阿罗	a'luo	0
阿罗麦克辛	a'luo'mai'ke'xin	0
阿什丽格林尼	a'shen'li'ge'lin'ni	0
爱德华	ai'de'hua	0
爱德华卡伦	ai'de'hua'ka'lun	0
爱丽丝	ai'li'si	0
埃利斯戴	ai'li'si'dai	0
爱丽丝卡伦	ai'li'si'ka'lun	0
埃梅特	ai'mei'te	0
埃梅特卡伦	ai'mei'te'ka'lun	0
艾蒙	ai'meng	0
艾米丽	ai'mi'li	0
埃斯梅	ai'si'mei	0
埃斯梅卡伦	ai'si'mei'ka'lun	0
安吉拉	an'ji'la	0
保罗	bao'luo	0
贝拉	bei'la	0
贝拉卡伦	bei'la'ka'lun	0
本杰明	ben'jie'ming	0
彼得	bi'de	0
比的费辛利	bi'de'fei'xin'li	0
比利	bi'li	0
比利伯克	bi'li'bo'ke	0
比利布莱克	bi'li'bu'lai'ke	0
波波斯图尔特	bo'bo'si'tu'er'te	0
布莱斯达拉斯霍华德	bu'lai'si'da'la'si'huo'hua'de	0
布里	bu'li	0
布里坦纳	bu'li'tan'na	0
布里坦纳第二次短暂生命	bu'li'tan'na'di'er'ci'duan'zan'sheng'ming	0
查弗丽娜	cha'fu'li'na	0
查理	cha'li	0
查理布雷	cha'li'bu'lei	0
查理斯旺	cha'li'si'wang	0
查斯科斯宾塞	cha'si'ke'si'bin'sai	0
达科塔范宁	da'ke'ta'fan'ning	0
大卫斯雷德	da'wei'si'lei'de	0
丹尼尔卡莫	dan'ni'er'ka'mo	0
德米特里	de'mi'te'li	0
迪亚戈	di'ya'ge	0
蒂亚加勒	di'ya'jia'le	0
恩布里	en'bu'li	0
菲利克斯	fei'li'ke'si	0
福克斯	fu'ke'si	0
弗拉德米尔	fu'la'de'mi'er	0
海蒂	hai'di	0
吉尔伯明翰	ji'er'bo'ming'han	0
贾斯帕	jia'si'pa	0
贾斯帕黑尔	jia'si'pa'hei'er	0
杰克休斯顿	jie'ke'xiu'si'dun	0
杰克逊拉斯波恩	jie'ke'xun'la'si'bo'en	0
杰拉德	jie'la'de	0
卡叽里	ka'ji'li	0
卡莱尔	ka'lai'er	0
卡莱尔卡伦	ka'lai'er'ka'lun	0
卡伦	ka'lun	0
卡梅伦布莱特	ka'mei'lun'bu'lai'te	0
卡门	ka'men	0
凯比	kai'bi	0
凯厄斯	kai'e'si	0
凯厄斯吉米埃贝尔	kai'e'si'ji'mi'ai'bei'er	0
凯南鲁兹	kai'nan'lu'zi	0
凯特	kai'te	0
康涅狄格州	kang'nie'di'ge'zhou	0
克里斯蒂瑟拉图斯	ke'li'si'di'se'la'tu'si	0
克里斯滕普罗特	ke'li'si'teng'pu'luo'te	0
克里斯汀斯图尔特	ke'li'si'ting'si'tu'er'te	0
赖利	lai'li	0
赖利比利斯	lai'li'bi'li'si	0
兰德尔	lan'de'er	0
劳伦特	lao'lun'te	0
勒娜特	le'na'te	0
蕾妮	lei'ni	0
蕾妮德尔	lei'ni'de'er	0
蕾妮斯梅	lei'ni'si'mei	0
蕾妮斯梅卡里卡伦	lei'ni'si'mei'ka'li'ka'lun	0
蕾切尔李费佛	lei'qie'er'li'fei'fo	0
里尔	li'er	0
里尔克里尔沃特	li'er'ke'li'er'wo'te	0
里尔姆	li'er'mu	0
露西	lu'xi	0
罗伯特帕丁森	luo'bo'te'pa'ding'sen	0
罗莎莉	luo'sha'li	0
罗莎莉黑尔	luo'sha'li'hei'er	0
罗伊斯金	luo'yi'si'jin	0
玛吉	ma'ji	0
马库斯	ma'ku'si	0
马库斯克里斯多夫海达尔	ma'ku'si'ke'li'si'duo'fu'hai'da'er	0
玛丽	ma'li	0
迈克	mai'ke	0
迈克牛顿	mai'ke'niu'dun	0
迈克韦尔奇	mai'ke'wei'er'qi	0
梅莉莎罗森伯格	mei'li'sha'luo'sen'bo'ge	0
暮光之城	mu'guang'zhi'cheng	0
暮色	mu'se	0
妮基瑞德	ni'ji'rui'de	0
破晓	po'xiao	0
切尔西	qie'er'xi	0
塞娜	sai'na	0
塞思	sai'si	0
塞思克里尔沃特	sai'si'ke'li'er'wo'te	0
沙维尔塞缪尔	sha'wei'er'sai'miu'er	0
山姆	shan'mu	0
山姆乌利	shan'mu'wu'li	0
史蒂芬	shi'di'fen	0
斯蒂芬妮	si'di'fen'ni	0
泰勒洛特纳	tai'le'luo'te'na	0
坦尼娅	tan'ni'ya	0
婷塞尔柯瑞	ting'sai'er'ke'rui	0
维多利亚	wei'duo'li'ya	0
维纳尔	wei'na'er	0
沃尔图里	wo'er'tu'li	0
沃尔图里家族	wo'er'tu'li'jia'zu	0
沃特拉	wo'te'la	0
午夜阳光	wu'ye'yang'guang	0
希奥布翰	xi'ao'bu'han	0
吸血新世纪	xi'xue'xin'shi'ji	0
夏洛特	xia'luo'te	0
新月	xin'yue	0
休伊伦	xiu'yi'lun	0
雅各布	ya'ge'bu	0
雅各布布莱克	ya'ge'bu'bu'lai'ke	0
亚力克	ya'li'ke	0
亚历克斯莫拉兹	ya'li'ke'si'mo'la'zi	0
伊里尔	yi'li'er	0
伊莉莎白里瑟	yi'li'sha'bai'li'se	0
伊莎贝拉	yi'sha'bei'la	0
月食	yue'shi	0
詹姆斯	zhan'mu'si	0
