安定	an'ding	0
巴郡	ba'jun	0
巴西	ba'xi	0
白帝城	bai'di'cheng	0
白马津	bai'ma'jin	0
鲍隆	bao'long	0
鲍隆马	bao'long'ma	0
鲍隆统攻防智政	bao'long'tong'gong'fang'zhi'zheng	0
鲍隆卓绍权坚策术	bao'long'zhuo'shao'quan'jian'ce'shu	0
北地	bei'di	0
北海	bei'hai	0
北平	bei'ping	0
并州枪训骑训钱粮	bing'zhou'qiang'xun'qi'xun'qian'liang	0
博爱	bo'ai	0
博望坡	bo'wang'po	0
蔡勋	cai'xun	0
蔡勋奉绍权坚策	cai'xun'feng'shao'quan'jian'ce	0
蔡勋弓枪水	cai'xun'gong'qiang'shui	0
蔡勋统攻防智政	cai'xun'tong'gong'fang'zhi'zheng	0
仓城	cang'cheng	0
曹丕	cao'a	0
曹操	cao'a	0
曹植	cao'a	0
曹丕奉绍	cao'a'feng'shao	0
曹操奉绍	cao'a'feng'shao	0
曹植奉绍	cao'a'feng'shao	0
曹操马弓枪埋侦妖	cao'a'ma'gong'qiang'mai'zhen'yao	0
曹丕马弓侦幻	cao'a'ma'gong'zhen'huan	0
曹植埋妖	cao'a'mai'yao	0
曹丕统攻防智政	cao'a'tong'gong'fang'zhi'zheng	0
曹操统攻防智政	cao'a'tong'gong'fang'zhi'zheng	0
曹植统攻防智政	cao'a'tong'gong'fang'zhi'zheng	0
曹洪	cao'hong	0
曹洪奉绍	cao'hong'feng'shao	0
曹洪马弓枪	cao'hong'ma'gong'qiang	0
曹洪统攻防智政	cao'hong'tong'gong'fang'zhi'zheng	0
曹仁	cao'ren	0
曹仁奉绍	cao'ren'feng'shao	0
曹仁马弓枪埋	cao'ren'ma'gong'qiang'mai	0
曹仁统攻防智政	cao'ren'tong'gong'fang'zhi'zheng	0
曹睿	cao'rui	0
曹睿奉绍	cao'rui'feng'shao	0
曹睿统攻防智政	cao'rui'tong'gong'fang'zhi'zheng	0
曹睿仙幻	cao'rui'xian'huan	0
曹爽	cao'shuang	0
曹爽奉绍	cao'shuang'feng'shao	0
曹爽弓枪	cao'shuang'gong'qiang	0
曹爽统攻防智政	cao'shuang'tong'gong'fang'zhi'zheng	0
曹县	cao'xian	0
曹性	cao'xing	0
曹性奉绍	cao'xing'feng'shao	0
曹性弓枪埋	cao'xing'gong'qiang'mai	0
曹性统攻防智政	cao'xing'tong'gong'fang'zhi'zheng	0
曹彰	cao'zhang	0
曹彰奉绍	cao'zhang'feng'shao	0
曹彰马枪埋侦	cao'zhang'ma'qiang'mai'zhen	0
曹彰统攻防智政	cao'zhang'tong'gong'fang'zhi'zheng	0
曹真	cao'zhen	0
曹真奉绍	cao'zhen'feng'shao	0
曹真马枪	cao'zhen'ma'qiang	0
曹真统攻防智政	cao'zhen'tong'gong'fang'zhi'zheng	0
柴桑	chai'sang	0
长安	chang'an	0
长坂坡	chang'ban'po	0
长垣	chang'yuan	0
朝哥	chao'ge	0
陈宫	chen'a	0
陈登	chen'a	0
陈群	chen'a	0
陈群奉绍权坚策	chen'a'feng'shao'quan'jian'ce	0
陈登弓枪埋侦妖	chen'a'gong'qiang'mai'zhen'yao	0
陈群埋侦	chen'a'mai'zhen	0
陈宫埋侦妖	chen'a'mai'zhen'yao	0
陈宫腾备奉绍	chen'a'teng'bei'feng'shao	0
陈宫统攻防智政	chen'a'tong'gong'fang'zhi'zheng	0
陈登统攻防智政	chen'a'tong'gong'fang'zhi'zheng	0
陈群统攻防智政	chen'a'tong'gong'fang'zhi'zheng	0
陈登卓布操丕术	chen'a'zhuo'bu'cao'pi'shu	0
陈仓	chen'cang	0
陈到	chen'dao	0
陈到弓枪	chen'dao'gong'qiang	0
陈到统攻防智政	chen'dao'tong'gong'fang'zhi'zheng	0
陈到卓布操丕术	chen'dao'zhuo'bu'cao'pi'shu	0
陈珪	chen'gui	0
陈珪幻	chen'gui'huan	0
陈珪统攻防智政	chen'gui'tong'gong'fang'zhi'zheng	0
陈珪卓布操丕术	chen'gui'zhuo'bu'cao'pi'shu	0
陈横	chen'heng	0
陈横枪水幻	chen'heng'qiang'shui'huan	0
陈横统攻防智政	chen'heng'tong'gong'fang'zhi'zheng	0
陈横卓布操丕懿表	chen'heng'zhuo'bu'cao'pi'yi'biao	0
陈矫	chen'jiao	0
陈矫奉绍权坚策	chen'jiao'feng'shao'quan'jian'ce	0
陈矫弓埋侦	chen'jiao'gong'mai'zhen	0
陈矫统攻防智政	chen'jiao'tong'gong'fang'zhi'zheng	0
陈琳	chen'lin	0
陈琳奉绍权坚策	chen'lin'feng'shao'quan'jian'ce	0
陈琳埋侦妖	chen'lin'mai'zhen'yao	0
陈琳统攻防智政	chen'lin'tong'gong'fang'zhi'zheng	0
陈留	chen'liu	0
陈武	chen'wu	0
陈武操丕懿表璋获瓒	chen'wu'cao'pi'yi'biao'zhang'huo'zan	0
陈武弓枪水	chen'wu'gong'qiang'shui	0
陈武统攻防智政	chen'wu'tong'gong'fang'zhi'zheng	0
程昱	cheng'a	0
程昱备奉绍	cheng'a'bei'feng'shao	0
程昱埋侦妖幻	cheng'a'mai'zhen'yao'huan	0
程昱统攻防智政	cheng'a'tong'gong'fang'zhi'zheng	0
成都	cheng'du	0
成皋	cheng'gao	0
成固	cheng'gu	0
程普	cheng'pu	0
程普操丕懿表璋获瓒腾备	cheng'pu'cao'pi'yi'biao'zhang'huo'zan'teng'bei	0
程普马水埋	cheng'pu'ma'shui'mai	0
程普统攻防智政	cheng'pu'tong'gong'fang'zhi'zheng	0
程银	cheng'yin	0
程银马弓	cheng'yin'ma'gong	0
程银统攻防智政	cheng'yin'tong'gong'fang'zhi'zheng	0
程银卓布权坚策术	cheng'yin'zhuo'bu'quan'jian'ce'shu	0
赤壁	chi'bi	0
大乔	da'a	0
大乔统攻防智政	da'a'tong'gong'fang'zhi'zheng	0
大乔仙	da'a'xian	0
大乔懿表璋获瓒腾备	da'a'yi'biao'zhang'huo'zan'teng'bei	0
大梁	da'liang	0
大散关	da'san'guan	0
大悟	da'wu	0
带来洞主	dai'lai'dong'zhu	0
带来洞主统攻防智政	dai'lai'dong'zhu'tong'gong'fang'zhi'zheng	0
带来洞主侦	dai'lai'dong'zhu'zhen	0
带来洞主卓权坚策术	dai'lai'dong'zhu'zhuo'quan'jian'ce'shu	0
当阳	dang'yang	0
邓艾	deng'a	0
邓艾马弓仙埋侦妖	deng'a'ma'gong'xian'mai'zhen'yao	0
邓艾绍权坚策术	deng'a'shao'quan'jian'ce'shu	0
邓艾统攻防智政	deng'a'tong'gong'fang'zhi'zheng	0
邓芝	deng'zhi	0
邓芝埋侦幻	deng'zhi'mai'zhen'huan	0
邓芝统攻防智政	deng'zhi'tong'gong'fang'zhi'zheng	0
邓芝卓布权坚策术	deng'zhi'zhuo'bu'quan'jian'ce'shu	0
棣城	di'cheng	0
荻嘉	di'jia	0
典韦	dian'wei	0
典韦奉绍	dian'wei'feng'shao	0
典韦弓枪	dian'wei'gong'qiang	0
典韦统攻防智政	dian'wei'tong'gong'fang'zhi'zheng	0
貂婵	diao'a	0
貂婵备奉绍	diao'a'bei'feng'shao	0
貂婵统攻防智政	diao'a'tong'gong'fang'zhi'zheng	0
貂婵仙埋侦妖幻	diao'a'xian'mai'zhen'yao'huan	0
丁奉	ding'feng	0
丁奉操丕懿表璋获瓒腾	ding'feng'cao'pi'yi'biao'zhang'huo'zan'teng	0
丁奉弓水	ding'feng'gong'shui	0
丁奉统攻防智政	ding'feng'tong'gong'fang'zhi'zheng	0
董承	dong'cheng	0
董承马枪埋幻	dong'cheng'ma'qiang'mai'huan	0
董承统攻防智政	dong'cheng'tong'gong'fang'zhi'zheng	0
董承卓布操丕懿	dong'cheng'zhuo'bu'cao'pi'yi	0
董和	dong'he	0
董和弓枪	dong'he'gong'qiang	0
董和统攻防智政	dong'he'tong'gong'fang'zhi'zheng	0
董和卓布权坚策术	dong'he'zhuo'bu'quan'jian'ce'shu	0
东郡	dong'jun	0
董荼那	dong'tu'na	0
董荼那弓	dong'tu'na'gong	0
董荼那统攻防智政	dong'tu'na'tong'gong'fang'zhi'zheng	0
董荼那卓布权坚策术	dong'tu'na'zhuo'bu'quan'jian'ce'shu	0
董卓	dong'zhuo	0
董卓马枪妖	dong'zhuo'ma'qiang'yao	0
董卓统攻防智政	dong'zhuo'tong'gong'fang'zhi'zheng	0
董卓璋获瓒腾备奉	dong'zhuo'zhang'huo'zan'teng'bei'feng	0
兑州枪训骑训钱粮	dui'zhou'qiang'xun'qi'xun'qian'liang	0
朵思大王	duo'si'da'wang	0
朵思大王马幻	duo'si'da'wang'ma'huan	0
朵思大王统攻防智政	duo'si'da'wang'tong'gong'fang'zhi'zheng	0
朵思大王卓绍权坚策术	duo'si'da'wang'zhuo'shao'quan'jian'ce'shu	0
鄂焕	e'huan	0
鄂焕枪	e'huan'qiang	0
鄂焕统攻防智政	e'huan'tong'gong'fang'zhi'zheng	0
鄂焕卓权坚策术	e'huan'zhuo'quan'jian'ce'shu	0
法正	fa'a	0
法正水埋侦妖	fa'a'shui'mai'zhen'yao	0
法正统攻防智政	fa'a'tong'gong'fang'zhi'zheng	0
法正卓布权坚策术	fa'a'zhuo'bu'quan'jian'ce'shu	0
樊城	fan'cheng	0
樊稠	fan'chou	0
樊稠马弓	fan'chou'ma'gong	0
樊稠统攻防智政	fan'chou'tong'gong'fang'zhi'zheng	0
樊稠璋获瓒腾备奉	fan'chou'zhang'huo'zan'teng'bei'feng	0
樊口	fan'kou	0
范阳	fan'yang	0
费诗	fei'shi	0
费诗统攻防智政	fei'shi'tong'gong'fang'zhi'zheng	0
费诗侦幻	fei'shi'zhen'huan	0
费诗卓布权坚策术	fei'shi'zhuo'bu'quan'jian'ce'shu	0
费炜	fei'wei	0
费炜埋侦妖	fei'wei'mai'zhen'yao	0
费炜统攻防智政	fei'wei'tong'gong'fang'zhi'zheng	0
费炜卓布权坚策术	fei'wei'zhuo'bu'quan'jian'ce'shu	0
封丘	feng'qiu	0
扶风	fu'feng	0
傅士仁	fu'shi'ren	0
傅士仁布操丕懿表璋	fu'shi'ren'bu'cao'pi'yi'biao'zhang	0
傅士仁马埋	fu'shi'ren'ma'mai	0
傅士仁统攻防智政	fu'shi'ren'tong'gong'fang'zhi'zheng	0
甘宁	gan'ning	0
甘宁操丕懿表璋获瓒腾	gan'ning'cao'pi'yi'biao'zhang'huo'zan'teng	0
甘宁马弓枪水埋	gan'ning'ma'gong'qiang'shui'mai	0
甘宁统攻防智政	gan'ning'tong'gong'fang'zhi'zheng	0
高都	gao'du	0
高干	gao'gan	0
高干布操丕懿表	gao'gan'bu'cao'pi'yi'biao	0
高干马枪	gao'gan'ma'qiang	0
高干统攻防智政	gao'gan'tong'gong'fang'zhi'zheng	0
高览	gao'lan	0
高览奉绍权坚策	gao'lan'feng'shao'quan'jian'ce	0
高览马枪埋	gao'lan'ma'qiang'mai	0
高览统攻防智政	gao'lan'tong'gong'fang'zhi'zheng	0
高顺	gao'shun	0
高顺马枪埋	gao'shun'ma'qiang'mai	0
高顺腾备奉绍	gao'shun'teng'bei'feng'shao	0
高顺统攻防智政	gao'shun'tong'gong'fang'zhi'zheng	0
高翔	gao'xiang	0
高翔弓枪埋	gao'xiang'gong'qiang'mai	0
高翔统攻防智政	gao'xiang'tong'gong'fang'zhi'zheng	0
高翔卓布权坚策术	gao'xiang'zhuo'bu'quan'jian'ce'shu	0
高邑	gao'yi	0
龚都	gong'dou	0
龚都马枪	gong'dou'ma'qiang	0
龚都卓布权坚策术	gong'dou'zhuo'bu'quan'jian'ce'shu	0
龚都统攻防智政	gong'du'tong'gong'fang'zhi'zheng	0
公孙度	gong'sun'du	0
公孙度弓枪侦	gong'sun'du'gong'qiang'zhen	0
公孙度腾备奉绍	gong'sun'du'teng'bei'feng'shao	0
公孙度统攻防智政	gong'sun'du'tong'gong'fang'zhi'zheng	0
公孙范	gong'sun'fan	0
公孙范马弓枪	gong'sun'fan'ma'gong'qiang	0
公孙范统攻防智政	gong'sun'fan'tong'gong'fang'zhi'zheng	0
公孙范卓权坚策术	gong'sun'fan'zhuo'quan'jian'ce'shu	0
公孙恭	gong'sun'gong	0
公孙恭弓枪	gong'sun'gong'gong'qiang	0
公孙恭腾备奉绍	gong'sun'gong'teng'bei'feng'shao	0
公孙恭统攻防智政	gong'sun'gong'tong'gong'fang'zhi'zheng	0
公孙康	gong'sun'kang	0
公孙康弓埋	gong'sun'kang'gong'mai	0
公孙康腾备奉绍	gong'sun'kang'teng'bei'feng'shao	0
公孙康统攻防智政	gong'sun'kang'tong'gong'fang'zhi'zheng	0
公孙续	gong'sun'xu	0
公孙续马弓侦	gong'sun'xu'ma'gong'zhen	0
公孙续统攻防智政	gong'sun'xu'tong'gong'fang'zhi'zheng	0
公孙续卓权坚策术	gong'sun'xu'zhuo'quan'jian'ce'shu	0
公孙渊	gong'sun'yuan	0
公孙渊弓幻	gong'sun'yuan'gong'huan	0
公孙渊腾备奉绍	gong'sun'yuan'teng'bei'feng'shao	0
公孙渊统攻防智政	gong'sun'yuan'tong'gong'fang'zhi'zheng	0
公孙越	gong'sun'yue	0
公孙越马	gong'sun'yue'ma	0
公孙越统攻防智政	gong'sun'yue'tong'gong'fang'zhi'zheng	0
公孙越卓权坚策术	gong'sun'yue'zhuo'quan'jian'ce'shu	0
公孙瓒	gong'sun'zan	0
公孙瓒马弓枪埋妖	gong'sun'zan'ma'gong'qiang'mai'yao	0
公孙瓒统攻防智政	gong'sun'zan'tong'gong'fang'zhi'zheng	0
公孙瓒卓权坚策术	gong'sun'zan'zhuo'quan'jian'ce'shu	0
共县	gong'xian	0
巩志	gong'zhi	0
巩志弓	gong'zhi'gong	0
巩志统攻防智政	gong'zhi'tong'gong'fang'zhi'zheng	0
巩志卓布操丕懿	gong'zhi'zhuo'bu'cao'pi'yi	0
故市	gu'shi	0
顾雍	gu'yong	0
顾雍埋幻	gu'yong'mai'huan	0
顾雍统攻防智政	gu'yong'tong'gong'fang'zhi'zheng	0
顾雍懿表璋获瓒腾备	gu'yong'yi'biao'zhang'huo'zan'teng'bei	0
关羽	guan'a	0
关羽马弓枪水埋幻	guan'a'ma'gong'qiang'shui'mai'huan	0
关羽统攻防智政	guan'a'tong'gong'fang'zhi'zheng	0
关羽卓布策术	guan'a'zhuo'bu'ce'shu	0
官渡	guan'du	0
管亥	guan'hai	0
管亥马弓枪	guan'hai'ma'gong'qiang	0
管亥统攻防智政	guan'hai'tong'gong'fang'zhi'zheng	0
管亥璋获瓒腾备奉	guan'hai'zhang'huo'zan'teng'bei'feng	0
关平	guan'ping	0
关平马枪	guan'ping'ma'qiang	0
关平统攻防智政	guan'ping'tong'gong'fang'zhi'zheng	0
关平卓布策术	guan'ping'zhuo'bu'ce'shu	0
关索	guan'suo	0
关索马弓埋	guan'suo'ma'gong'mai	0
关索统攻防智政	guan'suo'tong'gong'fang'zhi'zheng	0
关索卓布策术	guan'suo'zhuo'bu'ce'shu	0
关统	guan'tong	0
关统马枪	guan'tong'ma'qiang	0
关统统攻防智政	guan'tong'tong'gong'fang'zhi'zheng	0
关统卓布策术	guan'tong'zhuo'bu'ce'shu	0
关兴	guan'xing	0
关兴马弓埋	guan'xing'ma'gong'mai	0
关兴统攻防智政	guan'xing'tong'gong'fang'zhi'zheng	0
关兴卓布策术	guan'xing'zhuo'bu'ce'shu	0
广汉	guang'han	0
郭嘉	guo'a	0
郭嘉奉绍	guo'a'feng'shao	0
郭嘉统攻防智政	guo'a'tong'gong'fang'zhi'zheng	0
郭嘉仙埋侦妖幻	guo'a'xian'mai'zhen'yao'huan	0
郭淮	guo'huai	0
郭淮马枪幻	guo'huai'ma'qiang'huan	0
郭淮腾备奉绍	guo'huai'teng'bei'feng'shao	0
郭淮统攻防智政	guo'huai'tong'gong'fang'zhi'zheng	0
郭汜	guo'si	0
郭汜弓	guo'si'gong	0
郭汜统攻防智政	guo'si'tong'gong'fang'zhi'zheng	0
郭汜璋获瓒腾备奉	guo'si'zhang'huo'zan'teng'bei'feng	0
郭图	guo'tu	0
郭图布操丕懿表璋获瓒	guo'tu'bu'cao'pi'yi'biao'zhang'huo'zan	0
郭图埋幻	guo'tu'mai'huan	0
郭图统攻防智政	guo'tu'tong'gong'fang'zhi'zheng	0
郭攸之	guo'you'zhi	0
郭攸之统攻防智政	guo'you'zhi'tong'gong'fang'zhi'zheng	0
郭攸之侦	guo'you'zhi'zhen	0
郭攸之卓布操丕术	guo'you'zhi'zhuo'bu'cao'pi'shu	0
韩当	han'dang	0
韩当马弓水	han'dang'ma'gong'shui	0
韩当统攻防智政	han'dang'tong'gong'fang'zhi'zheng	0
韩当懿表璋获瓒腾备	han'dang'yi'biao'zhang'huo'zan'teng'bei	0
韩馥	han'fu	0
韩馥表璋获瓒腾备	han'fu'biao'zhang'huo'zan'teng'bei	0
韩馥马枪幻	han'fu'ma'qiang'huan	0
韩馥统攻防智政	han'fu'tong'gong'fang'zhi'zheng	0
韩浩	han'hao	0
韩浩备奉绍	han'hao'bei'feng'shao	0
韩浩马枪埋	han'hao'ma'qiang'mai	0
韩浩统攻防智政	han'hao'tong'gong'fang'zhi'zheng	0
韩嵩	han'song	0
韩嵩奉绍权坚策	han'song'feng'shao'quan'jian'ce	0
韩嵩统攻防智政	han'song'tong'gong'fang'zhi'zheng	0
韩嵩侦幻	han'song'zhen'huan	0
韩遂	han'sui	0
韩遂马枪埋	han'sui'ma'qiang'mai	0
韩遂腾备奉绍	han'sui'teng'bei'feng'shao	0
韩遂统攻防智政	han'sui'tong'gong'fang'zhi'zheng	0
韩暹	han'xian	0
韩暹弓枪	han'xian'gong'qiang	0
韩暹腾备奉绍	han'xian'teng'bei'feng'shao	0
韩暹统攻防智政	han'xian'tong'gong'fang'zhi'zheng	0
韩玄	han'xuan	0
韩玄水	han'xuan'shui	0
韩玄腾备奉绍	han'xuan'teng'bei'feng'shao	0
韩玄统攻防智政	han'xuan'tong'gong'fang'zhi'zheng	0
汉中	han'zhong	0
郝昭	hao'a	0
郝昭奉绍	hao'a'feng'shao	0
郝昭埋侦妖	hao'a'mai'zhen'yao	0
郝昭统攻防智政	hao'a'tong'gong'fang'zhi'zheng	0
河间	he'jian	0
合江	he'jiang	0
赫连夜姬	he'lian'ye'a	0
赫连夜姬攻防智政	he'lian'ye'a'gong'fang'zhi'zheng	0
赫连夜姬埋侦妖幻	he'lian'ye'a'mai'zhen'yao'huan	0
河内	he'nei	0
贺齐	he'qi	0
贺齐枪水妖	he'qi'qiang'shui'yao	0
贺齐统攻防智政	he'qi'tong'gong'fang'zhi'zheng	0
贺齐懿表璋获瓒腾	he'qi'yi'biao'zhang'huo'zan'teng	0
河阳	he'yang	0
何仪	he'yi	0
何仪枪	he'yi'qiang	0
何仪统攻防智政	he'yi'tong'gong'fang'zhi'zheng	0
何仪璋获瓒腾备奉	he'yi'zhang'huo'zan'teng'bei'feng	0
胡班	hu'ban	0
胡班幻	hu'ban'huan	0
胡班统攻防智政	hu'ban'tong'gong'fang'zhi'zheng	0
胡班卓布操丕懿术	hu'ban'zhuo'bu'cao'pi'yi'shu	0
胡车儿	hu'che'er	0
胡车儿统攻防智政	hu'che'er'tong'gong'fang'zhi'zheng	0
胡车儿璋获瓒腾备奉	hu'che'er'zhang'huo'zan'teng'bei'feng	0
壶关	hu'guan	0
虎牢关	hu'lao'guan	0
花容	hua'rong	0
华佗	hua'tuo	0
华佗布操丕懿表璋	hua'tuo'bu'cao'pi'yi'biao'zhang	0
华佗统攻防智政	hua'tuo'tong'gong'fang'zhi'zheng	0
华佗仙	hua'tuo'xian	0
华雄	hua'xiong	0
华雄马枪	hua'xiong'ma'qiang	0
华雄统攻防智政	hua'xiong'tong'gong'fang'zhi'zheng	0
华雄璋获瓒腾备奉	hua'xiong'zhang'huo'zan'teng'bei'feng	0
桓范	huan'fan	0
桓范备奉绍	huan'fan'bei'feng'shao	0
桓范统攻防智政	huan'fan'tong'gong'fang'zhi'zheng	0
桓范侦幻	huan'fan'zhen'huan	0
皇甫嵩	huang'fu'song	0
皇甫嵩奉绍权坚策	huang'fu'song'feng'shao'quan'jian'ce	0
皇甫嵩马枪仙埋妖	huang'fu'song'ma'qiang'xian'mai'yao	0
皇甫嵩统攻防智政	huang'fu'song'tong'gong'fang'zhi'zheng	0
黄盖	huang'gai	0
黄盖枪水埋妖	huang'gai'qiang'shui'mai'yao	0
黄盖统攻防智政	huang'gai'tong'gong'fang'zhi'zheng	0
黄盖懿表璋获瓒腾备	huang'gai'yi'biao'zhang'huo'zan'teng'bei	0
黄皓	huang'hao	0
黄皓统攻防智政	huang'hao'tong'gong'fang'zhi'zheng	0
黄皓妖	huang'hao'yao	0
黄皓卓布策术	huang'hao'zhuo'bu'ce'shu	0
黄权	huang'quan	0
黄权水侦	huang'quan'shui'zhen	0
黄权统攻防智政	huang'quan'tong'gong'fang'zhi'zheng	0
黄权卓权坚策术	huang'quan'zhuo'quan'jian'ce'shu	0
黄月英	huang'yue'a	0
黄月英水仙埋侦妖幻	huang'yue'a'shui'xian'mai'zhen'yao'huan	0
黄月英统攻防智政	huang'yue'a'tong'gong'fang'zhi'zheng	0
黄月英卓布策术	huang'yue'a'zhuo'bu'ce'shu	0
黄忠	huang'zhong	0
黄忠马弓枪幻	huang'zhong'ma'gong'qiang'huan	0
黄忠统攻防智政	huang'zhong'tong'gong'fang'zhi'zheng	0
黄忠卓布权坚策术	huang'zhong'zhuo'bu'quan'jian'ce'shu	0
黄祖	huang'zu	0
黄祖奉绍权坚策	huang'zu'feng'shao'quan'jian'ce	0
黄祖水幻	huang'zu'shui'huan	0
黄祖统攻防智政	huang'zu'tong'gong'fang'zhi'zheng	0
霍峻	huo'jun	0
霍峻弓幻	huo'jun'gong'huan	0
霍峻统攻防智政	huo'jun'tong'gong'fang'zhi'zheng	0
霍峻卓权坚策术	huo'jun'zhuo'quan'jian'ce'shu	0
纪灵	ji'ling	0
纪灵表璋获瓒腾备	ji'ling'biao'zhang'huo'zan'teng'bei	0
纪灵马枪	ji'ling'ma'qiang	0
纪灵统攻防智政	ji'ling'tong'gong'fang'zhi'zheng	0
济源	ji'yuan	0
冀州刀训弓训骑训钱粮	ji'zhou'dao'xun'gong'xun'qi'xun'qian'liang	0
贾诩	jia'a	0
贾诩腾备奉绍	jia'a'teng'bei'feng'shao	0
贾诩统攻防智政	jia'a'tong'gong'fang'zhi'zheng	0
贾诩仙埋侦妖	jia'a'xian'mai'zhen'yao	0
贾充	jia'chong	0
贾充奉绍权坚策	jia'chong'feng'shao'quan'jian'ce	0
贾充埋侦妖	jia'chong'mai'zhen'yao	0
贾充统攻防智政	jia'chong'tong'gong'fang'zhi'zheng	0
贾范	jia'fan	0
贾范弓	jia'fan'gong	0
贾范获瓒腾备奉绍	jia'fan'huo'zan'teng'bei'feng'shao	0
贾范统攻防智政	jia'fan'tong'gong'fang'zhi'zheng	0
剑阁	jian'ge	0
建业	jian'ye	0
简雍	jian'yong	0
简雍埋侦妖	jian'yong'mai'zhen'yao	0
简雍统攻防智政	jian'yong'tong'gong'fang'zhi'zheng	0
简雍卓布权坚策术	jian'yong'zhuo'bu'quan'jian'ce'shu	0
蒋琬	jiang'a	0
姜维	jiang'a	0
姜维马弓枪仙埋妖	jiang'a'ma'gong'qiang'xian'mai'yao	0
蒋琬水幻	jiang'a'shui'huan	0
蒋琬统攻防智政	jiang'a'tong'gong'fang'zhi'zheng	0
姜维统攻防智政	jiang'a'tong'gong'fang'zhi'zheng	0
蒋琬卓布操丕术	jiang'a'zhuo'bu'cao'pi'shu	0
姜维卓布权坚策术	jiang'a'zhuo'bu'quan'jian'ce'shu	0
蒋干	jiang'gan	0
蒋干统攻防智政	jiang'gan'tong'gong'fang'zhi'zheng	0
蒋干璋获瓒腾备奉	jiang'gan'zhang'huo'zan'teng'bei'feng	0
蒋钦	jiang'qin	0
蒋钦水	jiang'qin'shui	0
蒋钦统攻防智政	jiang'qin'tong'gong'fang'zhi'zheng	0
蒋钦懿表璋获瓒腾备	jiang'qin'yi'biao'zhang'huo'zan'teng'bei	0
江夏	jiang'xia	0
江阳	jiang'yang	0
蒋义渠	jiang'yi'qu	0
蒋义渠布操丕懿表	jiang'yi'qu'bu'cao'pi'yi'biao	0
蒋义渠马枪幻	jiang'yi'qu'ma'qiang'huan	0
蒋义渠统攻防智政	jiang'yi'qu'tong'gong'fang'zhi'zheng	0
江油	jiang'you	0
交州弓训钱粮	jiao'zhou'gong'xun'qian'liang	0
街亭	jie'ting	0
金环三结	jin'huan'san'jie	0
金环三结弓枪	jin'huan'san'jie'gong'qiang	0
金环三结统攻防智政	jin'huan'san'jie'tong'gong'fang'zhi'zheng	0
金环三结卓绍权坚策术	jin'huan'san'jie'zhuo'shao'quan'jian'ce'shu	0
金旋	jin'xuan	0
金旋布操丕懿表	jin'xuan'bu'cao'pi'yi'biao	0
金旋马弓枪水	jin'xuan'ma'gong'qiang'shui	0
金旋统攻防智政	jin'xuan'tong'gong'fang'zhi'zheng	0
晋阳	jin'yang	0
荆州刀训枪训弓训钱粮	jing'zhou'dao'xun'qiang'xun'gong'xun'qian'liang	0
巨鹿	ju'lu	0
沮授	ju'shou	0
沮授布操丕懿表	ju'shou'bu'cao'pi'yi'biao	0
沮授埋妖	ju'shou'mai'yao	0
沮授统攻防智政	ju'shou'tong'gong'fang'zhi'zheng	0
卷县	juan'xian	0
阚泽	kan'a	0
阚泽表璋获瓒腾备	kan'a'biao'zhang'huo'zan'teng'bei	0
阚泽水仙侦	kan'a'shui'xian'zhen	0
阚泽统攻防智政	kan'a'tong'gong'fang'zhi'zheng	0
孔融	kong'rong	0
孔融绍权坚策术	kong'rong'shao'quan'jian'ce'shu	0
孔融统攻防智政	kong'rong'tong'gong'fang'zhi'zheng	0
孔融侦	kong'rong'zhen	0
会稽	kuai'ji	0
蒯良	kuai'liang	0
蒯良奉绍权坚策	kuai'liang'feng'shao'quan'jian'ce	0
蒯良弓侦埋幻	kuai'liang'gong'zhen'mai'huan	0
蒯良统攻防智政	kuai'liang'tong'gong'fang'zhi'zheng	0
蒯越	kuai'yue	0
蒯越奉绍权坚策	kuai'yue'feng'shao'quan'jian'ce	0
蒯越统攻防智政	kuai'yue'tong'gong'fang'zhi'zheng	0
蒯越侦埋妖	kuai'yue'zhen'mai'yao	0
乐进	le'jin	0
乐进备奉绍	le'jin'bei'feng'shao	0
乐进马弓枪埋侦	le'jin'ma'gong'qiang'mai'zhen	0
乐进统攻防智政	le'jin'tong'gong'fang'zhi'zheng	0
乐陵	le'ling	0
雷薄	lei'bao	0
雷薄表璋获瓒腾备	lei'bao'biao'zhang'huo'zan'teng'bei	0
雷薄马枪埋	lei'bao'ma'qiang'mai	0
雷薄统攻防智政	lei'bao'tong'gong'fang'zhi'zheng	0
雷铜	lei'tong	0
雷铜枪水埋	lei'tong'qiang'shui'mai	0
雷铜统攻防智政	lei'tong'tong'gong'fang'zhi'zheng	0
雷铜卓布权坚策术	lei'tong'zhuo'bu'quan'jian'ce'shu	0
李儒	li'a	0
李儒统攻防智政	li'a'tong'gong'fang'zhi'zheng	0
李儒仙埋幻	li'a'xian'mai'huan	0
李儒璋获瓒腾备奉	li'a'zhang'huo'zan'teng'bei'feng	0
李典	li'dian	0
李典备奉绍	li'dian'bei'feng'shao	0
李典马枪水妖	li'dian'ma'qiang'shui'yao	0
李典统攻防智政	li'dian'tong'gong'fang'zhi'zheng	0
李恢	li'hui	0
李恢弓幻	li'hui'gong'huan	0
李恢统攻防智政	li'hui'tong'gong'fang'zhi'zheng	0
李恢卓权坚策术	li'hui'zhuo'quan'jian'ce'shu	0
李傕	li'jue	0
李傕马枪	li'jue'ma'qiang	0
李傕统攻防智政	li'jue'tong'gong'fang'zhi'zheng	0
李傕璋获瓒腾备奉	li'jue'zhang'huo'zan'teng'bei'feng	0
李肃	li'su	0
李肃获瓒腾备奉	li'su'huo'zan'teng'bei'feng	0
李肃埋幻	li'su'mai'huan	0
李肃统攻防智政	li'su'tong'gong'fang'zhi'zheng	0
郦县	li'xian	0
李岩	li'yan	0
李岩马弓枪	li'yan'ma'gong'qiang	0
李岩统攻防智政	li'yan'tong'gong'fang'zhi'zheng	0
李岩卓布权坚策术	li'yan'zhuo'bu'quan'jian'ce'shu	0
黎阳	li'yang	0
李异	li'yi	0
李异马弓枪	li'yi'ma'gong'qiang	0
李异统攻防智政	li'yi'tong'gong'fang'zhi'zheng	0
李异懿表璋获瓒腾备	li'yi'yi'biao'zhang'huo'zan'teng'bei	0
梁兴	liang'xing	0
梁兴马弓	liang'xing'ma'gong	0
梁兴统攻防智政	liang'xing'tong'gong'fang'zhi'zheng	0
梁兴卓布权坚策术	liang'xing'zhuo'bu'quan'jian'ce'shu	0
凉州骑训钱粮	liang'zhou'qi'xun'qian'liang	0
廖化	liao'hua	0
廖化马枪埋	liao'hua'ma'qiang'mai	0
廖化统攻防智政	liao'hua'tong'gong'fang'zhi'zheng	0
廖化卓布操丕术	liao'hua'zhuo'bu'cao'pi'shu	0
临江	lin'jiang	0
凌操	ling'cao	0
凌操操丕懿表璋获瓒	ling'cao'cao'pi'yi'biao'zhang'huo'zan	0
凌操弓水埋	ling'cao'gong'shui'mai	0
凌操统攻防智政	ling'cao'tong'gong'fang'zhi'zheng	0
凌统	ling'tong	0
凌统操丕懿表璋获瓒	ling'tong'cao'pi'yi'biao'zhang'huo'zan	0
凌统弓水	ling'tong'gong'shui	0
凌统统攻防智政	ling'tong'tong'gong'fang'zhi'zheng	0
刘备	liu'bei	0
刘备马枪仙埋侦	liu'bei'ma'qiang'xian'mai'zhen	0
刘备统攻防智政	liu'bei'tong'gong'fang'zhi'zheng	0
刘备卓布策术	liu'bei'zhuo'bu'ce'shu	0
刘表	liu'biao	0
刘表弓水	liu'biao'gong'shui	0
刘表绍权坚策术	liu'biao'shao'quan'jian'ce'shu	0
刘表统攻防智政	liu'biao'tong'gong'fang'zhi'zheng	0
刘琮	liu'cong	0
刘琮绍权坚策术	liu'cong'shao'quan'jian'ce'shu	0
刘琮水	liu'cong'shui	0
刘琮统攻防智政	liu'cong'tong'gong'fang'zhi'zheng	0
刘岱	liu'dai	0
刘岱奉绍权坚策	liu'dai'feng'shao'quan'jian'ce	0
刘岱统攻防智政	liu'dai'tong'gong'fang'zhi'zheng	0
刘封	liu'feng	0
刘封马弓水	liu'feng'ma'gong'shui	0
刘封统攻防智政	liu'feng'tong'gong'fang'zhi'zheng	0
刘封卓布策术	liu'feng'zhuo'bu'ce'shu	0
刘辟	liu'pi	0
刘辟马枪	liu'pi'ma'qiang	0
刘辟统攻防智政	liu'pi'tong'gong'fang'zhi'zheng	0
刘辟卓布权坚策术	liu'pi'zhuo'bu'quan'jian'ce'shu	0
刘琦	liu'qi	0
刘琦弓水埋妖	liu'qi'gong'shui'mai'yao	0
刘琦绍权坚策术	liu'qi'shao'quan'jian'ce'shu	0
刘琦统攻防智政	liu'qi'tong'gong'fang'zhi'zheng	0
刘禅	liu'shan	0
刘禅统攻防智政	liu'shan'tong'gong'fang'zhi'zheng	0
刘禅卓布策术	liu'shan'zhuo'bu'ce'shu	0
刘繇	liu'yao	0
刘繇弓水埋	liu'yao'gong'shui'mai	0
刘繇统攻防智政	liu'yao'tong'gong'fang'zhi'zheng	0
刘繇卓布操丕懿表	liu'yao'zhuo'bu'cao'pi'yi'biao	0
刘璋	liu'zhang	0
刘璋弓枪仙	liu'zhang'gong'qiang'xian	0
刘璋统攻防智政	liu'zhang'tong'gong'fang'zhi'zheng	0
刘璋卓绍权坚策术	liu'zhang'zhuo'shao'quan'jian'ce'shu	0
陇西	long'xi	0
陆逊	lu'a	0
鲁肃	lu'a	0
陆逊操丕懿表璋获瓒	lu'a'cao'pi'yi'biao'zhang'huo'zan	0
陆逊弓枪水仙埋侦幻	lu'a'gong'qiang'shui'xian'mai'zhen'huan	0
鲁肃弓水仙埋侦幻	lu'a'gong'shui'xian'mai'zhen'huan	0
陆逊统攻防智政	lu'a'tong'gong'fang'zhi'zheng	0
鲁肃统攻防智政	lu'a'tong'gong'fang'zhi'zheng	0
鲁肃懿表璋获瓒腾	lu'a'yi'biao'zhang'huo'zan'teng	0
陆绩	lu'ji	0
陆绩埋妖	lu'ji'mai'yao	0
陆绩统攻防智政	lu'ji'tong'gong'fang'zhi'zheng	0
陆绩懿表璋获瓒腾	lu'ji'yi'biao'zhang'huo'zan'teng	0
卢植	lu'zhi	0
卢植埋妖	lu'zhi'mai'yao	0
卢植统攻防智政	lu'zhi'tong'gong'fang'zhi'zheng	0
卢植卓布操丕懿术	lu'zhi'zhuo'bu'cao'pi'yi'shu	0
骆统	luo'tong	0
骆统腾备奉绍	luo'tong'teng'bei'feng'shao	0
骆统统攻防智政	luo'tong'tong'gong'fang'zhi'zheng	0
洛阳	luo'yang	0
吕蒙	lv'a	0
吕蒙操丕懿表璋获瓒腾	lv'a'cao'pi'yi'biao'zhang'huo'zan'teng	0
吕蒙弓水埋侦幻	lv'a'gong'shui'mai'zhen'huan	0
吕蒙统攻防智政	lv'a'tong'gong'fang'zhi'zheng	0
吕布	lv'bu	0
吕布马弓枪	lv'bu'ma'gong'qiang	0
吕布腾备奉绍	lv'bu'teng'bei'feng'shao	0
吕布统攻防智政	lv'bu'tong'gong'fang'zhi'zheng	0
吕范	lv'fan	0
吕范布操丕懿表璋获瓒	lv'fan'bu'cao'pi'yi'biao'zhang'huo'zan	0
吕范水埋侦	lv'fan'shui'mai'zhen	0
吕范统攻防智政	lv'fan'tong'gong'fang'zhi'zheng	0
吕凯	lv'kai	0
吕凯弓侦	lv'kai'gong'zhen	0
吕凯统攻防智政	lv'kai'tong'gong'fang'zhi'zheng	0
吕凯卓布权坚策术	lv'kai'zhuo'bu'quan'jian'ce'shu	0
吕旷	lv'kuang	0
吕旷布操丕懿表璋	lv'kuang'bu'cao'pi'yi'biao'zhang	0
吕旷马水埋	lv'kuang'ma'shui'mai	0
吕旷统攻防智政	lv'kuang'tong'gong'fang'zhi'zheng	0
吕翔	lv'xiang	0
吕翔布操丕懿表璋	lv'xiang'bu'cao'pi'yi'biao'zhang	0
吕翔马	lv'xiang'ma	0
吕翔统攻防智政	lv'xiang'tong'gong'fang'zhi'zheng	0
吕义	lv'yi	0
吕义马枪	lv'yi'ma'qiang	0
吕义统攻防智政	lv'yi'tong'gong'fang'zhi'zheng	0
吕义卓布权坚策术	lv'yi'zhuo'bu'quan'jian'ce'shu	0
马良	ma'a	0
马谡	ma'a	0
马谡马弓埋妖	ma'a'ma'gong'mai'yao	0
马良统攻防智政	ma'a'tong'gong'fang'zhi'zheng	0
马谡统攻防智政	ma'a'tong'gong'fang'zhi'zheng	0
马良仙埋妖	ma'a'xian'mai'yao	0
马良卓布操丕术	ma'a'zhuo'bu'cao'pi'shu	0
马谡卓布操丕术	ma'a'zhuo'bu'cao'pi'shu	0
马超	ma'chao	0
马超马弓枪	ma'chao'ma'gong'qiang	0
马超统攻防智政	ma'chao'tong'gong'fang'zhi'zheng	0
马超卓布权坚策术	ma'chao'zhuo'bu'quan'jian'ce'shu	0
马岱	ma'dai	0
马岱马弓枪	ma'dai'ma'gong'qiang	0
马岱统攻防智政	ma'dai'tong'gong'fang'zhi'zheng	0
马岱卓布权坚策术	ma'dai'zhuo'bu'quan'jian'ce'shu	0
马腾	ma'teng	0
马腾马弓埋	ma'teng'ma'gong'mai	0
马腾统攻防智政	ma'teng'tong'gong'fang'zhi'zheng	0
马腾卓布权坚策术	ma'teng'zhuo'bu'quan'jian'ce'shu	0
马铁	ma'tie	0
马铁马弓	ma'tie'ma'gong	0
马铁统攻防智政	ma'tie'tong'gong'fang'zhi'zheng	0
马铁卓布权坚策术	ma'tie'zhuo'bu'quan'jian'ce'shu	0
马玩	ma'wan	0
马玩马	ma'wan'ma	0
马玩统攻防智政	ma'wan'tong'gong'fang'zhi'zheng	0
马玩卓布权坚策术	ma'wan'zhuo'bu'quan'jian'ce'shu	0
马休	ma'xiu	0
马休马弓幻	ma'xiu'ma'gong'huan	0
马休统攻防智政	ma'xiu'tong'gong'fang'zhi'zheng	0
马休卓布权坚策术	ma'xiu'zhuo'bu'quan'jian'ce'shu	0
马云绿	ma'yun'lv	0
马云绿马弓枪埋	ma'yun'lv'ma'gong'qiang'mai	0
马云绿统攻防智政	ma'yun'lv'tong'gong'fang'zhi'zheng	0
马云绿卓布策术	ma'yun'lv'zhuo'bu'ce'shu	0
马忠	ma'zhong	0
马忠马水埋	ma'zhong'ma'shui'mai	0
马忠统攻防智政	ma'zhong'tong'gong'fang'zhi'zheng	0
马忠卓布权坚策术	ma'zhong'zhuo'bu'quan'jian'ce'shu	0
满宠	man'chong	0
满宠奉绍权坚策	man'chong'feng'shao'quan'jian'ce	0
满宠统攻防智政	man'chong'tong'gong'fang'zhi'zheng	0
满宠侦妖	man'chong'zhen'yao	0
忙牙长	mang'ya'chang	0
忙牙长马弓埋	mang'ya'chang'ma'gong'mai	0
忙牙长绍权坚策术	mang'ya'chang'shao'quan'jian'ce'shu	0
忙牙长统攻防智政	mang'ya'chang'tong'gong'fang'zhi'zheng	0
毛玠	mao'jie	0
毛玠奉绍权坚策	mao'jie'feng'shao'quan'jian'ce	0
毛玠弓水埋侦	mao'jie'gong'shui'mai'zhen	0
毛玠统攻防智政	mao'jie'tong'gong'fang'zhi'zheng	0
孟达	meng'da	0
孟达弓枪妖	meng'da'gong'qiang'yao	0
孟达绍权坚策术	meng'da'shao'quan'jian'ce'shu	0
孟达统攻防智政	meng'da'tong'gong'fang'zhi'zheng	0
孟获	meng'huo	0
孟获马弓水	meng'huo'ma'gong'shui	0
孟获统攻防智政	meng'huo'tong'gong'fang'zhi'zheng	0
孟获卓权坚策术	meng'huo'zhuo'quan'jian'ce'shu	0
孟津	meng'jin	0
蒙县	meng'xian	0
孟优	meng'you	0
孟优弓水	meng'you'gong'shui	0
孟优统攻防智政	meng'you'tong'gong'fang'zhi'zheng	0
孟优卓权坚策术	meng'you'zhuo'quan'jian'ce'shu	0
弭衡	mi'a	0
弭衡绍权坚策术	mi'a'shao'quan'jian'ce'shu	0
弭衡统攻防智政	mi'a'tong'gong'fang'zhi'zheng	0
弭衡仙埋侦妖	mi'a'xian'mai'zhen'yao	0
迷当大王	mi'dang'da'wang	0
迷当大王马	mi'dang'da'wang'ma	0
迷当大王绍权坚策术	mi'dang'da'wang'shao'quan'jian'ce'shu	0
迷当大王统攻防智政	mi'dang'da'wang'tong'gong'fang'zhi'zheng	0
糜芳	mi'fang	0
糜芳马埋	mi'fang'ma'mai	0
糜芳统攻防智政	mi'fang'tong'gong'fang'zhi'zheng	0
糜芳卓布操丕懿术	mi'fang'zhuo'bu'cao'pi'yi'shu	0
糜竺	mi'zhu	0
糜竺枪水埋幻	mi'zhu'qiang'shui'mai'huan	0
糜竺统攻防智政	mi'zhu'tong'gong'fang'zhi'zheng	0
糜竺卓布操丕术	mi'zhu'zhuo'bu'cao'pi'shu	0
棉竹关	mian'zhu'guan	0
木鹿大王	mu'lu'da'wang	0
木鹿大王马弓水妖	mu'lu'da'wang'ma'gong'shui'yao	0
木鹿大王统攻防智政	mu'lu'da'wang'tong'gong'fang'zhi'zheng	0
木鹿大王卓绍权坚策术	mu'lu'da'wang'zhuo'shao'quan'jian'ce'shu	0
南安	nan'an	0
南郡	nan'jun	0
南乡	nan'xiang	0
南阳	nan'yang	0
牛金	niu'jin	0
牛金奉绍权坚策	niu'jin'feng'shao'quan'jian'ce	0
牛金马枪埋	niu'jin'ma'qiang'mai	0
牛金统攻防智政	niu'jin'tong'gong'fang'zhi'zheng	0
潘凤	pan'feng	0
潘凤表璋获瓒腾备	pan'feng'biao'zhang'huo'zan'teng'bei	0
潘凤马	pan'feng'ma	0
潘凤统攻防智政	pan'feng'tong'gong'fang'zhi'zheng	0
潘璋	pan'zhang	0
潘璋布操丕懿表璋获瓒	pan'zhang'bu'cao'pi'yi'biao'zhang'huo'zan	0
潘璋弓水埋幻	pan'zhang'gong'shui'mai'huan	0
潘璋统攻防智政	pan'zhang'tong'gong'fang'zhi'zheng	0
庞统	pang'a	0
庞统弓枪水仙埋侦妖幻	pang'a'gong'qiang'shui'xian'mai'zhen'yao'huan	0
庞统统攻防智政	pang'a'tong'gong'fang'zhi'zheng	0
庞统卓布权坚策术	pang'a'zhuo'bu'quan'jian'ce'shu	0
庞德	pang'de	0
庞德奉绍权坚策	pang'de'feng'shao'quan'jian'ce	0
庞德马弓枪	pang'de'ma'gong'qiang	0
庞德统攻防智政	pang'de'tong'gong'fang'zhi'zheng	0
平皋	ping'gao	0
濮阳	pu'yang	0
犍为	qian'wei	0
千阳	qian'yang	0
谯周	qiao'zhou	0
谯周统攻防智政	qiao'zhou'tong'gong'fang'zhi'zheng	0
谯周侦妖	qiao'zhou'zhen'yao	0
谯周卓布权坚策术	qiao'zhou'zhuo'bu'quan'jian'ce'shu	0
秦宓	qin'mi	0
秦宓统攻防智政	qin'mi'tong'gong'fang'zhi'zheng	0
秦宓侦幻	qin'mi'zhen'huan	0
秦宓卓布权坚策术	qin'mi'zhuo'bu'quan'jian'ce'shu	0
清河	qing'he	0
青州枪训钱粮	qing'zhou'qiang'xun'qian'liang	0
全琮	quan'cong	0
全琮表璋获瓒腾备	quan'cong'biao'zhang'huo'zan'teng'bei	0
全琮弓水埋	quan'cong'gong'shui'mai	0
全琮统攻防智政	quan'cong'tong'gong'fang'zhi'zheng	0
汝南	ru'nan	0
沙摩柯	sha'mo'ke	0
沙摩柯弓	sha'mo'ke'gong	0
沙摩柯统攻防智政	sha'mo'ke'tong'gong'fang'zhi'zheng	0
沙摩柯卓布权坚策术	sha'mo'ke'zhuo'bu'quan'jian'ce'shu	0
山阳	shan'yang	0
上艾	shang'ai	0
上蔡	shang'cai	0
上党	shang'dang	0
上圭	shang'gui	0
上庸	shang'yong	0
审配	shen'pei	0
审配布操丕懿表	shen'pei'bu'cao'pi'yi'biao	0
审配埋侦妖幻	shen'pei'mai'zhen'yao'huan	0
审配统攻防智政	shen'pei'tong'gong'fang'zhi'zheng	0
司马懿	si'ma'a	0
司马昭	si'ma'a	0
司马懿奉绍权坚策	si'ma'a'feng'shao'quan'jian'ce	0
司马昭奉绍权坚策	si'ma'a'feng'shao'quan'jian'ce	0
司马懿马枪埋侦妖幻	si'ma'a'ma'qiang'mai'zhen'yao'huan	0
司马懿统攻防智政	si'ma'a'tong'gong'fang'zhi'zheng	0
司马昭统攻防智政	si'ma'a'tong'gong'fang'zhi'zheng	0
司马昭仙埋侦妖	si'ma'a'xian'mai'zhen'yao	0
司马师	si'ma'shi	0
司马师奉绍权坚策	si'ma'shi'feng'shao'quan'jian'ce	0
司马师马枪埋侦幻	si'ma'shi'ma'qiang'mai'zhen'huan	0
司马师统攻防智政	si'ma'shi'tong'gong'fang'zhi'zheng	0
司马炎	si'ma'yan	0
司马炎奉绍权坚策	si'ma'yan'feng'shao'quan'jian'ce	0
司马炎弓枪	si'ma'yan'gong'qiang	0
司马炎统攻防智政	si'ma'yan'tong'gong'fang'zhi'zheng	0
司州刀训枪训钱粮	si'zhou'dao'xun'qiang'xun'qian'liang	0
苏飞	su'fei	0
苏飞马枪水	su'fei'ma'qiang'shui	0
苏飞统攻防智政	su'fei'tong'gong'fang'zhi'zheng	0
苏飞璋获瓒腾备奉	su'fei'zhang'huo'zan'teng'bei'feng	0
酸枣	suan'zao	0
随县	sui'xian	0
孙策	sun'ce	0
孙策马弓枪水	sun'ce'ma'gong'qiang'shui	0
孙策统攻防智政	sun'ce'tong'gong'fang'zhi'zheng	0
孙策懿表璋获瓒腾备	sun'ce'yi'biao'zhang'huo'zan'teng'bei	0
孙皓	sun'hao	0
孙皓幻	sun'hao'huan	0
孙皓统攻防智政	sun'hao'tong'gong'fang'zhi'zheng	0
孙皓懿表璋获瓒腾	sun'hao'yi'biao'zhang'huo'zan'teng	0
孙桓	sun'huan	0
孙桓马弓枪水	sun'huan'ma'gong'qiang'shui	0
孙桓统攻防智政	sun'huan'tong'gong'fang'zhi'zheng	0
孙桓懿表璋获瓒腾备	sun'huan'yi'biao'zhang'huo'zan'teng'bei	0
孙坚	sun'jian	0
孙坚马弓枪水埋	sun'jian'ma'gong'qiang'shui'mai	0
孙坚统攻防智政	sun'jian'tong'gong'fang'zhi'zheng	0
孙坚懿表璋获瓒腾	sun'jian'yi'biao'zhang'huo'zan'teng	0
孙礼	sun'li	0
孙礼操丕懿表璋获瓒腾	sun'li'cao'pi'yi'biao'zhang'huo'zan'teng	0
孙礼马埋	sun'li'ma'mai	0
孙礼统攻防智政	sun'li'tong'gong'fang'zhi'zheng	0
孙乾	sun'qian	0
孙乾埋侦幻	sun'qian'mai'zhen'huan	0
孙乾统攻防智政	sun'qian'tong'gong'fang'zhi'zheng	0
孙乾卓布操丕术	sun'qian'zhuo'bu'cao'pi'shu	0
孙权	sun'quan	0
孙权弓水埋侦	sun'quan'gong'shui'mai'zhen	0
孙权统攻防智政	sun'quan'tong'gong'fang'zhi'zheng	0
孙权懿表璋获瓒腾	sun'quan'yi'biao'zhang'huo'zan'teng	0
孙尚香	sun'shang'a	0
孙尚香弓枪水埋	sun'shang'a'gong'qiang'shui'mai	0
孙尚香统攻防智政	sun'shang'a'tong'gong'fang'zhi'zheng	0
孙尚香卓布操丕懿	sun'shang'a'zhuo'bu'cao'pi'yi	0
孙韶	sun'shao	0
孙韶操丕懿表璋获瓒腾	sun'shao'cao'pi'yi'biao'zhang'huo'zan'teng	0
孙韶弓水埋	sun'shao'gong'shui'mai	0
孙韶统攻防智政	sun'shao'tong'gong'fang'zhi'zheng	0
蹋顿	ta'dun	0
蹋顿马	ta'dun'ma	0
蹋顿统攻防智政	ta'dun'tong'gong'fang'zhi'zheng	0
蹋顿卓布操丕懿表	ta'dun'zhuo'bu'cao'pi'yi'biao	0
太行	tai'hang	0
太史慈	tai'shi'ci	0
太史慈操丕懿表璋获瓒腾	tai'shi'ci'cao'pi'yi'biao'zhang'huo'zan'teng	0
太史慈马弓枪水埋	tai'shi'ci'ma'gong'qiang'shui'mai	0
太史慈统攻防智政	tai'shi'ci'tong'gong'fang'zhi'zheng	0
谭雄	tan'xiong	0
谭雄弓枪	tan'xiong'gong'qiang	0
谭雄统攻防智政	tan'xiong'tong'gong'fang'zhi'zheng	0
谭雄懿表璋获瓒腾备	tan'xiong'yi'biao'zhang'huo'zan'teng'bei	0
陶谦	tao'qian	0
陶谦马仙	tao'qian'ma'xian	0
陶谦统攻防智政	tao'qian'tong'gong'fang'zhi'zheng	0
陶谦卓布操丕懿术	tao'qian'zhuo'bu'cao'pi'yi'shu	0
田丰	tian'a	0
田丰统攻防智政	tian'a'tong'gong'fang'zhi'zheng	0
田丰仙埋妖	tian'a'xian'mai'yao	0
田丰卓布操丕懿表	tian'a'zhuo'bu'cao'pi'yi'biao	0
田畴	tian'chou	0
田畴统攻防智政	tian'chou'tong'gong'fang'zhi'zheng	0
田畴侦幻	tian'chou'zhen'huan	0
田畴卓布操丕懿	tian'chou'zhuo'bu'cao'pi'yi	0
田楷	tian'kai	0
田楷弓枪	tian'kai'gong'qiang	0
田楷统攻防智政	tian'kai'tong'gong'fang'zhi'zheng	0
田楷卓布权坚策术	tian'kai'zhuo'bu'quan'jian'ce'shu	0
天水	tian'shui	0
桐柏	tong'bai	0
潼关	tong'guan	0
王朗	wang'a	0
王朗奉绍权坚策	wang'a'feng'shao'quan'jian'ce	0
王朗弓水幻	wang'a'gong'shui'huan	0
王朗统攻防智政	wang'a'tong'gong'fang'zhi'zheng	0
王粲	wang'can	0
王粲奉绍权坚策	wang'can'feng'shao'quan'jian'ce	0
王粲弓水侦妖	wang'can'gong'shui'zhen'yao	0
王粲统攻防智政	wang'can'tong'gong'fang'zhi'zheng	0
王甫	wang'fu	0
王甫弓水侦妖	wang'fu'gong'shui'zhen'yao	0
王甫统攻防智政	wang'fu'tong'gong'fang'zhi'zheng	0
王甫卓布权坚策术	wang'fu'zhuo'bu'quan'jian'ce'shu	0
王基	wang'ji	0
王基奉绍权坚策	wang'ji'feng'shao'quan'jian'ce	0
王基马弓枪	wang'ji'ma'gong'qiang	0
王基统攻防智政	wang'ji'tong'gong'fang'zhi'zheng	0
王浚	wang'jun	0
王浚奉绍权坚策	wang'jun'feng'shao'quan'jian'ce	0
王浚弓水妖	wang'jun'gong'shui'yao	0
王浚统攻防智政	wang'jun'tong'gong'fang'zhi'zheng	0
王匡	wang'kuang	0
王匡马	wang'kuang'ma	0
王匡统攻防智政	wang'kuang'tong'gong'fang'zhi'zheng	0
王匡懿表璋获瓒腾	wang'kuang'yi'biao'zhang'huo'zan'teng	0
王累	wang'lei	0
王累统攻防智政	wang'lei'tong'gong'fang'zhi'zheng	0
王累侦	wang'lei'zhen	0
王累卓绍权坚策术	wang'lei'zhuo'shao'quan'jian'ce'shu	0
王平	wang'ping	0
王平弓侦幻	wang'ping'gong'zhen'huan	0
王平统攻防智政	wang'ping'tong'gong'fang'zhi'zheng	0
王平卓布权坚策术	wang'ping'zhuo'bu'quan'jian'ce'shu	0
王睿	wang'rui	0
王睿奉绍权坚策	wang'rui'feng'shao'quan'jian'ce	0
王睿弓水妖	wang'rui'gong'shui'yao	0
王睿统攻防智政	wang'rui'tong'gong'fang'zhi'zheng	0
王双	wang'shuang	0
王双奉绍权坚	wang'shuang'feng'shao'quan'jian	0
王双弓	wang'shuang'gong	0
王双统攻防智政	wang'shuang'tong'gong'fang'zhi'zheng	0
王修	wang'xiu	0
王修表璋获瓒腾备奉	wang'xiu'biao'zhang'huo'zan'teng'bei'feng	0
王修幻	wang'xiu'huan	0
王修统攻防智政	wang'xiu'tong'gong'fang'zhi'zheng	0
王允	wang'yun	0
王允埋侦妖	wang'yun'mai'zhen'yao	0
王允绍权坚策术	wang'yun'shao'quan'jian'ce'shu	0
王允统攻防智政	wang'yun'tong'gong'fang'zhi'zheng	0
魏兴	wei'xing	0
魏续	wei'xu	0
魏续枪埋	wei'xu'qiang'mai	0
魏续腾备奉绍	wei'xu'teng'bei'feng'shao	0
魏续统攻防智政	wei'xu'tong'gong'fang'zhi'zheng	0
魏延	wei'yan	0
魏延马弓	wei'yan'ma'gong	0
魏延统攻防智政	wei'yan'tong'gong'fang'zhi'zheng	0
魏延卓布策术	wei'yan'zhuo'bu'ce'shu	0
文丑	wen'chou	0
文丑马弓枪	wen'chou'ma'gong'qiang	0
文丑统攻防智政	wen'chou'tong'gong'fang'zhi'zheng	0
文丑卓布操丕懿表	wen'chou'zhuo'bu'cao'pi'yi'biao	0
文聘	wen'pin	0
文聘奉绍权坚策	wen'pin'feng'shao'quan'jian'ce	0
文聘弓枪水埋侦幻	wen'pin'gong'qiang'shui'mai'zhen'huan	0
文聘统攻防智政	wen'pin'tong'gong'fang'zhi'zheng	0
文钦	wen'qin	0
文钦马枪侦幻	wen'qin'ma'qiang'zhen'huan	0
文钦绍权坚策术	wen'qin'shao'quan'jian'ce'shu	0
文钦统攻防智政	wen'qin'tong'gong'fang'zhi'zheng	0
文鸯	wen'yang	0
文鸯马弓水埋	wen'yang'ma'gong'shui'mai	0
文鸯绍权坚策术	wen'yang'shao'quan'jian'ce'shu	0
文鸯统攻防智政	wen'yang'tong'gong'fang'zhi'zheng	0
吴班	wu'ban	0
吴班马枪埋	wu'ban'ma'qiang'mai	0
吴班统攻防智政	wu'ban'tong'gong'fang'zhi'zheng	0
吴班卓布权坚策术	wu'ban'zhuo'bu'quan'jian'ce'shu	0
乌巢	wu'chao	0
武都	wu'du	0
武关	wu'guan	0
吴兰	wu'lan	0
吴兰马枪	wu'lan'ma'qiang	0
吴兰统攻防智政	wu'lan'tong'gong'fang'zhi'zheng	0
吴兰卓布权坚策术	wu'lan'zhuo'bu'quan'jian'ce'shu	0
乌林	wu'lin	0
武陵	wu'ling	0
武清	wu'qing	0
毋丘俭	wu'qiu'jian	0
毋丘俭奉绍权坚策	wu'qiu'jian'feng'shao'quan'jian'ce	0
毋丘俭弓枪埋妖	wu'qiu'jian'gong'qiang'mai'yao	0
毋丘俭统攻防智政	wu'qiu'jian'tong'gong'fang'zhi'zheng	0
武山	wu'shan	0
兀突骨	wu'tu'gu	0
兀突骨马弓枪	wu'tu'gu'ma'gong'qiang	0
兀突骨统攻防智政	wu'tu'gu'tong'gong'fang'zhi'zheng	0
兀突骨卓绍权坚策术	wu'tu'gu'zhuo'shao'quan'jian'ce'shu	0
巫县	wu'xian	0
吴懿	wu'yi	0
吴懿弓枪	wu'yi'gong'qiang	0
吴懿统攻防智政	wu'yi'tong'gong'fang'zhi'zheng	0
吴懿卓权坚策术	wu'yi'zhuo'quan'jian'ce'shu	0
五丈原	wu'zhang'yuan	0
西陵	xi'ling	0
析县	xi'xian	0
夏侯霸	xia'hou'ba	0
夏侯霸马弓妖幻	xia'hou'ba'ma'gong'yao'huan	0
夏侯霸统攻防智政	xia'hou'ba'tong'gong'fang'zhi'zheng	0
夏侯霸卓绍权坚策术	xia'hou'ba'zhuo'shao'quan'jian'ce'shu	0
夏侯淳	xia'hou'chun	0
夏侯淳奉绍	xia'hou'chun'feng'shao	0
夏侯淳马枪埋妖	xia'hou'chun'ma'qiang'mai'yao	0
夏侯淳统攻防智政	xia'hou'chun'tong'gong'fang'zhi'zheng	0
夏侯德	xia'hou'de	0
夏侯德备奉绍	xia'hou'de'bei'feng'shao	0
夏侯德砬	xia'hou'de'la	0
夏侯德统攻防智政	xia'hou'de'tong'gong'fang'zhi'zheng	0
夏侯和	xia'hou'he	0
夏侯和奉绍	xia'hou'he'feng'shao	0
夏侯和马枪妖	xia'hou'he'ma'qiang'yao	0
夏侯和统攻防智政	xia'hou'he'tong'gong'fang'zhi'zheng	0
夏侯惠	xia'hou'hui	0
夏侯惠奉绍	xia'hou'hui'feng'shao	0
夏侯惠统攻防智政	xia'hou'hui'tong'gong'fang'zhi'zheng	0
夏侯惠仙埋幻	xia'hou'hui'xian'mai'huan	0
夏侯懋	xia'hou'mao	0
夏侯懋奉绍权坚	xia'hou'mao'feng'shao'quan'jian	0
夏侯懋马	xia'hou'mao'ma	0
夏侯懋统攻防智政	xia'hou'mao'tong'gong'fang'zhi'zheng	0
夏侯尚	xia'hou'shang	0
夏侯尚备奉绍	xia'hou'shang'bei'feng'shao	0
夏侯尚马弓	xia'hou'shang'ma'gong	0
夏侯尚统攻防智政	xia'hou'shang'tong'gong'fang'zhi'zheng	0
夏侯玄	xia'hou'xuan	0
夏侯玄备奉绍	xia'hou'xuan'bei'feng'shao	0
夏侯玄埋	xia'hou'xuan'mai	0
夏侯玄统攻防智政	xia'hou'xuan'tong'gong'fang'zhi'zheng	0
夏侯渊	xia'hou'yuan	0
夏侯渊奉绍	xia'hou'yuan'feng'shao	0
夏侯渊马弓埋	xia'hou'yuan'ma'gong'mai	0
夏侯渊统攻防智政	xia'hou'yuan'tong'gong'fang'zhi'zheng	0
夏口	xia'kou	0
下邳	xia'pi	0
向宠	xiang'chong	0
向宠马弓埋侦	xiang'chong'ma'gong'mai'zhen	0
向宠统攻防智政	xiang'chong'tong'gong'fang'zhi'zheng	0
向宠卓布操丕术	xiang'chong'zhuo'bu'cao'pi'shu	0
向朗	xiang'lang	0
向朗埋妖	xiang'lang'mai'yao	0
向朗统攻防智政	xiang'lang'tong'gong'fang'zhi'zheng	0
向朗卓布操丕术	xiang'lang'zhuo'bu'cao'pi'shu	0
襄阳	xiang'yang	0
襄邑	xiang'yi	0
小乔	xiao'a	0
小乔统攻防智政	xiao'a'tong'gong'fang'zhi'zheng	0
小乔仙妖	xiao'a'xian'yao	0
小乔懿表璋获瓒腾	xiao'a'yi'biao'zhang'huo'zan'teng	0
小沛	xiao'pei	0
辛毗	xin'pi	0
辛毗埋侦幻	xin'pi'mai'zhen'huan	0
辛毗腾备奉绍	xin'pi'teng'bei'feng'shao	0
辛毗统攻防智政	xin'pi'tong'gong'fang'zhi'zheng	0
新平	xin'ping	0
信阳	xin'yang	0
新野	xin'ye	0
邢道荣	xing'dao'rong	0
邢道荣表璋获瓒腾备	xing'dao'rong'biao'zhang'huo'zan'teng'bei	0
邢道荣枪	xing'dao'rong'qiang	0
邢道荣统攻防智政	xing'dao'rong'tong'gong'fang'zhi'zheng	0
修武	xiu'wu	0
徐庶	xu'a	0
徐庶埋侦妖幻	xu'a'mai'zhen'yao'huan	0
徐庶统攻防智政	xu'a'tong'gong'fang'zhi'zheng	0
徐庶卓布权坚策术	xu'a'zhuo'bu'quan'jian'ce'shu	0
许昌	xu'chang	0
许贡	xu'gong	0
许贡弓水	xu'gong'gong'shui	0
许贡腾备奉绍	xu'gong'teng'bei'feng'shao	0
许贡统攻防智政	xu'gong'tong'gong'fang'zhi'zheng	0
徐晃	xu'huang	0
徐晃备奉绍	xu'huang'bei'feng'shao	0
徐晃马弓枪埋妖	xu'huang'ma'gong'qiang'mai'yao	0
徐晃统攻防智政	xu'huang'tong'gong'fang'zhi'zheng	0
许靖	xu'jing	0
许靖奉绍权坚策	xu'jing'feng'shao'quan'jian'ce	0
许靖幻	xu'jing'huan	0
许靖统攻防智政	xu'jing'tong'gong'fang'zhi'zheng	0
徐盛	xu'sheng	0
徐盛操丕懿表璋获瓒腾	xu'sheng'cao'pi'yi'biao'zhang'huo'zan'teng	0
徐盛枪水妖	xu'sheng'qiang'shui'yao	0
徐盛统攻防智政	xu'sheng'tong'gong'fang'zhi'zheng	0
许攸	xu'you	0
许攸备奉绍	xu'you'bei'feng'shao	0
许攸统攻防智政	xu'you'tong'gong'fang'zhi'zheng	0
许攸仙埋	xu'you'xian'mai	0
徐州刀训枪训弓训骑训钱粮	xu'zhou'dao'xun'qiang'xun'gong'xun'qi'xun'qian'liang	0
许褚	xu'zhu	0
许褚奉绍	xu'zhu'feng'shao	0
许褚枪埋	xu'zhu'qiang'mai	0
许褚统攻防智政	xu'zhu'tong'gong'fang'zhi'zheng	0
荀或	xun'a	0
荀攸	xun'a	0
荀或备奉绍	xun'a'bei'feng'shao	0
荀攸奉绍权坚策	xun'a'feng'shao'quan'jian'ce	0
荀或埋侦妖	xun'a'mai'zhen'yao	0
荀或统攻防智政	xun'a'tong'gong'fang'zhi'zheng	0
荀攸统攻防智政	xun'a'tong'gong'fang'zhi'zheng	0
荀攸仙埋侦	xun'a'xian'mai'zhen	0
阎圃	yan'a	0
阎圃获瓒腾备奉	yan'a'huo'zan'teng'bei'feng	0
阎圃埋侦妖	yan'a'mai'zhen'yao	0
阎圃统攻防智政	yan'a'tong'gong'fang'zhi'zheng	0
延津	yan'jin	0
颜良	yan'liang	0
颜良马枪	yan'liang'ma'qiang	0
颜良统攻防智政	yan'liang'tong'gong'fang'zhi'zheng	0
颜良卓布权坚策术	yan'liang'zhuo'bu'quan'jian'ce'shu	0
雁门关	yan'men'guan	0
偃师	yan'shi	0
燕县	yan'xian	0
严颜	yan'yan	0
严颜弓枪妖	yan'yan'gong'qiang'yao	0
严颜统攻防智政	yan'yan'tong'gong'fang'zhi'zheng	0
严颜卓布权坚策术	yan'yan'zhuo'bu'quan'jian'ce'shu	0
杨修	yang'a	0
杨修奉绍权坚策	yang'a'feng'shao'quan'jian'ce	0
杨修统攻防智政	yang'a'tong'gong'fang'zhi'zheng	0
杨修仙幻	yang'a'xian'huan	0
阳城	yang'cheng	0
杨奉	yang'feng	0
杨奉马枪埋	yang'feng'ma'qiang'mai	0
杨奉统攻防智政	yang'feng'tong'gong'fang'zhi'zheng	0
杨奉卓布操丕懿	yang'feng'zhuo'bu'cao'pi'yi	0
羊祜	yang'hu	0
羊祜奉绍权坚策	yang'hu'feng'shao'quan'jian'ce	0
羊祜马枪埋妖	yang'hu'ma'qiang'mai'yao	0
羊祜统攻防智政	yang'hu'tong'gong'fang'zhi'zheng	0
阳平关	yang'ping'guan	0
杨秋	yang'qiu	0
杨秋马弓枪	yang'qiu'ma'gong'qiang	0
杨秋统攻防智政	yang'qiu'tong'gong'fang'zhi'zheng	0
杨秋卓布权坚策术	yang'qiu'zhuo'bu'quan'jian'ce'shu	0
阳武	yang'wu	0
杨仪	yang'yi	0
杨仪幻	yang'yi'huan	0
杨仪统攻防智政	yang'yi'tong'gong'fang'zhi'zheng	0
杨仪卓布权坚策术	yang'yi'zhuo'bu'quan'jian'ce'shu	0
扬州刀训弓训钱粮	yang'zhou'dao'xun'gong'xun'qian'liang	0
野王	ye'wang	0
伊籍	yi'ji	0
伊籍埋侦幻	yi'ji'mai'zhen'huan	0
伊籍统攻防智政	yi'ji'tong'gong'fang'zhi'zheng	0
伊籍卓布操丕术	yi'ji'zhuo'bu'cao'pi'shu	0
益州刀训枪训弓训钱粮	yi'zhou'dao'xun'qiang'xun'gong'xun'qian'liang	0
尹默	yin'mo	0
尹默统攻防智政	yin'mo'tong'gong'fang'zhi'zheng	0
尹默妖	yin'mo'yao	0
尹默卓布操丕懿术	yin'mo'zhuo'bu'cao'pi'yi'shu	0
永安	yong'an	0
雍州刀训骑训钱粮	yong'zhou'dao'xun'qi'xun'qian'liang	0
幽州刀训训骑训钱粮	you'zhou'dao'xun'xun'qi'xun'qian'liang	0
虞翻	yu'fan	0
虞翻表璋获瓒腾备	yu'fan'biao'zhang'huo'zan'teng'bei	0
虞翻埋侦幻	yu'fan'mai'zhen'huan	0
虞翻统攻防智政	yu'fan'tong'gong'fang'zhi'zheng	0
于禁	yu'jin	0
于禁奉绍	yu'jin'feng'shao	0
于禁马弓	yu'jin'ma'gong	0
于禁统攻防智政	yu'jin'tong'gong'fang'zhi'zheng	0
于诠	yu'quan	0
于诠操丕懿表璋获瓒腾	yu'quan'cao'pi'yi'biao'zhang'huo'zan'teng	0
于诠水	yu'quan'shui	0
于诠统攻防智政	yu'quan'tong'gong'fang'zhi'zheng	0
豫州枪训弓训钱粮	yu'zhou'qiang'xun'gong'xun'qian'liang	0
袁尚	yuan'shang	0
袁尚布操丕懿表	yuan'shang'bu'cao'pi'yi'biao	0
袁尚马	yuan'shang'ma	0
袁尚统攻防智政	yuan'shang'tong'gong'fang'zhi'zheng	0
袁绍	yuan'shao	0
袁绍布操丕懿表璋	yuan'shao'bu'cao'pi'yi'biao'zhang	0
袁绍马枪	yuan'shao'ma'qiang	0
袁绍统攻防智政	yuan'shao'tong'gong'fang'zhi'zheng	0
袁术	yuan'shu	0
袁术表璋获瓒腾备	yuan'shu'biao'zhang'huo'zan'teng'bei	0
袁术弓枪妖	yuan'shu'gong'qiang'yao	0
袁术统攻防智政	yuan'shu'tong'gong'fang'zhi'zheng	0
袁谭	yuan'tan	0
袁谭布操丕懿表	yuan'tan'bu'cao'pi'yi'biao	0
袁谭马枪	yuan'tan'ma'qiang	0
袁谭统攻防智政	yuan'tan'tong'gong'fang'zhi'zheng	0
原武	yuan'wu	0
袁熙	yuan'xi	0
袁熙布操丕懿表	yuan'xi'bu'cao'pi'yi'biao	0
袁熙弓枪妖	yuan'xi'gong'qiang'yao	0
袁熙统攻防智政	yuan'xi'tong'gong'fang'zhi'zheng	0
袁胤	yuan'yin	0
袁胤表璋获瓒腾备	yuan'yin'biao'zhang'huo'zan'teng'bei	0
袁胤弓幻	yuan'yin'gong'huan	0
袁胤统攻防智政	yuan'yin'tong'gong'fang'zhi'zheng	0
云梦	yun'meng	0
臧霸	zang'ba	0
臧霸马弓枪幻	zang'ba'ma'gong'qiang'huan	0
臧霸腾备奉绍	zang'ba'teng'bei'feng'shao	0
臧霸统攻防智政	zang'ba'tong'gong'fang'zhi'zheng	0
笮融	ze'rong	0
笮融布操丕懿表璋	ze'rong'bu'cao'pi'yi'biao'zhang	0
笮融水侦	ze'rong'shui'zhen	0
笮融统攻防智政	ze'rong'tong'gong'fang'zhi'zheng	0
张昭	zhang'a	0
张松	zhang'a	0
张昭操丕懿表璋获瓒腾	zhang'a'cao'pi'yi'biao'zhang'huo'zan'teng	0
张松埋侦幻	zhang'a'mai'zhen'huan	0
张昭埋侦妖幻	zhang'a'mai'zhen'yao'huan	0
张昭统攻防智政	zhang'a'tong'gong'fang'zhi'zheng	0
张松统攻防智政	zhang'a'tong'gong'fang'zhi'zheng	0
张松卓布权坚策术	zhang'a'zhuo'bu'quan'jian'ce'shu	0
张苞	zhang'bao	0
张苞马弓埋	zhang'bao'ma'gong'mai	0
张苞统攻防智政	zhang'bao'tong'gong'fang'zhi'zheng	0
张苞卓布策术	zhang'bao'zhuo'bu'ce'shu	0
张飞	zhang'fei	0
张飞马枪埋幻	zhang'fei'ma'qiang'mai'huan	0
张飞统攻防智政	zhang'fei'tong'gong'fang'zhi'zheng	0
张飞卓布策术	zhang'fei'zhuo'bu'ce'shu	0
张合	zhang'he	0
张合马弓枪埋	zhang'he'ma'gong'qiang'mai	0
张合腾备奉绍	zhang'he'teng'bei'feng'shao	0
张合统攻防智政	zhang'he'tong'gong'fang'zhi'zheng	0
张弘	zhang'hong	0
张弘操丕懿表璋获瓒腾	zhang'hong'cao'pi'yi'biao'zhang'huo'zan'teng	0
张弘埋侦	zhang'hong'mai'zhen	0
张弘统攻防智政	zhang'hong'tong'gong'fang'zhi'zheng	0
张辽	zhang'liao	0
张辽备奉绍	zhang'liao'bei'feng'shao	0
张辽马弓枪埋妖	zhang'liao'ma'gong'qiang'mai'yao	0
张辽统攻防智政	zhang'liao'tong'gong'fang'zhi'zheng	0
张鲁	zhang'lu	0
张鲁获瓒腾备奉绍	zhang'lu'huo'zan'teng'bei'feng'shao	0
张鲁埋侦幻	zhang'lu'mai'zhen'huan	0
张鲁统攻防智政	zhang'lu'tong'gong'fang'zhi'zheng	0
张任	zhang'ren	0
张任弓枪埋侦妖	zhang'ren'gong'qiang'mai'zhen'yao	0
张任统攻防智政	zhang'ren'tong'gong'fang'zhi'zheng	0
张任卓权坚策术	zhang'ren'zhuo'quan'jian'ce'shu	0
张卫	zhang'wei	0
张卫获瓒腾备奉绍	zhang'wei'huo'zan'teng'bei'feng'shao	0
张卫马枪	zhang'wei'ma'qiang	0
张卫统攻防智政	zhang'wei'tong'gong'fang'zhi'zheng	0
张休	zhang'xiu	0
张绣	zhang'xiu	0
张休操丕懿表璋获瓒腾	zhang'xiu'cao'pi'yi'biao'zhang'huo'zan'teng	0
张绣马弓枪侦	zhang'xiu'ma'gong'qiang'zhen	0
张休统攻防智政	zhang'xiu'tong'gong'fang'zhi'zheng	0
张绣统攻防智政	zhang'xiu'tong'gong'fang'zhi'zheng	0
张绣璋获瓒腾备奉	zhang'xiu'zhang'huo'zan'teng'bei'feng	0
张休侦	zhang'xiu'zhen	0
张燕	zhang'yan	0
张燕奉绍权坚策	zhang'yan'feng'shao'quan'jian'ce	0
张燕弓枪	zhang'yan'gong'qiang	0
张燕统攻防智政	zhang'yan'tong'gong'fang'zhi'zheng	0
张嶷	zhang'yi	0
张嶷马弓埋妖	zhang'yi'ma'gong'mai'yao	0
张嶷统攻防智政	zhang'yi'tong'gong'fang'zhi'zheng	0
张嶷卓布权坚策术	zhang'yi'zhuo'bu'quan'jian'ce'shu	0
张英	zhang'ying	0
张英布操丕懿表	zhang'ying'bu'cao'pi'yi'biao	0
张英马枪水	zhang'ying'ma'qiang'shui	0
张英统攻防智政	zhang'ying'tong'gong'fang'zhi'zheng	0
张允	zhang'yun	0
张允奉绍权坚策	zhang'yun'feng'shao'quan'jian'ce	0
张允弓水	zhang'yun'gong'shui	0
张允统攻防智政	zhang'yun'tong'gong'fang'zhi'zheng	0
赵云	zhao'a	0
赵云马弓枪埋妖	zhao'a'ma'gong'qiang'mai'yao	0
赵云统攻防智政	zhao'a'tong'gong'fang'zhi'zheng	0
赵云卓布策术	zhao'a'zhuo'bu'ce'shu	0
赵统	zhao'tong	0
赵统马枪	zhao'tong'ma'qiang	0
赵统统攻防智政	zhao'tong'tong'gong'fang'zhi'zheng	0
赵统卓布策术	zhao'tong'zhuo'bu'ce'shu	0
甄宓	zhen'a	0
甄宓奉绍	zhen'a'feng'shao	0
甄宓统攻防智政	zhen'a'tong'gong'fang'zhi'zheng	0
甄宓仙埋	zhen'a'xian'mai	0
真定	zhen'ding	0
郑州	zheng'zhou	0
锺会	zhong'a	0
锺会备奉绍	zhong'a'bei'feng'shao	0
锺会马仙埋妖	zhong'a'ma'xian'mai'yao	0
锺会统攻防智政	zhong'a'tong'gong'fang'zhi'zheng	0
中牟	zhong'mu	0
中丘	zhong'qiu	0
锺繇	zhong'yao	0
锺繇备奉绍	zhong'yao'bei'feng'shao	0
锺繇统攻防智政	zhong'yao'tong'gong'fang'zhi'zheng	0
锺繇侦幻	zhong'yao'zhen'huan	0
周瑜	zhou'a	0
周瑜弓水埋侦妖	zhou'a'gong'shui'mai'zhen'yao	0
周瑜统攻防智政	zhou'a'tong'gong'fang'zhi'zheng	0
周瑜懿表璋获瓒腾	zhou'a'yi'biao'zhang'huo'zan'teng	0
周仓	zhou'cang	0
周仓枪水埋	zhou'cang'qiang'shui'mai	0
周仓统攻防智政	zhou'cang'tong'gong'fang'zhi'zheng	0
周仓卓布策术	zhou'cang'zhuo'bu'ce'shu	0
周泰	zhou'tai	0
周泰操丕懿表璋获瓒腾	zhou'tai'cao'pi'yi'biao'zhang'huo'zan'teng	0
周泰马枪水幻	zhou'tai'ma'qiang'shui'huan	0
周泰统攻防智政	zhou'tai'tong'gong'fang'zhi'zheng	0
朱处	zhu'chu	0
朱处操丕懿表璋获瓒腾	zhu'chu'cao'pi'yi'biao'zhang'huo'zan'teng	0
朱处水幻	zhu'chu'shui'huan	0
朱处统攻防智政	zhu'chu'tong'gong'fang'zhi'zheng	0
诸葛亮	zhu'ge'a	0
诸葛瑾	zhu'ge'a	0
诸葛瑾操丕懿表璋获瓒腾	zhu'ge'a'cao'pi'yi'biao'zhang'huo'zan'teng	0
诸葛瑾水埋妖	zhu'ge'a'shui'mai'yao	0
诸葛亮水仙埋侦妖幻	zhu'ge'a'shui'xian'mai'zhen'yao'huan	0
诸葛亮统攻防智政	zhu'ge'a'tong'gong'fang'zhi'zheng	0
诸葛瑾统攻防智政	zhu'ge'a'tong'gong'fang'zhi'zheng	0
诸葛亮卓布策术	zhu'ge'a'zhuo'bu'ce'shu	0
诸葛诞	zhu'ge'dan	0
诸葛诞获瓒腾备奉	zhu'ge'dan'huo'zan'teng'bei'feng	0
诸葛诞马枪水埋侦幻	zhu'ge'dan'ma'qiang'shui'mai'zhen'huan	0
诸葛诞统攻防智政	zhu'ge'dan'tong'gong'fang'zhi'zheng	0
诸葛均	zhu'ge'jun	0
诸葛均幻	zhu'ge'jun'huan	0
诸葛均统攻防智政	zhu'ge'jun'tong'gong'fang'zhi'zheng	0
诸葛均卓布操丕术	zhu'ge'jun'zhuo'bu'cao'pi'shu	0
诸葛恪	zhu'ge'ke	0
诸葛恪操丕懿表璋获瓒腾	zhu'ge'ke'cao'pi'yi'biao'zhang'huo'zan'teng	0
诸葛恪水埋侦妖	zhu'ge'ke'shui'mai'zhen'yao	0
诸葛恪统攻防智政	zhu'ge'ke'tong'gong'fang'zhi'zheng	0
朱桓	zhu'huan	0
朱桓操丕懿表璋获瓒	zhu'huan'cao'pi'yi'biao'zhang'huo'zan	0
朱桓弓水埋妖	zhu'huan'gong'shui'mai'yao	0
朱桓统攻防智政	zhu'huan'tong'gong'fang'zhi'zheng	0
朱隽	zhu'jun	0
朱隽马弓枪水幻	zhu'jun'ma'gong'qiang'shui'huan	0
朱隽统攻防智政	zhu'jun'tong'gong'fang'zhi'zheng	0
朱隽卓布操丕懿术	zhu'jun'zhuo'bu'cao'pi'yi'shu	0
朱然	zhu'ran	0
朱然操丕懿表璋获瓒腾	zhu'ran'cao'pi'yi'biao'zhang'huo'zan'teng	0
朱然马枪水	zhu'ran'ma'qiang'shui	0
朱然统攻防智政	zhu'ran'tong'gong'fang'zhi'zheng	0
祝融夫人	zhu'rong'fu'ren	0
祝融夫人统攻防智政	zhu'rong'fu'ren'tong'gong'fang'zhi'zheng	0
祝融夫人卓权坚策术	zhu'rong'fu'ren'zhuo'quan'jian'ce'shu	0
朱治	zhu'zhi	0
朱治操丕懿表璋获瓒腾	zhu'zhi'cao'pi'yi'biao'zhang'huo'zan'teng	0
朱治枪水	zhu'zhi'qiang'shui	0
朱治统攻防智政	zhu'zhi'tong'gong'fang'zhi'zheng	0
涿鹿	zhuo'lu	0
梓潼	zi'tong	0
祖茂	zu'mao	0
祖茂水	zu'mao'shui	0
祖茂统攻防智政	zu'mao'tong'gong'fang'zhi'zheng	0
祖茂懿表璋获瓒腾备	zu'mao'yi'biao'zhang'huo'zan'teng'bei	0
