办公室保洁	ban'gong'shi'bao'jie	0
保洁阿姨	bao'jie'a'yi	0
保洁车辆	bao'jie'che'liang	0
保洁服务	bao'jie'fu'wu	0
保洁公司	bao'jie'gong'si	0
保洁合同	bao'jie'he'tong	0
保洁清洗	bao'jie'qing'xi	0
保洁托管	bao'jie'tuo'guan	0
保洁小时工	bao'jie'xiao'shi'gong	0
保洁用品	bao'jie'yong'pin	0
保姆	bao'mu	0
北京保洁	bei'jing'bao'jie	0
簸箕	bo'ji	0
厂房保洁	chang'fang'bao'jie	0
尘推	chen'tui	0
除胶剂	chu'jiao'ji	0
单位保洁	dan'wei'bao'jie	0
地毯清洗	di'tan'qing'xi	0
芳香球	fang'xiang'qiu	0
公司保洁	gong'si'bao'jie	0
环卫保洁	huan'wei'bao'jie	0
家庭保洁	jia'ting'bao'jie	0
家政保洁	jia'zheng'bao'jie	0
洁厕灵	jie'ce'ling	0
开荒保洁	kai'huang'bao'jie	0
垃圾袋	la'ji'dai	0
楼宇保洁	lou'yu'bao'jie	0
祺鑫保洁	qi'xin'bao'jie	0
企业保洁	qi'ye'bao'jie	0
清洁液	qing'jie'ye	0
清洁用品	qing'jie'yong'pin	0
日常保洁	ri'chang'bao'jie	0
扫把	sao'ba	0
腾旭保洁	teng'xu'bao'jie	0
腾旭企服	teng'xu'qi'fu	0
望京保洁	wang'jing'bao'jie	0
物业保洁	wu'ye'bao'jie	0
吸尘器	xi'chen'qi	0
消毒液	xiao'du'ye	0
展会保洁	zhan'hui'bao'jie	0
朝阳保洁	zhao'yang'bao'jie	0
驻场保洁	zhu'chang'bao'jie	0
专业保洁	zhuan'ye'bao'jie	0
