北定中原	bei'ding'zhong'yuan	0
必能裨补阙漏	bi'neng'bi'bu'que'lou	0
必能使行阵和睦	bi'neng'shi'hang'zhen'he'mu	0
陛下亦宜自谋	bi'xia'yi'yi'zi'mou	0
兵甲已足	bing'jia'yi'zu	0
不求闻达于诸侯	bu'qiu'wen'da'yu'zhu'hou	0
不效则治臣之罪	bu'xiao'ze'zhi'chen'zhi'zui	0
不宜偏私	bu'yi'pian'si	0
不宜妄自菲薄	bu'yi'wang'zi'fei'bo	0
不宜异同	bu'yi'yi'tong	0
不知所言	bu'zhi'suo'yan	0
察纳雅言	cha'na'ya'yan	0
臣本布衣	chen'ben'bu'yi	0
臣不胜受恩感激	chen'bu'sheng'shou'en'gan'ji	0
诚宜开张圣听	cheng'yi'kai'zhang'sheng'ting	0
此诚危急存亡之秋也	ci'cheng'wei'ji'cun'wang'zhi'qiu'ye	0
此后汉所以倾颓也	ci'hou'han'suo'yi'qing'tui'ye	0
此皆良实	ci'jie'liang'shi	0
此悉贞良死节之臣	ci'xi'zhen'liang'si'jie'zhi'chen	0
此先汉所以兴隆也	ci'xian'han'suo'yi'xing'long'ye	0
当奖率三军	dang'jiang'lv'san'jun	0
尔来二十有一年矣	er'lai'er'shi'you'yi'nian'yi	0
而中道崩殂	er'zhong'dao'beng'cu	0
奉命于危难之间	feng'ming'yu'wei'nan'zhi'jian	0
盖追先帝之殊遇	gai'zhui'xian'di'zhi'shu'yu	0
躬耕于南阳	gong'geng'yu'nan'yang	0
宫中府中	gong'zhong'fu'zhong	0
苟全性命于乱世	gou'quan'xing'ming'yu'luan'shi	0
故临崩寄臣以大事也	gu'lin'beng'ji'chen'yi'da'shi'ye	0
故五月渡泸	gu'wu'yue'du'lu	0
后值倾覆	hou'zhi'qing'fu	0
还于旧都	huan'yu'jiu'du	0
恢弘志士之气	hui'hong'zhi'shi'zhi'qi	0
及为忠善者	ji'wei'zhong'shan'zhe	0
将军向宠	jiang'jun'xiang'chong	0
今当远离	jin'dang'yuan'li	0
进尽忠言	jin'jin'zhong'yan	0
今南方已定	jin'nan'fang'yi'ding	0
今天下三分	jin'tian'xia'san'fen	0
俱为一体	ju'wei'yi'ti	0
可计日而待也	ke'ji'ri'er'dai'ye	0
恐托付不效	kong'tuo'fu'bu'xiao	0
临表涕零	lin'biao'ti'ling	0
每与臣论此事	mei'yu'chen'lun'ci'shi	0
亲贤臣	qin'xian'chen	0
亲小人	qin'xiao'ren	0
然后施行	ran'hou'shi'xing	0
然侍卫之臣不懈于内	ran'shi'wei'zhi'chen'bu'xie'yu'nei	0
攘除奸凶	rang'chu'jian'xiong	0
若无兴德之言	ruo'wu'xing'de'zhi'yan	0
若有作奸犯科	ruo'you'zuo'jian'fan'ke	0
三顾臣于草庐之中	san'gu'chen'yu'cao'lu'zhi'zhong	0
深入不毛	shen'ru'bu'mao	0
深追先帝遗诏	shen'zhui'xian'di'yi'zhao	0
使内外异法也	shi'nei'wai'yi'fa'ye	0
事无大小	shi'wu'da'xiao	0
是以先帝简拔以遗陛下	shi'yi'xian'di'jian'ba'yi'yi'bi'xia	0
是以众议举宠为督	shi'yi'zhong'yi'ju'chong'wei'du	0
试用于昔日	shi'yong'yu'xi'ri	0
侍中尚书长史参军	shi'zhong'shang'shu'zhang'shi'can'jun	0
侍中侍郎郭攸之费祎董允等	shi'zhong'shi'lang'guo'you'zhi'fei'yi'dong'yun'deng	0
受命以来	shou'ming'yi'lai	0
受任于败军之际	shou'ren'yu'bai'jun'zhi'ji	0
庶竭驽钝	shu'jie'nu'dun	0
夙夜忧叹	su'ye'you'tan	0
遂许先帝以驱驰	sui'xu'xian'di'yi'qu'chi	0
未尝不叹息痛恨于桓灵也	wei'chang'bu'tan'xi'tong'hen'yu'huan'ling'ye	0
猥自枉屈	wei'zi'wang'qu	0
悉以咨之	xi'yi'zi'zhi	0
先帝不以臣卑鄙	xian'di'bu'yi'chen'bei'bi	0
先帝称之曰能	xian'di'cheng'zhi'yue'neng	0
先帝创业未半	xian'di'chuang'ye'wei'ban	0
先帝在时	xian'di'zai'shi	0
先帝知臣谨慎	xian'di'zhi'chen'jin'shen	0
晓畅军事	xiao'chang'jun'shi	0
兴复汉室	xing'fu'han'shi	0
性行淑均	xing'xing'shu'jun	0
宜付有司论其刑赏	yi'fu'you'si'lun'qi'xing'shang	0
以告先帝之灵	yi'gao'xian'di'zhi'ling	0
以光先帝遗德	yi'guang'xian'di'yi'de	0
以塞忠谏之路也	yi'sai'zhong'jian'zhi'lu'ye	0
以伤先帝之明	yi'shang'xian'di'zhi'ming	0
以彰其咎	yi'zhang'qi'jiu	0
以昭陛下平明之理	yi'zhao'bi'xia'ping'ming'zhi'li	0
益州疲弊	yi'zhou'pi'bi	0
以咨诹善道	yi'zi'zou'shan'dao	0
引喻失义	yin'yu'shi'yi	0
优劣得所	you'lie'de'suo	0
由是感激	you'shi'gan'ji	0
有所广益	you'suo'guang'yi	0
欲报之于陛下也	yu'bao'zhi'yu'bi'xia'ye	0
愚以为宫中之事	yu'yi'wei'gong'zhong'zhi'shi	0
愚以为营中之事	yu'yi'wei'ying'zhong'zhi'shi	0
愿陛下亲之信之	yuan'bi'xia'qin'zhi'xin'zhi	0
愿陛下托臣以讨贼兴复之效	yuan'bi'xia'tuo'chen'yi'tao'zei'xing'fu'zhi'xiao	0
远贤臣	yuan'xian'chen	0
远小人	yuan'xiao'ren	0
则汉室之隆	ze'han'shi'zhi'long	0
则攸之祎允之任也	ze'you'zhi'yi'yun'zhi'ren'ye	0
则责攸之祎允等之慢	ze'ze'you'zhi'yi'yun'deng'zhi'man	0
陟罚臧否	zhi'fa'zang'pi	0
志虑忠纯	zhi'lv'zhong'chun	0
至于斟酌损益	zhi'yu'zhen'zhuo'sun'yi	0
忠志之士忘身于外者	zhong'zhi'zhi'shi'wang'shen'yu'wai'zhe	0
咨臣以当世之事	zi'chen'yi'dang'shi'zhi'shi	0
