安全	an'quan	0
安全阀	an'quan'fa	0
安全生产	an'quan'sheng'chan	0
安全卫生	an'quan'wei'sheng	0
安全要求	an'quan'yao'qiu	0
安装	an'zhuang	0
安装材料	an'zhuang'cai'liao	0
安装材料表	an'zhuang'cai'liao'biao	0
安装工程	an'zhuang'gong'cheng	0
安装条件	an'zhuang'tiao'jian	0
安装要求	an'zhuang'yao'qiu	0
版本	ban'ben	0
半成品	ban'cheng'pin	0
办公楼	ban'gong'lou	0
保湿设计	bao'shi'she'ji	0
备用原则	bei'yong'yuan'ze	0
泵房	beng'fang	0
必要性	bi'yao'xing	0
变电配电室	bian'dian'pei'dian'shi	0
编制项目建议书	bian'zhi'xiang'mu'jian'yi'shu	0
标的	biao'di	0
标高	biao'gao	0
标准	biao'zhun	0
标准办	biao'zhun'ban	0
标准化	biao'zhun'hua	0
标准设计	biao'zhun'she'ji	0
标准设计图集	biao'zhun'she'ji'tu'ji	0
标准图例	biao'zhun'tu'li	0
不合理	bu'he'li	0
布局方案	bu'ju'fang'an	0
不可能	bu'ke'neng	0
布置方案	bu'zhi'fang'an	0
布置图	bu'zhi'tu	0
不足之处	bu'zu'zhi'chu	0
材料	cai'liao	0
材料表	cai'liao'biao	0
材料采购	cai'liao'cai'gou	0
材料选择	cai'liao'xuan'ze	0
采暖	cai'nuan	0
采暖通风	cai'nuan'tong'feng	0
财务审计	cai'wu'shen'ji	0
材质	cai'zhi	0
参观	can'guan	0
槽车	cao'che	0
槽船	cao'chuan	0
操作参数	cao'zuo'can'shu	0
操作方便	cao'zuo'fang'bian	0
操作负荷	cao'zuo'fu'he	0
操作规程	cao'zuo'gui'cheng	0
操作人员	cao'zuo'ren'yuan	0
操作时间	cao'zuo'shi'jian	0
操作水平	cao'zuo'shui'ping	0
操作条件	cao'zuo'tiao'jian	0
操作压力	cao'zuo'ya'li	0
操作状态	cao'zuo'zhuang'tai	0
查资料	cha'zi'liao	0
产量	chan'liang	0
产品方案	chan'pin'fang'an	0
产品分离	chan'pin'fen'li	0
产品规格	chan'pin'gui'ge	0
产品精制	chan'pin'jing'zhi	0
产品需求	chan'pin'xu'qiu	0
产品质量	chan'pin'zhi'liang	0
常规操作	chang'gui'cao'zuo	0
常规仪表	chang'gui'yi'biao	0
厂区给水	chang'qu'gei'shui	0
厂区排水	chang'qu'pai'shui	0
厂址	chang'zhi	0
厂址复查	chang'zhi'fu'cha	0
厂址区域	chang'zhi'qu'yu	0
厂址踏勘	chang'zhi'ta'kan	0
厂址选择	chang'zhi'xuan'ze	0
超高压	chao'gao'ya	0
车间配电	che'jian'pei'dian	0
衬里	chen'li	0
承包合同	cheng'bao'he'tong	0
成本低	cheng'ben'di	0
成本估算	cheng'ben'gu'suan	0
成品	cheng'pin	0
成品工段	cheng'pin'gong'duan	0
成熟程度	cheng'shu'cheng'du	0
筹备组	chou'bei'zu	0
初步方案	chu'bu'fang'an	0
初步估算	chu'bu'gu'suan	0
初步规划	chu'bu'gui'hua	0
初步设计	chu'bu'she'ji	0
初步设计阶段	chu'bu'she'ji'jie'duan	0
初步设计说明书	chu'bu'she'ji'shuo'ming'shu	0
初步预测	chu'bu'yu'ce	0
初勘	chu'kan	0
初勘要求	chu'kan'yao'qiu	0
处理原则	chu'li'yuan'ze	0
传动设备	chuan'dong'she'bei	0
创造性	chuang'zao'xing	0
纯碱厂	chun'jian'chang	0
粗馏	cu'liu	0
催化剂	cui'hua'ji	0
存在问题	cun'zai'wen'ti	0
大型	da'xing	0
大型化工厂	da'xing'hua'gong'chang	0
大型容器	da'xing'rong'qi	0
大型项目	da'xing'xiang'mu	0
带控制点	dai'kong'zhi'dian	0
单位产品	dan'wei'chan'pin	0
单位时间	dan'wei'shi'jian	0
单项工程	dan'xiang'gong'cheng	0
氮氧站	dan'yang'zhan	0
单元设备	dan'yuan'she'bei	0
地方材料	di'fang'cai'liao	0
地区管理	di'qu'guan'li	0
低温高压	di'wen'gao'ya	0
低压	di'ya	0
地质初勘	di'zhi'chu'kan	0
地质勘察	di'zhi'kan'cha	0
电表	dian'biao	0
电缆	dian'lan	0
电力供应	dian'li'gong'ying	0
电气	dian'qi	0
电气工程	dian'qi'gong'cheng	0
电气仪表	dian'qi'yi'biao	0
电网	dian'wang	0
电修	dian'xiu	0
电源	dian'yuan	0
电源配置	dian'yuan'pei'zhi	0
电源状况	dian'yuan'zhuang'kuang	0
调查	diao'cha	0
调查研究	diao'cha'yan'jiu	0
调研报告	diao'yan'bao'gao	0
动力电源	dong'li'dian'yuan	0
动力供应	dong'li'gong'ying	0
动力用电	dong'li'yong'dian	0
动力用电负荷	dong'li'yong'dian'fu'he	0
动设备	dong'she'bei	0
毒性	du'xing	0
法规	fa'gui	0
法人代表	fa'ren'dai'biao	0
发展规划	fa'zhan'gui'hua	0
发展情况	fa'zhan'qing'kuang	0
发展余地	fa'zhan'yu'di	0
反复比较	fan'fu'bi'jiao	0
返工	fan'gong	0
反应	fan'ying	0
反应步骤	fan'ying'bu'zhou	0
反应器	fan'ying'qi	0
反应原理	fan'ying'yuan'li	0
方案设计	fang'an'she'ji	0
方案审核	fang'an'shen'he	0
防爆	fang'bao	0
防范评价	fang'fan'ping'jia	0
防腐蚀	fang'fu'shi	0
防腐涂料	fang'fu'tu'liao	0
防火规范	fang'huo'gui'fan	0
非标设备	fei'biao'she'bei	0
非常规	fei'chang'gui	0
非常规操作	fei'chang'gui'cao'zuo	0
非定型	fei'ding'xing	0
非定型设备	fei'ding'xing'she'bei	0
非工艺专业	fei'gong'yi'zhuan'ye	0
废气	fei'qi	0
非生产部门	fei'sheng'chan'bu'men	0
废水处理	fei'shui'chu'li	0
废渣	fei'zha	0
非正常生产	fei'zheng'chang'sheng'chan	0
非正常停车	fei'zheng'chang'ting'che	0
分级	fen'ji	0
分离器	fen'li'qi	0
分期建设	fen'qi'jian'she	0
分析认证	fen'xi'ren'zheng	0
分析预测	fen'xi'yu'ce	0
分项	fen'xiang	0
分项负责人	fen'xiang'fu'ze'ren	0
风机	feng'ji	0
风险程度	feng'xian'cheng'du	0
复查厂址	fu'cha'chang'zhi	0
副反应	fu'fan'ying	0
负荷等级	fu'he'deng'ji	0
符合国情	fu'he'guo'qing	0
腐蚀性	fu'shi'xing	0
复用设计	fu'yong'she'ji	0
复杂程度	fu'za'cheng'du	0
复杂性	fu'za'xing	0
负责人	fu'ze'ren	0
辅助部门	fu'zhu'bu'men	0
辅助工程	fu'zhu'gong'cheng	0
辅助设施	fu'zhu'she'shi	0
辅助生产部门	fu'zhu'sheng'chan'bu'men	0
改革开放	gai'ge'kai'fang	0
概念设计	gai'nian'she'ji	0
概算	gai'suan	0
概算书	gai'suan'shu	0
概算资料	gai'suan'zi'liao	0
干燥剂	gan'zao'ji	0
岗位操作法	gang'wei'cao'zuo'fa	0
高温高压	gao'wen'gao'ya	0
高压	gao'ya	0
高压配电室	gao'ya'pei'dian'shi	0
给水处理	gei'shui'chu'li	0
给水水源	gei'shui'shui'yuan	0
更衣室	geng'yi'shi	0
工厂运输	gong'chang'yun'shu	0
工厂组成	gong'chang'zu'cheng	0
工程拨款	gong'cheng'bo'kuan	0
工程成品	gong'cheng'cheng'pin	0
工程地质	gong'cheng'di'zhi	0
工程技术人员	gong'cheng'ji'shu'ren'yuan	0
工程建设	gong'cheng'jian'she	0
工程进度	gong'cheng'jin'du	0
工程进度表	gong'cheng'jin'du'biao	0
工程设计	gong'cheng'she'ji	0
工程设计行业	gong'cheng'she'ji'hang'ye	0
工程设计组	gong'cheng'she'ji'zu	0
工程师	gong'cheng'shi	0
工程施工	gong'cheng'shi'gong	0
工程问题	gong'cheng'wen'ti	0
工程项目	gong'cheng'xiang'mu	0
工程消耗	gong'cheng'xiao'hao	0
公称直径	gong'cheng'zhi'jing	0
工程质量	gong'cheng'zhi'liang	0
工程资料	gong'cheng'zi'liao	0
工程总结	gong'cheng'zong'jie	0
供电安装图	gong'dian'an'zhuang'tu	0
工具书	gong'ju'shu	0
供热	gong're	0
供热管线	gong're'guan'xian	0
供水温度	gong'shui'wen'du	0
供水压力	gong'shui'ya'li	0
工业安全	gong'ye'an'quan	0
工业炉	gong'ye'lu	0
工业生产	gong'ye'sheng'chan	0
工业装置	gong'ye'zhuang'zhi	0
工艺	gong'yi	0
工艺参数	gong'yi'can'shu	0
工艺成熟	gong'yi'cheng'shu	0
工艺成熟程度	gong'yi'cheng'shu'cheng'du	0
工艺过程	gong'yi'guo'cheng	0
工艺技术路线	gong'yi'ji'shu'lu'xian	0
工艺计算	gong'yi'ji'suan	0
工艺介质	gong'yi'jie'zhi	0
工艺流程	gong'yi'liu'cheng	0
工艺流程图	gong'yi'liu'cheng'tu	0
工艺路线	gong'yi'lu'xian	0
工艺设计	gong'yi'she'ji	0
工艺设计人员	gong'yi'she'ji'ren'yuan	0
工艺数据	gong'yi'shu'ju	0
工艺特点	gong'yi'te'dian	0
工艺图纸	gong'yi'tu'zhi	0
工艺图纸目录	gong'yi'tu'zhi'mu'lu	0
工艺专业	gong'yi'zhuan'ye	0
工艺资料	gong'yi'zi'liao	0
供应方式	gong'ying'fang'shi	0
公用工程	gong'yong'gong'cheng	0
公用工程系统图	gong'yong'gong'cheng'xi'tong'tu	0
工作量	gong'zuo'liang	0
工作能力	gong'zuo'neng'li	0
构筑物	gou'zhu'wu	0
固定资产	gu'ding'zi'chan	0
估算	gu'suan	0
管道	guan'dao	0
管道安装	guan'dao'an'zhuang	0
管道布置图	guan'dao'bu'zhi'tu	0
管道材料	guan'dao'cai'liao	0
管道工程	guan'dao'gong'cheng	0
管道设计	guan'dao'she'ji	0
管架	guan'jia	0
管架管件图	guan'jia'guan'jian'tu	0
管件	guan'jian	0
关键设备	guan'jian'she'bei	0
管理部门	guan'li'bu'men	0
管理工作	guan'li'gong'zuo	0
罐区	guan'qu	0
规范	gui'fan	0
规范标准	gui'fan'biao'zhun	0
规划布局	gui'hua'bu'ju	0
规划局	gui'hua'ju	0
规章制度	gui'zhang'zhi'du	0
国际标准化	guo'ji'biao'zhun'hua	0
国家标准	guo'jia'biao'zhun	0
国家规划	guo'jia'gui'hua	0
国家级大型项目	guo'jia'ji'da'xing'xiang'mu	0
国家政策	guo'jia'zheng'ce	0
锅炉房	guo'lu'fang	0
国外技术	guo'wai'ji'shu	0
国外文献	guo'wai'wen'xian	0
耗能装置	hao'neng'zhuang'zhi	0
合成氨	he'cheng'an	0
合成氨厂	he'cheng'an'chang	0
合成树脂	he'cheng'shu'zhi	0
合成树脂工业	he'cheng'shu'zhi'gong'ye	0
合成纤维	he'cheng'xian'wei	0
合成纤维工业	he'cheng'xian'wei'gong'ye	0
合成橡胶	he'cheng'xiang'jiao	0
合成橡胶厂	he'cheng'xiang'jiao'chang	0
合成橡胶工业	he'cheng'xiang'jiao'gong'ye	0
合理的	he'li'de	0
合理性	he'li'xing	0
合同评审	he'tong'ping'shen	0
后期服务	hou'qi'fu'wu	0
后期建设	hou'qi'jian'she	0
后勤行政人员	hou'qin'xing'zheng'ren'yuan	0
化工产品	hua'gong'chan'pin	0
化工产品生产	hua'gong'chan'pin'sheng'chan	0
化工厂	hua'gong'chang	0
化工工程	hua'gong'gong'cheng	0
化工工艺流程	hua'gong'gong'yi'liu'cheng	0
化工管道	hua'gong'guan'dao	0
化工行业	hua'gong'hang'ye	0
化工联合企业	hua'gong'lian'he'qi'ye	0
化工设备	hua'gong'she'bei	0
化工设计	hua'gong'she'ji	0
化工设计管理标准	hua'gong'she'ji'guan'li'biao'zhun	0
化工生产装置	hua'gong'sheng'chan'zhuang'zhi	0
化工装置	hua'gong'zhuang'zhi	0
化学反应	hua'xue'fan'ying	0
化学肥料	hua'xue'fei'liao	0
化学肥料工业	hua'xue'fei'liao'gong'ye	0
化学工程	hua'xue'gong'cheng	0
化学工程数据	hua'xue'gong'cheng'shu'ju	0
化学工业	hua'xue'gong'ye	0
化学品	hua'xue'pin	0
化学纤维单体	hua'xue'xian'wei'dan'ti	0
环保标准	huan'bao'biao'zhun	0
环保措施	huan'bao'cuo'shi	0
环保管理	huan'bao'guan'li	0
环保局	huan'bao'ju	0
环保投资	huan'bao'tou'zi	0
环保投资概算	huan'bao'tou'zi'gai'suan	0
环境保护	huan'jing'bao'hu	0
环境保护措施	huan'jing'bao'hu'cuo'shi	0
环境工程	huan'jing'gong'cheng	0
环境监测	huan'jing'jian'ce	0
环境监测体制	huan'jing'jian'ce'ti'zhi	0
环境特征	huan'jing'te'zheng	0
环境污染	huan'jing'wu'ran	0
换热器	huan're'qi	0
磺化	huang'hua	0
回访	hui'fang	0
会鉴	hui'jian	0
回收工段	hui'shou'gong'duan	0
回水	hui'shui	0
回水温度	hui'shui'wen'du	0
回水压力	hui'shui'ya'li	0
火车槽车	huo'che'cao'che	0
基本程序	ji'ben'cheng'xu	0
基本概念	ji'ben'gai'nian	0
基本建设项目	ji'ben'jian'she'xiang'mu	0
基础经济数据	ji'chu'jing'ji'shu'ju	0
基础设计	ji'chu'she'ji	0
基础研究	ji'chu'yan'jiu	0
基础知识	ji'chu'zhi'shi	0
基础资料	ji'chu'zi'liao	0
机构分支	ji'gou'fen'zhi	0
机关人员	ji'guan'ren'yuan	0
计划管理部门	ji'hua'guan'li'bu'men	0
基建费用	ji'jian'fei'yong	0
基建投资	ji'jian'tou'zi	0
积累经验	ji'lei'jing'yan	0
给排水	ji'pai'shui	0
给排水安装图	ji'pai'shui'an'zhuang'tu	0
机器设备	ji'qi'she'bei	0
技术方案	ji'shu'fang'an	0
技术改造	ji'shu'gai'zao	0
技术改造项目	ji'shu'gai'zao'xiang'mu	0
技术改造项目设计	ji'shu'gai'zao'xiang'mu'she'ji	0
技术工作	ji'shu'gong'zuo	0
技术管理部门	ji'shu'guan'li'bu'men	0
技术规格	ji'shu'gui'ge	0
技术进步	ji'shu'jin'bu	0
技术经济	ji'shu'jing'ji	0
技术经济条件	ji'shu'jing'ji'tiao'jian	0
技术经济指标	ji'shu'jing'ji'zhi'biao	0
技术开发	ji'shu'kai'fa	0
技术考察	ji'shu'kao'cha	0
技术来源	ji'shu'lai'yuan	0
技术路线	ji'shu'lu'xian	0
技术软件	ji'shu'ruan'jian	0
技术上	ji'shu'shang	0
技术水平	ji'shu'shui'ping	0
技术特征	ji'shu'te'zheng	0
技术条件	ji'shu'tiao'jian	0
技术问题	ji'shu'wen'ti	0
技术要点	ji'shu'yao'dian	0
技术员	ji'shu'yuan	0
技术政策	ji'shu'zheng'ce	0
计算单位	ji'suan'dan'wei	0
计算方法	ji'suan'fang'fa	0
集体成果	ji'ti'cheng'guo	0
机械厂	ji'xie'chang	0
机修	ji'xiu	0
机修车间	ji'xiu'che'jian	0
甲苯	jia'ben	0
加工厂	jia'gong'chang	0
加工过程	jia'gong'guo'cheng	0
假想设计	jia'xiang'she'ji	0
监测站	jian'ce'zhan	0
建厂地区	jian'chang'di'qu	0
建厂条件	jian'chang'tiao'jian	0
鉴定报告	jian'ding'bao'gao	0
监督活动	jian'du'huo'dong	0
健康	jian'kang	0
监理	jian'li	0
监理部门	jian'li'bu'men	0
监理单位	jian'li'dan'wei	0
监理合同	jian'li'he'tong	0
碱熔	jian'rong	0
建设	jian'she	0
建设程序	jian'she'cheng'xu	0
建设单位	jian'she'dan'wei	0
建设合同	jian'she'he'tong	0
建设进展	jian'she'jin'zhan	0
建设前期	jian'she'qian'qi	0
建设项目	jian'she'xiang'mu	0
建设造价	jian'she'zao'jia	0
间歇操作	jian'xie'cao'zuo	0
碱性废水	jian'xing'fei'shui	0
建修	jian'xiu	0
检修	jian'xiu	0
建议	jian'yi	0
建议单位	jian'yi'dan'wei	0
建议书	jian'yi'shu	0
建筑材料	jian'zhu'cai'liao	0
建筑设计	jian'zhu'she'ji	0
建筑施工	jian'zhu'shi'gong	0
校对	jiao'dui	0
交接条件	jiao'jie'tiao'jian	0
交通运输	jiao'tong'yun'shu	0
阶段设计	jie'duan'she'ji	0
结构设计	jie'gou'she'ji	0
结焦	jie'jiao	0
结晶器	jie'jing'qi	0
解决问题	jie'jue'wen'ti	0
接力泵	jie'li'beng	0
结论	jie'lun	0
节能措施	jie'neng'cuo'shi	0
节能效益	jie'neng'xiao'yi	0
界区	jie'qu	0
界区线	jie'qu'xian	0
接受任务	jie'shou'ren'wu	0
节约用地	jie'yue'yong'di	0
进料预处理	jin'liao'yu'chu'li	0
竞标	jing'biao	0
经济分析	jing'ji'fen'xi	0
经济评价	jing'ji'ping'jia	0
经济上	jing'ji'shang	0
经济损失	jing'ji'sun'shi	0
经济条件	jing'ji'tiao'jian	0
经济效益	jing'ji'xiao'yi	0
经济效益评价	jing'ji'xiao'yi'ping'jia	0
经济性	jing'ji'xing	0
经济要求	jing'ji'yao'qiu	0
经济政策	jing'ji'zheng'ce	0
经济指标	jing'ji'zhi'biao	0
精馏	jing'liu	0
精细化工	jing'xi'hua'gong	0
精心设计	jing'xin'she'ji	0
经验丰富	jing'yan'feng'fu	0
经营管理	jing'ying'guan'li	0
竞争性	jing'zheng'xing	0
精制	jing'zhi	0
静止设备	jing'zhi'she'bei	0
聚合	ju'he	0
具体化	ju'ti'hua	0
具体结构	ju'ti'jie'gou	0
具体情况	ju'ti'qing'kuang	0
具体要求	ju'ti'yao'qiu	0
绝对速率	jue'dui'su'lv	0
决算书	jue'suan'shu	0
绝压	jue'ya	0
竣工	jun'gong	0
竣工图	jun'gong'tu	0
竣工验收	jun'gong'yan'shou	0
开车	kai'che	0
开发部门	kai'fa'bu'men	0
开发过程	kai'fa'guo'cheng	0
开发阶段	kai'fa'jie'duan	0
开发项目	kai'fa'xiang'mu	0
开发周期	kai'fa'zhou'qi	0
开工报告	kai'gong'bao'gao	0
开工报告会	kai'gong'bao'gao'hui	0
勘察	kan'cha	0
勘察设计	kan'cha'she'ji	0
勘察设计阶段	kan'cha'she'ji'jie'duan	0
考核	kao'he	0
可操作	ke'cao'zuo	0
可靠程度	ke'kao'cheng'du	0
可靠性	ke'kao'xing	0
可控制	ke'kong'zhi	0
可能性	ke'neng'xing	0
可行方案	ke'xing'fang'an	0
可行性	ke'xing'xing	0
可行性研究	ke'xing'xing'yan'jiu	0
可行性研究报告	ke'xing'xing'yan'jiu'bao'gao	0
可行性研究阶段	ke'xing'xing'yan'jiu'jie'duan	0
可行研究报告	ke'xing'yan'jiu'bao'gao	0
科学方法	ke'xue'fang'fa	0
科学技术	ke'xue'ji'shu	0
空气调节	kong'qi'tiao'jie	0
空气站	kong'qi'zhan	0
空压站	kong'ya'zhan	0
控制	kong'zhi	0
控制参数	kong'zhi'can'shu	0
控制点	kong'zhi'dian	0
控制方案	kong'zhi'fang'an	0
控制生产	kong'zhi'sheng'chan	0
控制室	kong'zhi'shi	0
控制投资	kong'zhi'tou'zi	0
控制系统	kong'zhi'xi'tong	0
控制要求	kong'zhi'yao'qiu	0
控制原则	kong'zhi'yuan'ze	0
矿产资源	kuang'chan'zi'yuan	0
扩建	kuo'jian	0
劳动安全	lao'dong'an'quan	0
劳动安全局	lao'dong'an'quan'ju	0
劳动保护	lao'dong'bao'hu	0
劳动就业	lao'dong'jiu'ye	0
冷冻	leng'dong	0
冷冻站	leng'dong'zhan	0
冷却水	leng'que'shui	0
冷却塔	leng'que'ta	0
立面布置	li'mian'bu'zhi	0
利润	li'run	0
立项	li'xiang	0
立项过程	li'xiang'guo'cheng	0
联合企业	lian'he'qi'ye	0
联锁	lian'suo	0
连续操作	lian'xu'cao'zuo	0
连续化生产	lian'xu'hua'sheng'chan	0
连续运转时间	lian'xu'yun'zhuan'shi'jian	0
炼油厂	lian'you'chang	0
磷肥厂	lin'fei'chang	0
磷矿	lin'kuang	0
流程	liu'cheng	0
流程草图	liu'cheng'cao'tu	0
流程设计	liu'cheng'she'ji	0
流程图	liu'cheng'tu	0
流动资产	liu'dong'zi'chan	0
流动资金	liu'dong'zi'jin	0
流速	liu'su	0
硫酸厂	liu'suan'chang	0
流体	liu'ti	0
流体力学	liu'ti'li'xue	0
流体流程	liu'ti'liu'cheng	0
硫铁矿	liu'tie'kuang	0
卤化物	lu'hua'wu	0
轮廓设想	lun'kuo'she'xiang	0
煤渣	mei'zha	0
门卫	men'wei	0
内部约束条件	nei'bu'yue'shu'tiao'jian	0
能耗状况	neng'hao'zhuang'kuang	0
能量衡算	neng'liang'heng'suan	0
年操作时间	nian'cao'zuo'shi'jian	0
年产	nian'chan	0
尿素	niao'su	0
农药厂	nong'yao'chang	0
农药工业	nong'yao'gong'ye	0
农药化工厂	nong'yao'hua'gong'chang	0
排放标准	pai'fang'biao'zhun	0
配电室	pei'dian'shi	0
配套装置	pei'tao'zhuang'zhi	0
评定卡	ping'ding'ka	0
评价意见	ping'jia'yi'jian	0
凭借经验	ping'jie'jing'yan	0
平均故障	ping'jun'gu'zhang	0
平均故障工作时间	ping'jun'gu'zhang'gong'zuo'shi'jian	0
平均修复时间	ping'jun'xiu'fu'shi'jian	0
平面布置	ping'mian'bu'zhi	0
汽车槽车	qi'che'cao'che	0
其他动力	qi'ta'dong'li	0
其他化学工业	qi'ta'hua'xue'gong'ye	0
其他文件	qi'ta'wen'jian	0
其他资料	qi'ta'zi'liao	0
气体净化	qi'ti'jing'hua	0
气象资料	qi'xiang'zi'liao	0
企业单位	qi'ye'dan'wei	0
企业法人	qi'ye'fa'ren	0
企业性质	qi'ye'xing'zhi	0
前期工作	qian'qi'gong'zuo	0
强碱	qiang'jian	0
强酸	qiang'suan	0
氢气	qing'qi	0
全过程	quan'guo'cheng	0
全系统	quan'xi'tong	0
炔烃	que'ting	0
燃料	ran'liao	0
染料涂料	ran'liao'tu'liao	0
染料涂料工业	ran'liao'tu'liao'gong'ye	0
热工	re'gong	0
热量衡算	re'liang'heng'suan	0
人工控制	ren'gong'kong'zhi	0
人力	ren'li	0
人员配备	ren'yuan'pei'bei	0
人员配置	ren'yuan'pei'zhi	0
日用化工厂	ri'yong'hua'gong'chang	0
融化	rong'hua	0
容器	rong'qi	0
熔烧	rong'shao	0
三废	san'fei	0
三废处理	san'fei'chu'li	0
三废治理方案	san'fei'zhi'li'fang'an	0
筛选	shai'xuan	0
上级部门	shang'ji'bu'men	0
烧碱厂	shao'jian'chang	0
设备	she'bei	0
设备安装	she'bei'an'zhuang	0
设备安装图	she'bei'an'zhuang'tu	0
设备备用	she'bei'bei'yong	0
设备布置	she'bei'bu'zhi	0
设备布置图	she'bei'bu'zhi'tu	0
设备采购	she'bei'cai'gou	0
设备材料	she'bei'cai'liao	0
设备订货	she'bei'ding'huo	0
设备管口方位图	she'bei'guan'kou'fang'wei'tu	0
设备设计	she'bei'she'ji	0
设备特性	she'bei'te'xing	0
设备型号	she'bei'xing'hao	0
设备选择	she'bei'xuan'ze	0
设备仪表	she'bei'yi'biao	0
设备一览表	she'bei'yi'lan'biao	0
设备制造	she'bei'zhi'zao	0
设备专业	she'bei'zhuan'ye	0
设备总图	she'bei'zong'tu	0
设定值	she'ding'zhi	0
社会效益	she'hui'xiao'yi	0
社会效益评价	she'hui'xiao'yi'ping'jia	0
设计	she'ji	0
设计班子	she'ji'ban'zi	0
设计标准	she'ji'biao'zhun	0
设计参数	she'ji'can'shu	0
设计成品	she'ji'cheng'pin	0
设计程序	she'ji'cheng'xu	0
设计单位	she'ji'dan'wei	0
设计对象	she'ji'dui'xiang	0
设计方案	she'ji'fang'an	0
设计费用	she'ji'fei'yong	0
设计工作	she'ji'gong'zuo	0
设计工作基本程序	she'ji'gong'zuo'ji'ben'cheng'xu	0
设计工作者	she'ji'gong'zuo'zhe	0
设计管理	she'ji'guan'li	0
设计过程	she'ji'guo'cheng	0
设计合同	she'ji'he'tong	0
设计回访	she'ji'hui'fang	0
设计基础	she'ji'ji'chu	0
设计机构	she'ji'ji'gou	0
设计计划	she'ji'ji'hua	0
设计进度	she'ji'jin'du	0
设计考虑	she'ji'kao'lv	0
设计内容	she'ji'nei'rong	0
设计能力	she'ji'neng'li	0
设计前期工作报告	she'ji'qian'qi'gong'zuo'bao'gao	0
设计任务	she'ji'ren'wu	0
设计人员	she'ji'ren'yuan	0
设计室	she'ji'shi	0
设计时间	she'ji'shi'jian	0
设计说明书	she'ji'shuo'ming'shu	0
设计思路	she'ji'si'lu	0
设计思想	she'ji'si'xiang	0
设计条件	she'ji'tiao'jian	0
设计图集	she'ji'tu'ji	0
设计图纸	she'ji'tu'zhi	0
设计文件	she'ji'wen'jian	0
设计项目	she'ji'xiang'mu	0
设计项目负责人	she'ji'xiang'mu'fu'ze'ren	0
设计要求	she'ji'yao'qiu	0
设计依据	she'ji'yi'ju	0
设计院	she'ji'yuan	0
设计原则	she'ji'yuan'ze	0
设计指标	she'ji'zhi'biao	0
设计质量	she'ji'zhi'liang	0
设计种类	she'ji'zhong'lei	0
设计准备	she'ji'zhun'bei	0
设计总负责人	she'ji'zong'fu'ze'ren	0
审核	shen'he	0
审核意见	shen'he'yi'jian	0
审批立项	shen'pi'li'xiang	0
生产	sheng'chan	0
生产报表	sheng'chan'bao'biao	0
生产部门	sheng'chan'bu'men	0
生产步骤	sheng'chan'bu'zhou	0
生产车间	sheng'chan'che'jian	0
生产方法	sheng'chan'fang'fa	0
生产方式	sheng'chan'fang'shi	0
生产服务	sheng'chan'fu'wu	0
生产工段	sheng'chan'gong'duan	0
生产管理	sheng'chan'guan'li	0
生产规模	sheng'chan'gui'mo	0
生产过程	sheng'chan'guo'cheng	0
生产技术	sheng'chan'ji'shu	0
生产经营	sheng'chan'jing'ying	0
生产连续	sheng'chan'lian'xu	0
生产流程叙述	sheng'chan'liu'cheng'xu'shu	0
生产能力	sheng'chan'neng'li	0
生产人员	sheng'chan'ren'yuan	0
生产实践	sheng'chan'shi'jian	0
生产稳定	sheng'chan'wen'ding	0
生产要求	sheng'chan'yao'qiu	0
生产装置	sheng'chan'zhuang'zhi	0
生活部门	sheng'huo'bu'men	0
市场调研	shi'chang'diao'yan	0
市场需求	shi'chang'xu'qiu	0
市场预测	shi'chang'yu'ce	0
试车	shi'che	0
施工	shi'gong	0
施工安装	shi'gong'an'zhuang	0
施工单位	shi'gong'dan'wei	0
施工阶段	shi'gong'jie'duan	0
施工结束	shi'gong'jie'shu	0
施工配合	shi'gong'pei'he	0
施工说明	shi'gong'shuo'ming	0
施工说明书	shi'gong'shuo'ming'shu	0
施工条件	shi'gong'tiao'jian	0
施工图	shi'gong'tu	0
施工图设计	shi'gong'tu'she'ji	0
施工图设计阶段	shi'gong'tu'she'ji'jie'duan	0
施工图纸	shi'gong'tu'zhi	0
施工质量	shi'gong'zhi'liang	0
事故处理	shi'gu'chu'li	0
石灰厂矿	shi'hui'chang'kuang	0
实际生产时间	shi'ji'sheng'chan'shi'jian	0
势力	shi'li	0
实施方案	shi'shi'fang'an	0
实施规则	shi'shi'gui'ze	0
食堂	shi'tang	0
试验阶段	shi'yan'jie'duan	0
实验室	shi'yan'shi	0
适应范围	shi'ying'fan'wei	0
使用条件	shi'yong'tiao'jian	0
使用原则	shi'yong'yuan'ze	0
石油化工	shi'you'hua'gong	0
石油化工厂	shi'you'hua'gong'chang	0
收集资料	shou'ji'zi'liao	0
数据	shu'ju	0
输水管道	shu'shui'guan'dao	0
输送设备	shu'song'she'bei	0
竖向布置	shu'xiang'bu'zhi	0
数字模型法	shu'zi'mo'xing'fa	0
水文地质	shui'wen'di'zhi	0
水文地质资料	shui'wen'di'zhi'zi'liao	0
水文勘察	shui'wen'kan'cha	0
水源	shui'yuan	0
水质处理	shui'zhi'chu'li	0
搜集资料	sou'ji'zi'liao	0
塑料	su'liao	0
塑料厂	su'liao'chang	0
塑料工业	su'liao'gong'ye	0
酸性废水	suan'xing'fei'shui	0
踏勘	ta'kan	0
特殊措施	te'shu'cuo'shi	0
特殊管道	te'shu'guan'dao	0
特殊情况	te'shu'qing'kuang	0
特殊要求	te'shu'yao'qiu	0
特殊仪表	te'shu'yi'biao	0
提纯	ti'chun	0
条件范围	tiao'jian'fan'wei	0
同时满足	tong'shi'man'zu	0
通用设计	tong'yong'she'ji	0
投标	tou'biao	0
投产	tou'chan	0
投资	tou'zi	0
投资包干	tou'zi'bao'gan	0
投资额	tou'zi'e	0
投资费用	tou'zi'fei'yong	0
投资估算	tou'zi'gu'suan	0
投资回收期	tou'zi'hui'shou'qi	0
投资结算	tou'zi'jie'suan	0
投资利润率	tou'zi'li'run'lv	0
投资情况	tou'zi'qing'kuang	0
投资项目	tou'zi'xiang'mu	0
投资兴建	tou'zi'xing'jian	0
土建	tu'jian	0
土建施工图	tu'jian'shi'gong'tu	0
涂料	tu'liao	0
推荐方案	tui'jian'fang'an	0
外部工艺	wai'bu'gong'yi	0
外部评审	wai'bu'ping'shen	0
外部条件	wai'bu'tiao'jian	0
外部约束条件	wai'bu'yue'shu'tiao'jian	0
外汇储备	wai'hui'chu'bei	0
烷烃	wan'ting	0
维护检修规程	wei'hu'jian'xiu'gui'cheng	0
微机	wei'ji	0
微机控制	wei'ji'kong'zhi	0
卫生防疫站	wei'sheng'fang'yi'zhan	0
卫生要求	wei'sheng'yao'qiu	0
委托	wei'tuo	0
委托设计	wei'tuo'she'ji	0
危险	wei'xian	0
危险程度	wei'xian'cheng'du	0
危险区	wei'xian'qu	0
维修	wei'xiu	0
维修任务	wei'xiu'ren'wu	0
稳定性	wen'ding'xing	0
温度	wen'du	0
文件	wen'jian	0
文献资料	wen'xian'zi'liao	0
文字注解	wen'zi'zhu'jie	0
污垢系数	wu'gou'xi'shu	0
无机化学	wu'ji'hua'xue	0
无机化学工业	wu'ji'hua'xue'gong'ye	0
物料表	wu'liao'biao	0
物料处理	wu'liao'chu'li	0
物料衡算	wu'liao'heng'suan	0
物料流程图	wu'liao'liu'cheng'tu	0
物料平衡	wu'liao'ping'heng	0
物流组成	wu'liu'zu'cheng	0
污染物	wu'ran'wu	0
污染源	wu'ran'yuan	0
污水处理	wu'shui'chu'li	0
物资	wu'zi	0
吸收	xi'shou	0
吸收塔	xi'shou'ta	0
烯烃	xi'ting	0
系统的	xi'tong'de	0
系统物料	xi'tong'wu'liao	0
下列要求	xia'lie'yao'qiu	0
现场情况	xian'chang'qing'kuang	0
现场施工	xian'chang'shi'gong	0
现代化	xian'dai'hua	0
现代化化工厂	xian'dai'hua'hua'gong'chang	0
先进程度	xian'jin'cheng'du	0
先进性	xian'jin'xing	0
相当规模	xiang'dang'gui'mo	0
相对速度	xiang'dui'su'du	0
橡胶厂	xiang'jiao'chang	0
橡胶轮胎加工厂	xiang'jiao'lun'tai'jia'gong'chang	0
详勘	xiang'kan	0
详勘要求	xiang'kan'yao'qiu	0
项目筹备组	xiang'mu'chou'bei'zu	0
项目负责人	xiang'mu'fu'ze'ren	0
项目后评价	xiang'mu'hou'ping'jia	0
项目建议书	xiang'mu'jian'yi'shu	0
项目建议书阶段	xiang'mu'jian'yi'shu'jie'duan	0
项目名称	xiang'mu'ming'cheng	0
项目实施	xiang'mu'shi'shi	0
项目投资	xiang'mu'tou'zi	0
项目性质	xiang'mu'xing'zhi	0
项目意向	xiang'mu'yi'xiang	0
项目组织	xiang'mu'zu'zhi	0
乡镇企业	xiang'zhen'qi'ye	0
消防局	xiao'fang'ju	0
消防站	xiao'fang'zhan	0
消耗定额	xiao'hao'ding'e	0
消耗量	xiao'hao'liang	0
消耗少	xiao'hao'shao	0
硝化物	xiao'hua'wu	0
小试	xiao'shi	0
小试研究报告	xiao'shi'yan'jiu'bao'gao	0
销售	xiao'shou	0
销售渠道	xiao'shou'qu'dao	0
小型	xiao'xing	0
小型化工厂	xiao'xing'hua'gong'chang	0
小型项目	xiao'xing'xiang'mu	0
泄漏	xie'lou	0
新材料	xin'cai'liao	0
新产品	xin'chan'pin	0
新技术	xin'ji'shu	0
新技术开发过程	xin'ji'shu'kai'fa'guo'cheng	0
新建项目	xin'jian'xiang'mu	0
新建项目设计	xin'jian'xiang'mu'she'ji	0
新控制方案	xin'kong'zhi'fang'an	0
新设备	xin'she'bei	0
新仪器	xin'yi'qi	0
行政	xing'zheng	0
行政办公楼	xing'zheng'ban'gong'lou	0
行政部门	xing'zheng'bu'men	0
行政管理	xing'zheng'guan'li	0
行政人员	xing'zheng'ren'yuan	0
修改补充	xiu'gai'bu'chong	0
需求合理	xu'qiu'he'li	0
需求量	xu'qiu'liang	0
需求预测	xu'qiu'yu'ce	0
选择报告	xuan'ze'bao'gao	0
循环冷却水	xun'huan'leng'que'shui	0
循环水	xun'huan'shui	0
循环水站	xun'huan'shui'zhan	0
压库	ya'ku	0
压力	ya'li	0
压力容器	ya'li'rong'qi	0
压力容器监测站	ya'li'rong'qi'jian'ce'zhan	0
压缩机	ya'suo'ji	0
压缩空气	ya'suo'kong'qi	0
压缩空气站	ya'suo'kong'qi'zhan	0
严格把关	yan'ge'ba'guan	0
研究报告	yan'jiu'bao'gao	0
研究成果	yan'jiu'cheng'guo	0
研究单位	yan'jiu'dan'wei	0
研究对象	yan'jiu'dui'xiang	0
研究课题	yan'jiu'ke'ti	0
研究讨论	yan'jiu'tao'lun	0
衍生物	yan'sheng'wu	0
严重污染	yan'zhong'wu'ran	0
业主	ye'zhu	0
一般用电	yi'ban'yong'dian	0
易爆性	yi'bao'xing	0
仪表	yi'biao	0
仪表造型	yi'biao'zao'xing	0
一定阶段	yi'ding'jie'duan	0
一氯醋酸	yi'lv'cu'suan	0
易燃性	yi'ran'xing	0
易燃易爆	yi'ran'yi'bao	0
医务室	yi'wu'shi	0
乙烯厂	yi'xi'chang	0
仪修	yi'xiu	0
一氧化碳	yi'yang'hua'tan	0
医药工业	yi'yao'gong'ye	0
一知半解	yi'zhi'ban'jie	0
银行贷款	yin'hang'dai'kuan	0
应用研究	ying'yong'yan'jiu	0
用电负荷	yong'dian'fu'he	0
用工	yong'gong	0
有毒废水	you'du'fei'shui	0
油罐	you'guan	0
有关部门	you'guan'bu'men	0
有关单位	you'guan'dan'wei	0
有关手册	you'guan'shou'ce	0
有关专家	you'guan'zhuan'jia	0
有关专业	you'guan'zhuan'ye	0
有关资料	you'guan'zi'liao	0
优化方案	you'hua'fang'an	0
优化设计	you'hua'she'ji	0
有机化工	you'ji'hua'gong	0
有机化工原料	you'ji'hua'gong'yuan'liao	0
迂回	yu'hui	0
预可行性研究	yu'ke'xing'xing'yan'jiu	0
预可行研究报告	yu'ke'xing'yan'jiu'bao'gao	0
预期效果	yu'qi'xiao'guo	0
浴室	yu'shi	0
预算书	yu'suan'shu	0
原材料	yuan'cai'liao	0
原材料规格	yuan'cai'liao'gui'ge	0
原料	yuan'liao	0
原料工段	yuan'liao'gong'duan	0
原料路线	yuan'liao'lu'xian	0
原料贮存	yuan'liao'zhu'cun	0
原始记录	yuan'shi'ji'lu	0
原始资料	yuan'shi'zi'liao	0
约束条件	yue'shu'tiao'jian	0
运输方法	yun'shu'fang'fa	0
允许浓度	yun'xu'nong'du	0
运转时间	yun'zhuan'shi'jian	0
责任心	ze'ren'xin	0
炸药	zha'yao	0
招标	zhao'biao	0
招标方式	zhao'biao'fang'shi	0
招标阶段	zhao'biao'jie'duan	0
照明负荷	zhao'ming'fu'he	0
真空泵房	zhen'kong'beng'fang	0
正常操作负荷	zheng'chang'cao'zuo'fu'he	0
正常生产	zheng'chang'sheng'chan	0
蒸发器	zheng'fa'qi	0
蒸馏塔	zheng'liu'ta	0
蒸气	zheng'qi	0
蒸气压力	zheng'qi'ya'li	0
正确决策	zheng'que'jue'ce	0
征用土地	zheng'yong'tu'di	0
治理方案	zhi'li'fang'an	0
质量保证	zhi'liang'bao'zheng	0
质量保证体系	zhi'liang'bao'zheng'ti'xi	0
质量管理体系	zhi'liang'guan'li'ti'xi	0
质量好	zhi'liang'hao	0
质量评定卡	zhi'liang'ping'ding'ka	0
质量守恒定律	zhi'liang'shou'heng'ding'lv	0
职业性	zhi'ye'xing	0
制造	zhi'zao	0
制造工艺	zhi'zao'gong'yi	0
制造图	zhi'zao'tu	0
制造现场	zhi'zao'xian'chang	0
重大技术	zhong'da'ji'shu	0
重大损失	zhong'da'sun'shi	0
中毒	zhong'du	0
中和	zhong'he	0
中试	zhong'shi	0
中试设计	zhong'shi'she'ji	0
中试研究报告	zhong'shi'yan'jiu'bao'gao	0
中试装置	zhong'shi'zhuang'zhi	0
中试装置设计	zhong'shi'zhuang'zhi'she'ji	0
中型	zhong'xing	0
中型化工厂	zhong'xing'hua'gong'chang	0
中型项目	zhong'xing'xiang'mu	0
中压	zhong'ya	0
主办单位	zhu'ban'dan'wei	0
贮存	zhu'cun	0
贮存包装	zhu'cun'bao'zhuang	0
贮罐	zhu'guan	0
主管部门	zhu'guan'bu'men	0
主观判断	zhu'guan'pan'duan	0
助剂	zhu'ji	0
主力单位名称	zhu'li'dan'wei'ming'cheng	0
主要负责人	zhu'yao'fu'ze'ren	0
主要设备	zhu'yao'she'bei	0
主要设计内容	zhu'yao'she'ji'nei'rong	0
贮运方案	zhu'yun'fang'an	0
转包	zhuan'bao	0
转化	zhuan'hua	0
转化率	zhuan'hua'lv	0
专利	zhuan'li	0
专业对口	zhuan'ye'dui'kou	0
专业负责人	zhuan'ye'fu'ze'ren	0
专业技术	zhuan'ye'ji'shu	0
专业技术人员	zhuan'ye'ji'shu'ren'yuan	0
专业设置	zhuan'ye'she'zhi	0
专业室	zhuan'ye'shi	0
状态条件	zhuang'tai'tiao'jian	0
装置建设	zhuang'zhi'jian'she	0
自动化程度	zi'dong'hua'cheng'du	0
自动化控制	zi'dong'hua'kong'zhi	0
自动化水平	zi'dong'hua'shui'ping	0
自动化仪表	zi'dong'hua'yi'biao	0
自动化仪表工程	zi'dong'hua'yi'biao'gong'cheng	0
自动控制	zi'dong'kong'zhi	0
自动控制工程	zi'dong'kong'zhi'gong'cheng	0
资格	zi'ge	0
资金	zi'jin	0
资金筹措	zi'jin'chou'cuo	0
资金短缺	zi'jin'duan'que	0
资金上	zi'jin'shang	0
自控	zi'kong	0
自控仪表线路安装图	zi'kong'yi'biao'xian'lu'an'zhuang'tu	0
资料	zi'liao	0
自然规律	zi'ran'gui'lv	0
自然条件	zi'ran'tiao'jian	0
资源	zi'yuan	0
总变电所	zong'bian'dian'suo	0
总承包合同	zong'cheng'bao'he'tong	0
总负责人	zong'fu'ze'ren	0
总工程师	zong'gong'cheng'shi	0
总工艺流程	zong'gong'yi'liu'cheng	0
综合利用	zong'he'li'yong	0
综合评价	zong'he'ping'jia	0
总论	zong'lun	0
总平面布置	zong'ping'mian'bu'zhi	0
总投资	zong'tou'zi	0
总图	zong'tu	0
总图布置	zong'tu'bu'zhi	0
总图运输	zong'tu'yun'shu	0
组合方式	zu'he'fang'shi	0
最初阶段	zui'chu'jie'duan	0
最大效益	zui'da'xiao'yi	0
最低操作负荷	zui'di'cao'zuo'fu'he	0
最低压力	zui'di'ya'li	0
最高压力	zui'gao'ya'li	0
作计算	zuo'ji'suan	0
