安禅制毒龙	an'chan'zhi'du'long	0
安得元龙百尺楼	an'de'yuan'long'bai'chi'lou	0
安得中山千日酒	an'de'zhong'shan'qian'ri'jiu	0
岸容待腊将舒柳	an'rong'dai'la'jiang'shu'liu	0
暗香浮动月黄昏	an'xiang'fu'dong'yue'huang'hun	0
傲吏身闲笑五侯	ao'li'shen'xian'xiao'wu'hou	0
芭蕉分绿与窗纱	ba'jiao'fen'lv'yu'chuang'sha	0
八月洞庭秋	ba'yue'dong'ting'qiu	0
八月湖水平	ba'yue'hu'shui'ping	0
百般红紫斗芳菲	bai'ban'hong'zi'dou'fang'fei	0
百尺楼台水接天	bai'chi'lou'tai'shui'jie'tian	0
白帝城高急暮砧	bai'di'cheng'gao'ji'mu'zhen	0
白发悲花落	bai'fa'bei'hua'luo	0
白发老闲事	bai'fa'lao'xian'shi	0
白发三千丈	bai'fa'san'qian'zhang	0
白露始专征	bai'lu'shi'zhuan'zheng	0
百亩庭中半是苔	bai'mu'ting'zhong'ban'shi'tai	0
白蘋吹尽楚江秋	bai'pin'chui'jin'chu'jiang'qiu	0
白日传心净	bai'ri'chuan'xin'jing	0
白日依山尽	bai'ri'yi'shan'jin	0
白沙翠竹江村暮	bai'sha'cui'zhu'jiang'cun'mu	0
白首为谁雄	bai'shou'wei'shui'xiong	0
白水绕东城	bai'shui'rao'dong'cheng	0
白云红叶共悠悠	bai'yun'hong'ye'gong'you'you	0
白云回望合	bai'yun'hui'wang'he	0
白云千载空悠悠	bai'yun'qian'zai'kong'you'you	0
百啭流莺绕建章	bai'zhuan'liu'ying'rao'jian'zhang	0
半岭通佳气	ban'ling'tong'jia'qi	0
半亩方塘一鉴开	ban'mu'fang'tang'yi'jian'kai	0
傍花随柳过前川	bang'hua'sui'liu'guo'qian'chuan	0
宝剑值千金	bao'jian'zhi'qian'jin	0
爆竹声中一岁除	bao'zhu'sheng'zhong'yi'sui'chu	0
北斗挂城边	bei'dou'gua'cheng'bian	0
杯渡不惊鸥	bei'du'bu'jing'ou	0
北风吹白云	bei'feng'chui'bai'yun	0
北山输绿涨横陂	bei'shan'shu'lv'zhang'heng'bei	0
陂塘五月秋	bei'tang'wu'yue'qiu	0
北有中天百尺台	bei'you'zhong'tian'bai'chi'tai	0
本为圣明除弊政	ben'wei'sheng'ming'chu'bi'zheng	0
毕竟西湖六月中	bi'jing'xi'hu'liu'yue'zhong	0
避贤初罢相	bi'xian'chu'ba'xiang	0
边地莺花少	bian'di'ying'hua'shao	0
边风扫北平	bian'feng'sao'bei'ping	0
便觉眼前生意满	bian'jue'yan'qian'sheng'yi'man	0
别路绕山川	bie'lu'rao'shan'chuan	0
别业初开云汉边	bie'ye'chu'kai'yun'han'bian	0
别业居幽处	bie'ye'ju'you'chu	0
别业临青甸	bie'ye'lin'qing'dian	0
病入新年感物华	bing'ru'xin'nian'gan'wu'hua	0
并作南来一味凉	bing'zuo'nan'lai'yi'wei'liang	0
波撼岳阳城	bo'han'yue'yang'cheng	0
薄暮空潭曲	bo'mu'kong'tan'qu	0
波飘菰米沉云黑	bo'piao'gu'mi'chen'yun'hei	0
不必问君平	bu'bi'wen'jun'ping	0
不道人间巧几多	bu'dao'ren'jian'qiao'ji'duo	0
不得到辽西	bu'de'dao'liao'xi	0
不妨游衍莫忘归	bu'fang'you'yan'mo'wang'gui	0
不负信陵恩	bu'fu'xin'ling'en	0
不及石尤风	bu'ji'shi'you'feng	0
不寝听金钥	bu'qin'ting'jin'yao	0
不胜清怨却飞来	bu'sheng'qing'yuan'que'fei'lai	0
不是愁中即病中	bu'shi'chou'zhong'ji'bing'zhong	0
不受尘埃半点侵	bu'shou'chen'ai'ban'dian'qin	0
不脱蓑衣卧月明	bu'tuo'suo'yi'wo'yue'ming	0
不向东风怨未开	bu'xiang'dong'feng'yuan'wei'kai	0
不信东风唤不回	bu'xin'dong'feng'huan'bu'hui	0
不信楼头杨柳月	bu'xin'lou'tou'yang'liu'yue	0
不须檀板共金樽	bu'xu'tan'ban'gong'jin'zun	0
不用开书帙	bu'yong'kai'shu'zhi	0
不在五湖中	bu'zai'wu'hu'zhong	0
不知春去几多时	bu'zhi'chun'qu'ji'duo'shi	0
不知何处是他乡	bu'zhi'he'chu'shi'ta'xiang	0
不知明镜里	bu'zhi'ming'jing'li	0
不知天下士	bu'zhi'tian'xia'shi	0
不知香积寺	bu'zhi'xiang'ji'si	0
不作边城将	bu'zuo'bian'cheng'jiang	0
才了蚕桑又插田	cai'le'can'sang'you'cha'tian	0
彩绳斜挂绿杨烟	cai'sheng'xie'gua'lv'yang'yan	0
才有梅花便不同	cai'you'mei'hua'bian'bu'tong	0
彩云萧史驻	cai'yun'xiao'shi'zhu	0
残星几点雁横塞	can'xing'ji'dian'yan'heng'sai	0
残雪压枝犹有橘	can'xue'ya'zhi'you'you'ju	0
苍茫泽国东	cang'mang'ze'guo'dong	0
嘈嘈虚枕纳溪声	cao'cao'xu'zhen'na'xi'sheng	0
草满池塘水满陂	cao'man'chi'tang'shui'man'bei	0
草木知春不久归	cao'mu'zhi'chun'bu'jiu'gui	0
草铺横野六七里	cao'pu'heng'ye'liu'qi'li	0
草色遥看近却无	cao'se'yao'kan'jin'que'wu	0
草长平湖白鹭飞	cao'zhang'ping'hu'bai'lu'fei	0
曾是洛阳花下客	ceng'shi'luo'yang'hua'xia'ke	0
曾为大梁客	ceng'wei'da'liang'ke	0
插棘编篱谨护持	cha'ji'bian'li'jin'hu'chi	0
禅房花木深	chan'fang'hua'mu'shen	0
蝉声断续悲残月	chan'sheng'duan'xu'bei'can'yue	0
长伴云衢千里明	chang'ban'yun'qu'qian'li'ming	0
唱彻五更天未晓	chang'che'wu'geng'tian'wei'xiao	0
长此戴尧天	chang'ci'dai'yao'tian	0
长笛一声人倚楼	chang'di'yi'sheng'ren'yi'lou	0
肠断春江欲尽头	chang'duan'chun'jiang'yu'jin'tou	0
长歌怀采薇	chang'ge'huai'cai'wei	0
长河没晓天	chang'he'mei'xiao'tian	0
阊阖千门万户开	chang'he'qian'men'wan'hu'kai	0
长门蝶舞多	chang'men'die'wu'duo	0
长夏江村风日清	chang'xia'jiang'cun'feng'ri'qing	0
长夏江村事事幽	chang'xia'jiang'cun'shi'shi'you	0
长筵鹓鹭集	chang'yan'yuan'lu'ji	0
常愿奉金仙	chang'yuan'feng'jin'xian	0
朝罢香烟携满袖	chao'ba'xiang'yan'xie'man'xiu	0
朝罢须裁五色诏	chao'ba'xu'cai'wu'se'zhao	0
朝回日日典春衣	chao'hui'ri'ri'dian'chun'yi	0
朝来入庭树	chao'lai'ru'ting'shu	0
潮平两岸阔	chao'ping'liang'an'kuo	0
朝元阁上西风急	chao'yuan'ge'shang'xi'feng'ji	0
宸游不为三元夜	chen'you'bu'wei'san'yuan'ye	0
承恩咸已醉	cheng'en'xian'yi'zui	0
承露金茎霄汉间	cheng'lu'jin'jing'xiao'han'jian	0
橙切香黄蟹正肥	cheng'qie'xiang'huang'xie'zheng'fei	0
城阙辅三秦	cheng'que'fu'san'qin	0
称觞献寿乐钧天	cheng'shang'xian'shou'le'jun'tian	0
乘时方在德	cheng'shi'fang'zai'de	0
池成不让饮龙川	chi'cheng'bu'rang'yin'long'chuan	0
赤日石林气	chi'ri'shi'lin'qi	0
赤日行天午不知	chi'ri'xing'tian'wu'bu'zhi	0
池上于今有凤毛	chi'shang'yu'jin'you'feng'mao	0
敕使传宣坐赐茶	chi'shi'chuan'xuan'zuo'ci'cha	0
重重叠叠上瑶台	chong'chong'die'die'shang'yao'tai	0
愁见河桥酒幔青	chou'jian'he'qiao'jiu'man'qing	0
愁看五陵烟	chou'kan'wu'ling'yan	0
愁闻剑戟扶危主	chou'wen'jian'ji'fu'wei'zhu	0
处处鸟衔飞	chu'chu'niao'xian'fei	0
处处闻啼鸟	chu'chu'wen'ti'niao	0
出门俱是看花人	chu'men'ju'shi'kan'hua'ren	0
初日照高林	chu'ri'zhao'gao'lin	0
楚山不可极	chu'shan'bu'ke'ji	0
楚俗饶词客	chu'su'rao'ci'ke	0
初闻征雁已无蝉	chu'wen'zheng'yan'yi'wu'chan	0
穿花蛱蝶深深见	chuan'hua'jia'die'shen'shen'jian	0
传语风光共流转	chuan'yu'feng'guang'gong'liu'zhuan	0
窗含西岭千秋雪	chuang'han'xi'ling'qian'qiu'xue	0
床前明月光	chuang'qian'ming'yue'guang	0
床头一壶酒	chuang'tou'yi'hu'jiu	0
窗中小渭川	chuang'zhong'xiao'wei'chuan	0
吹葭六管动飞灰	chui'jia'liu'guan'dong'fei'hui	0
吹面不寒杨柳风	chui'mian'bu'han'yang'liu'feng	0
吹向玉阶飞	chui'xiang'yu'jie'fei	0
春潮带雨晚来急	chun'chao'dai'yu'wan'lai'ji	0
春潮夜夜深	chun'chao'ye'ye'shen	0
春城无处不飞花	chun'cheng'wu'chu'bu'fei'hua	0
春愁黯黯独成眠	chun'chou'an'an'du'cheng'mian	0
春到人间草木知	chun'dao'ren'jian'cao'mu'zhi	0
春风拂槛露华浓	chun'feng'fu'kan'lu'hua'nong	0
春风且莫定	chun'feng'qie'mo'ding	0
春风送暖入屠苏	chun'feng'song'nuan'ru'tu'su	0
春风疑不到天涯	chun'feng'yi'bu'dao'tian'ya	0
春流绕蜀城	chun'liu'rao'shu'cheng	0
春眠不觉晓	chun'mian'bu'jue'xiao	0
春日佳气多	chun'ri'jia'qi'duo	0
春入遥山碧四围	chun'ru'yao'shan'bi'si'wei	0
春色满园关不住	chun'se'man'yuan'guan'bu'zhu	0
春色恼人眠不得	chun'se'nao'ren'mian'bu'de	0
春宵一刻值千金	chun'xiao'yi'ke'zhi'qian'jin	0
此地别燕丹	ci'di'bie'yan'dan	0
此地空余黄鹤楼	ci'di'kong'yu'huang'he'lou	0
此地一为别	ci'di'yi'wei'bie	0
此会在何年	ci'hui'zai'he'nian	0
此日中流自在行	ci'ri'zhong'liu'zi'zai'xing	0
此生此夜不长好	ci'sheng'ci'ye'bu'zhang'hao	0
此生随万物	ci'sheng'sui'wan'wu	0
此翁殊不然	ci'weng'shu'bu'ran	0
刺绣五纹添弱线	ci'xiu'wu'wen'tian'ruo'xian	0
匆匆归到神仙府	cong'cong'gui'dao'shen'xian'fu	0
丛菊两开他日泪	cong'ju'liang'kai'ta'ri'lei	0
从来多古意	cong'lai'duo'gu'yi	0
翠辇不曾过	cui'nian'bu'ceng'guo	0
翠屏千仞合	cui'ping'qian'ren'he	0
翠掩重门燕子闲	cui'yan'zhong'men'yan'zi'xian	0
寸心言不尽	cun'xin'yan'bu'jin	0
村庄儿女各当家	cun'zhuang'er'nv'ge'dang'jia	0
大道直如发	da'dao'zhi'ru'fa	0
大都秋雁少	da'dou'qiu'yan'shao	0
大将南征胆气豪	da'jiang'nan'zheng'dan'qi'hao	0
打起黄莺儿	da'qi'huang'ying'er	0
淡淡著烟浓著月	dan'dan'zhu'yan'nong'zhu'yue	0
但逢佳节约重陪	dan'feng'jia'jie'yue'zhong'pei	0
但使主人能醉客	dan'shi'zhu'ren'neng'zui'ke	0
淡月疏星绕建章	dan'yue'shu'xing'rao'jian'zhang	0
丹嶂五丁开	dan'zhang'wu'ding'kai	0
淡妆浓抹总相宜	dan'zhuang'nong'mo'zong'xiang'yi	0
到江吴地尽	dao'jiang'wu'di'jin	0
到来生隐心	dao'lai'sheng'yin'xin	0
道人不是悲秋客	dao'ren'bu'shi'bei'qiu'ke	0
道通天地有形外	dao'tong'tian'di'you'xing'wai	0
得食阶除鸟雀驯	de'shi'jie'chu'niao'que'xun	0
登临近日边	deng'lin'jin'ri'bian	0
灯明方丈室	deng'ming'fang'zhang'shi	0
等闲识得东风面	deng'xian'shi'de'dong'feng'mian	0
笛弄晚风三四声	di'nong'wan'feng'san'si'sheng	0
底事来惊梦里闲	di'shi'lai'jing'meng'li'xian	0
低头思故乡	di'tou'si'gu'xiang	0
颠倒苍苔落绛英	dian'dao'cang'tai'luo'jiang'ying	0
点点杨花入砚池	dian'dian'yang'hua'ru'yan'chi	0
颠狂柳絮随风舞	dian'kuang'liu'xu'sui'feng'wu	0
电闪旌旗日月高	dian'shan'jing'qi'ri'yue'gao	0
殿上衮衣明日月	dian'shang'gun'yi'ming'ri'yue	0
点水蜻蜓款款飞	dian'shui'qing'ting'kuan'kuan'fei	0
点溪荷叶叠青钱	dian'xi'he'ye'die'qing'qian	0
蝶衣晒粉花枝舞	die'yi'shai'fen'hua'zhi'wu	0
东壁图书府	dong'bi'tu'shu'fu	0
东风吹水绿参差	dong'feng'chui'shui'lv'cen'ci	0
东风袅袅泛崇光	dong'feng'niao'niao'fan'chong'guang	0
东皋薄暮望	dong'gao'bo'mu'wang	0
东郡趋庭日	dong'jun'qu'ting'ri	0
东来紫气满函关	dong'lai'zi'qi'man'han'guan	0
冻雷惊笋欲抽芽	dong'lei'jing'sun'yu'chou'ya	0
东路云山合	dong'lu'yun'shan'he	0
东园载酒西园醉	dong'yuan'zai'jiu'xi'yuan'zui	0
冬至阳生春又来	dong'zhi'yang'sheng'chun'you'lai	0
都入长杨作雨声	dou'ru'chang'yang'zuo'yu'sheng	0
独对丹墀日未斜	du'dui'dan'chi'ri'wei'xie	0
妒花风雨便相催	du'hua'feng'yu'bian'xiang'cui	0
杜鹃枝上月三更	du'juan'zhi'shang'yue'san'geng	0
独怜幽草涧边生	du'lian'you'cao'jian'bian'sheng	0
独上江楼思悄然	du'shang'jiang'lou'si'qiao'ran	0
独有凤凰池上客	du'you'feng'huang'chi'shang'ke	0
独有宦游人	du'you'huan'you'ren	0
独坐黄昏谁是伴	du'zuo'huang'hun'shui'shi'ban	0
独坐幽篁里	du'zuo'you'huang'li	0
短笛无腔信口吹	duan'di'wu'qiang'xin'kou'chui	0
端居耻圣明	duan'ju'chi'sheng'ming	0
端门方喜翠华临	duan'men'fang'xi'cui'hua'lin	0
断桥垂露滴梧桐	duan'qiao'chui'lu'di'wu'tong	0
断送玉容人上天	duan'song'yu'rong'ren'shang'tian	0
断续声随断续风	duan'xu'sheng'sui'duan'xu'feng	0
多病所须惟药物	duo'bing'suo'xu'wei'yao'wu	0
多少工夫织得成	duo'shao'gong'fu'zhi'de'cheng	0
多少楼台烟雨中	duo'shao'lou'tai'yan'yu'zhong	0
鹅湖山下稻粱肥	e'hu'shan'xia'dao'liang'fei	0
恩叨醉酒深	en'dao'zui'jiu'shen	0
儿女共沾巾	er'nv'gong'zhan'jin	0
二十五弦弹夜月	er'shi'wu'xian'dan'ye'yue	0
二月山城未见花	er'yue'shan'cheng'wei'jian'hua	0
范蠡舟偏小	fan'li'zhou'pian'xiao	0
返照入闾巷	fan'zhao'ru'lv'xiang	0
芳草萋萋鹦鹉洲	fang'cao'qi'qi'ying'wu'zhou	0
放梢初见影离离	fang'shao'chu'jian'ying'li'li	0
芳树笼秦栈	fang'shu'long'qin'zhan	0
芳原绿野恣行时	fang'yuan'lv'ye'zi'xing'shi	0
方丈浑连水	fang'zhang'hun'lian'shui	0
方知不染心	fang'zhi'bu'ran'xin	0
飞入寻常百姓家	fei'ru'xun'chang'bai'xing'jia	0
分曹限紫薇	fen'cao'xian'zi'wei	0
粉蝶如知合断魂	fen'die'ru'zhi'he'duan'hun	0
分手脱相赠	fen'shou'tuo'xiang'zeng	0
汾水秋风陋汉才	fen'shui'qiu'feng'lou'han'cai	0
分野中峰变	fen'ye'zhong'feng'bian	0
风吹鼍鼓山河动	feng'chui'tuo'gu'shan'he'dong	0
蜂蝶纷纷过墙去	feng'die'fen'fen'guo'qiang'qu	0
凤管发昭阳	feng'guan'fa'zhao'yang	0
风光别我苦吟身	feng'guang'bie'wo'ku'yin'shen	0
风光不与四时同	feng'guang'bu'yu'si'shi'tong	0
风急打船头	feng'ji'da'chuan'tou	0
风景依稀似去年	feng'jing'yi'xi'si'qu'nian	0
风连西极动	feng'lian'xi'ji'dong	0
凤林戈未息	feng'lin'ge'wei'xi	0
风飘万点正愁人	feng'piao'wan'dian'zheng'chou'ren	0
风日晴和人意好	feng'ri'qing'he'ren'yi'hao	0
风烟望五津	feng'yan'wang'wu'jin	0
风正一帆悬	feng'zheng'yi'fan'xuan	0
浮沉千古事	fu'chen'qian'gu'shi	0
富贵不淫贫贱乐	fu'gui'bu'yin'pin'jian'le	0
赋就金门期再献	fu'jiu'jin'men'qi'zai'xian	0
赋就一篇怀马融	fu'jiu'yi'pian'huai'ma'rong	0
芙蓉生在秋江上	fu'rong'sheng'zai'qiu'jiang'shang	0
夫因兵死守蓬茅	fu'yin'bing'si'shou'peng'mao	0
浮云连海岱	fu'yun'lian'hai'dai	0
浮云游子意	fu'yun'you'zi'yi	0
干戈未定欲何之	gan'ge'wei'ding'yu'he'zhi	0
敢将衰朽惜残年	gan'jiang'shuai'xiu'xi'can'nian	0
刚被太阳收拾去	gang'bei'tai'yang'shou'shi'qu	0
高阁逼诸天	gao'ge'bi'zhu'tian	0
高列千峰宝炬森	gao'lie'qian'feng'bao'ju'sen	0
高枕石头眠	gao'zhen'shi'tou'mian	0
隔岸越山多	ge'an'yue'shan'duo	0
隔断红尘三十里	ge'duan'hong'chen'san'shi'li	0
歌管楼台声细细	ge'guan'lou'tai'sheng'xi'xi	0
隔江犹唱后庭花	ge'jiang'you'chang'hou'ting'hua	0
隔水问樵夫	ge'shui'wen'qiao'fu	0
更待银河彻底清	geng'dai'yin'he'che'di'qing	0
更得几回过	geng'dei'ji'hui'guo	0
更上一层楼	geng'shang'yi'ceng'lou	0
更闻枫叶下	geng'wen'feng'ye'xia	0
更无柳絮因风起	geng'wu'liu'xu'yin'feng'qi	0
更疑天路近	geng'yi'tian'lu'jin	0
宫殿风微燕雀高	gong'dian'feng'wei'yan'que'gao	0
共君今夜不须睡	gong'jun'jin'ye'bu'xu'shui	0
共沐恩波凤池上	gong'mu'en'bo'feng'chi'shang	0
宫阙通群帝	gong'que'tong'qun'di	0
公子调冰水	gong'zi'tiao'bing'shui	0
谷暗千旗出	gu'an'qian'qi'chu	0
古道少人行	gu'dao'shao'ren'xing	0
孤客最先闻	gu'ke'zui'xian'wen	0
故老思飞将	gu'lao'si'fei'jiang	0
古木丛青蔼	gu'mu'cong'qing'ai	0
古木无人径	gu'mu'wu'ren'jing	0
古木阴中系短篷	gu'mu'yin'zhong'xi'duan'peng	0
孤蓬万里征	gu'peng'wan'li'zheng	0
故人京洛满	gu'ren'jing'luo'man	0
故烧高烛照红妆	gu'shao'gao'zhu'zhao'hong'zhuang	0
姑苏城外寒山寺	gu'su'cheng'wai'han'shan'si	0
古屋画龙蛇	gu'wu'hua'long'she	0
故园书动经年绝	gu'yuan'shu'dong'jing'nian'jue	0
孤云独去闲	gu'yun'du'qu'xian	0
孤嶂秦碑在	gu'zhang'qin'bei'zai	0
孤舟一系故园心	gu'zhou'yi'xi'gu'yuan'xin	0
惯看宾客儿童喜	guan'kan'bin'ke'er'tong'xi	0
灌木萦旗转	guan'mu'ying'qi'zhuan	0
关塞极天惟鸟道	guan'sai'ji'tian'wei'niao'dao	0
官因老病休	guan'yin'lao'bing'xiu	0
归到玉堂清不寐	gui'dao'yu'tang'qing'bu'mei	0
桂楫中流望	gui'ji'zhong'liu'wang	0
归来饱饭黄昏后	gui'lai'bao'fan'huang'hun'hou	0
归路但萧条	gui'lu'dan'xiao'tiao	0
归路翻萧飒	gui'lu'fan'xiao'sa	0
归思欲沾巾	gui'si'yu'zhan'jin	0
归闲我欲频来此	gui'xian'wo'yu'pin'lai'ci	0
归雁洛阳边	gui'yan'luo'yang'bian	0
归邀麟阁名	gui'yao'lin'ge'ming	0
海尽边阴静	hai'jin'bian'yin'jing	0
海明先见日	hai'ming'xian'jian'ri	0
海内存知己	hai'nei'cun'zhi'ji	0
海鸥何事更相疑	hai'ou'he'shi'geng'xiang'yi	0
海气侵南部	hai'qi'qin'nan'bu	0
海日生残夜	hai'ri'sheng'can'ye	0
海色晴看雨	hai'se'qing'kan'yu	0
汉家宫阙动高秋	han'jia'gong'que'dong'gao'qiu	0
寒尽不知年	han'jin'bu'zhi'nian	0
汉寝唐陵无麦饭	han'qin'tang'ling'wu'mai'fan	0
寒色五陵松	han'se'wu'ling'song	0
寒食东风御柳斜	han'shi'dong'feng'yu'liu'xie	0
汉廷荣巧宦	han'ting'rong'qiao'huan	0
涵虚混太清	han'xu'hun'tai'qing	0
寒夜客来茶当酒	han'ye'ke'lai'cha'dang'jiu	0
寒衣处处催刀尺	han'yi'chu'chu'cui'dao'chi	0
浩劫因王造	hao'jie'yin'wang'zao	0
镐京春酒沾周宴	hao'jing'chun'jiu'zhan'zhou'yan	0
皓魄当空宝镜升	hao'po'dang'kong'bao'jing'sheng	0
好收吾骨瘴江边	hao'shou'wu'gu'zhang'jiang'bian	0
何处出尘氛	he'chu'chu'chen'fen	0
何处得秋霜	he'chu'de'qiu'shuang	0
何处秋风至	he'chu'qiu'feng'zhi	0
荷尽已无擎雨盖	he'jin'yi'wu'qing'yu'gai	0
荷净纳凉时	he'jing'na'liang'shi	0
何年顾虎头	he'nian'gu'hu'tou	0
何人最往还	he'ren'zui'wang'huan	0
何日复同游	he'ri'fu'tong'you	0
何如此地春	he'ru'ci'di'chun	0
何时议筑坛	he'shi'yi'zhu'tan	0
何用浮名绊此身	he'yong'fu'ming'ban'ci'shen	0
红锦韬缠日月符	hong'jin'tao'chan'ri'yue'fu	0
鸿雁悲鸣红蓼风	hong'yan'bei'ming'hong'liao'feng	0
红衣落尽渚莲愁	hong'yi'luo'jin'zhu'lian'chou	0
候火云峰峻	hou'huo'yun'feng'jun	0
扈从良可赋	hu'cong'liang'ke'fu	0
蝴蝶梦中家万里	hu'die'meng'zhong'jia'wan'li	0
呼童熨贴旧寒衣	hu'tong'yun'tie'jiu'han'yi	0
户外一峰秀	hu'wai'yi'feng'xiu	0
忽闻春尽强登山	hu'wen'chun'jin'qiang'deng'shan	0
忽闻歌古调	hu'wen'ge'gu'diao	0
花板润沾红杏雨	hua'ban'run'zhan'hong'xing'yu	0
画壁余鸿雁	hua'bi'yu'hong'yan	0
华发春催两鬓生	hua'fa'chun'cui'liang'bin'sheng	0
花飞莫遣随流水	hua'fei'mo'qian'sui'liu'shui	0
画架双裁翠络偏	hua'jia'shuang'cai'cui'luo'pian	0
花开红树乱莺啼	hua'kai'hong'shu'luan'ying'ti	0
花落知多少	hua'luo'zhi'duo'shao	0
花木成蹊手自栽	hua'mu'cheng'xi'shou'zi'zai	0
花隐掖垣暮	hua'yin'ye'yuan'mu	0
花迎剑佩星初落	hua'ying'jian'pei'xing'chu'luo	0
花有清香月有阴	hua'you'qing'xiang'yue'you'yin	0
花枝出建章	hua'zhi'chu'jian'zhang	0
怀君属秋夜	huai'jun'shu'qiu'ye	0
还家万里梦	huan'jia'wan'li'meng	0
缓寻芳草得归迟	huan'xun'fang'cao'de'gui'chi	0
荒城鲁殿余	huang'cheng'lu'dian'yu	0
黄鹤楼中吹玉笛	huang'he'lou'zhong'chui'yu'di	0
黄河入海流	huang'he'ru'hai'liu	0
黄鹤一去不复返	huang'he'yi'qu'bu'fu'fan	0
皇家贵主好神仙	huang'jia'gui'zhu'hao'shen'xian	0
黄金甲锁雷霆印	huang'jin'jia'suo'lei'ting'yin	0
黄梅时节家家雨	huang'mei'shi'jie'jia'jia'yu	0
荒庭垂橘柚	huang'ting'chui'ju'you	0
回首青山入梦频	hui'shou'qing'shan'ru'meng'pin	0
挥手自兹去	hui'shou'zi'zi'qu	0
回头不似在山时	hui'tou'bu'si'zai'shan'shi	0
会向瑶台月下逢	hui'xiang'yao'tai'yue'xia'feng	0
或恐是同乡	huo'kong'shi'tong'xiang	0
火云犹未敛奇峰	huo'yun'you'wei'lian'qi'feng	0
计程应说到常山	ji'cheng'ying'shuo'dao'chang'shan	0
几处园林萧瑟里	ji'chu'yuan'lin'xiao'se'li	0
几度呼童扫不开	ji'du'hu'tong'sao'bu'kai	0
几回青琐点朝班	ji'hui'qing'suo'dian'chao'ban	0
寂寂柴门村落里	ji'ji'chai'men'cun'luo'li	0
鹡鸰音断人千里	ji'ling'yin'duan'ren'qian'li	0
鸡鸣紫陌曙光寒	ji'ming'zi'mo'shu'guang'han	0
几日寂寥伤酒后	ji'ri'ji'liao'shang'jiu'hou	0
积雨空林烟火迟	ji'yu'kong'lin'yan'huo'chi	0
笳吹夜边声	jia'chui'ye'bian'sheng	0
家家扶得醉人归	jia'jia'fu'de'zui'ren'gui	0
佳节清明桃李笑	jia'jie'qing'ming'tao'li'xiao	0
佳人春戏小楼前	jia'ren'chun'xi'xiao'lou'qian	0
佳人雪藕丝	jia'ren'xue'ou'si	0
剑阁横云峻	jian'ge'heng'yun'jun	0
剪剪轻风阵阵寒	jian'jian'qing'feng'zhen'zhen'han	0
剑留南斗近	jian'liu'nan'dou'jin	0
剑佩声随玉墀步	jian'pei'sheng'sui'yu'chi'bu	0
见说蚕丛路	jian'shuo'can'cong'lu	0
江白迥闻风	jiang'bai'jiong'wen'feng	0
江城如画里	jiang'cheng'ru'hua'li	0
江城五月落梅花	jiang'cheng'wu'yue'luo'mei'hua	0
江春入旧年	jiang'chun'ru'jiu'nian	0
江枫渔火对愁眠	jiang'feng'yu'huo'dui'chou'mian	0
江寒朔吹生	jiang'han'shuo'chui'sheng	0
江湖浪迹一沙鸥	jiang'hu'lang'ji'yi'sha'ou	0
江湖满地一渔翁	jiang'hu'man'di'yi'yu'weng	0
江间波浪兼天涌	jiang'jian'bo'lang'jian'tian'yong	0
江岭作流人	jiang'ling'zuo'liu'ren	0
江上小堂巢翡翠	jiang'shang'xiao'tang'chao'fei'cui	0
江深走白沙	jiang'shen'zou'bai'sha	0
江声夜听潮	jiang'sheng'ye'ting'chao	0
将谓偷闲学少年	jiang'wei'tou'xian'xue'shao'nian	0
讲易见天心	jiang'yi'jian'tian'xin	0
绛帻鸡人报晓筹	jiang'ze'ji'ren'bao'xiao'chou	0
教儿且覆掌中杯	jiao'er'qie'fu'zhang'zhong'bei	0
交交时作弄机声	jiao'jiao'shi'zuo'nong'ji'sheng	0
狡兔空从弦外落	jiao'tu'kong'cong'xian'wai'luo	0
嗟尔勒铭才	jie'er'le'ming'cai	0
阶前众壑深	jie'qian'zhong'he'shen	0
接天莲叶无穷碧	jie'tian'lian'ye'wu'qiong'bi	0
解箨时闻声簌簌	jie'tuo'shi'wen'sheng'su'su	0
借问承恩者	jie'wen'cheng'en'zhe	0
借问酒家何处有	jie'wen'jiu'jia'he'chu'you	0
结宇依空林	jie'yu'yi'kong'lin	0
禁城春色晓苍苍	jin'cheng'chun'se'xiao'cang'cang	0
金殿当头紫阁重	jin'dian'dang'tou'zi'ge'zhong	0
锦里先生乌角巾	jin'li'xian'sheng'wu'jiao'jin	0
金炉香尽漏声残	jin'lu'xiang'jin'lou'sheng'can	0
禁门深锁寂无哗	jin'men'shen'suo'ji'wu'hua	0
金阙晓钟开万户	jin'que'xiao'zhong'kai'wan'hu	0
今日花开又一年	jin'ri'hua'kai'you'yi'nian	0
今日水犹寒	jin'ri'shui'you'han	0
今上岳阳楼	jin'shang'yue'yang'lou	0
尽是刘郎去后栽	jin'shi'liu'lang'qu'hou'zai	0
金天方肃杀	jin'tian'fang'su'sha	0
禁烟不到粤人国	jin'yan'bu'dao'yue'ren'guo	0
今朝几个来	jin'zhao'ji'ge'lai	0
金尊对绮筵	jin'zun'dui'qi'yan	0
敬从乘舆来此地	jing'cong'sheng'yu'lai'ci'di	0
旌旗朝朔气	jing'qi'chao'shuo'qi	0
旌旗日暖龙蛇动	jing'qi'ri'nuan'long'she'dong	0
久斑两鬓如霜雪	jiu'ban'liang'bin'ru'shuang'xue	0
九重春色醉仙桃	jiu'chong'chun'se'zui'xian'tao	0
酒涵花影红光溜	jiu'han'hua'ying'hong'guang'liu	0
啾啾栖鸟过	jiu'jiu'qi'niao'guo	0
九龄已老韩休死	jiu'ling'yi'lao'han'xiu'si	0
旧事凄凉不可听	jiu'shi'qi'liang'bu'ke'ting	0
旧时王谢堂前燕	jiu'shi'wang'xie'tang'qian'yan	0
九天阊阖开宫殿	jiu'tian'chang'he'kai'gong'dian	0
酒债寻常行处有	jiu'zhai'xun'chang'xing'chu'you	0
酒卮中有好花枝	jiu'zhi'zhong'you'hao'hua'zhi	0
菊残犹有傲霜枝	ju'can'you'you'ao'shuang'zhi	0
举头望明月	ju'tou'wang'ming'yue	0
卷幔五湖秋	juan'man'wu'hu'qiu	0
绝胜烟柳满皇都	jue'sheng'yan'liu'man'huang'du	0
军麾动洛城	jun'hui'dong'luo'cheng	0
君家何处住	jun'jia'he'chu'zhu	0
君王行出将	jun'wang'xing'chu'jiang	0
君王又尽紫霞杯	jun'wang'you'jin'zi'xia'bei	0
军中宜剑舞	jun'zhong'yi'jian'wu	0
开到荼蘼花事了	kai'dao'tu'mi'hua'shi'le	0
看取莲花净	kan'qu'lian'hua'jing	0
槛外低秦岭	kan'wai'di'qin'ling	0
可怜此地无车马	ke'lian'ci'di'wu'che'ma	0
可怜骢马使	ke'lian'cong'ma'shi	0
客路青山外	ke'lu'qing'shan'wai	0
客舍青青柳色新	ke'she'qing'qing'liu'se'xin	0
客心争日月	ke'xin'zheng'ri'yue	0
客有归欤叹	ke'you'gui'yu'tan	0
空波两畔明	kong'bo'liang'pan'ming	0
空翠落庭阴	kong'cui'luo'ting'yin	0
空戴南冠学楚囚	kong'dai'nan'guan'xue'chu'qiu	0
空水澄鲜一色秋	kong'shui'cheng'xian'yi'se'qiu	0
况复筋骸粗康健	kuang'fu'jin'hai'cu'kang'jian	0
匡衡抗疏功名薄	kuang'heng'kang'shu'gong'ming'bo	0
匡庐不可登	kuang'lu'bu'ke'deng	0
况是清明好天气	kuang'shi'qing'ming'hao'tian'qi	0
困临流水坐苔矶	kun'lin'liu'shui'zuo'tai'ji	0
昆明池水汉时功	kun'ming'chi'shui'han'shi'gong	0
困人天气日初长	kun'ren'tian'qi'ri'chu'chang	0
来往预期程	lai'wang'yu'qi'cheng	0
兰陵美酒郁金香	lan'ling'mei'jiu'yu'jin'xiang	0
缆侵堤柳系	lan'qin'di'liu'xi	0
蓝水远从千涧落	lan'shui'yuan'cong'qian'jian'luo	0
老病有孤舟	lao'bing'you'gu'zhou	0
老妻画纸为棋局	lao'qi'hua'zhi'wei'qi'ju	0
老去悲秋强自宽	lao'qu'bei'qiu'qiang'zi'kuan	0
老去恨空闻	lao'qu'hen'kong'wen	0
乐事还同万众心	le'shi'hai'tong'wan'zhong'xin	0
雷惊天地龙蛇蛰	lei'jing'tian'di'long'she'zhe	0
泪血染成红杜鹃	lei'xue'ran'cheng'hong'du'juan	0
冷暖年来只自知	leng'nuan'nian'lai'zhi'zi'zhi	0
冷艳全欺雪	leng'yan'quan'qi'xue	0
离愁似个长	li'chou'si'ge'chang	0
梨花院落溶溶月	li'hua'yuan'luo'rong'rong'yue	0
澧水映园林	li'shui'ying'yuan'lin	0
离堂思琴瑟	li'tang'si'qin'se	0
利欲驱人万火牛	li'yu'qu'ren'wan'huo'niu	0
联步趋丹陛	lian'bu'qu'dan'bi	0
连理枝头花正开	lian'li'zhi'tou'hua'zheng'kai	0
连山到海隅	lian'shan'dao'hai'yu	0
恋赏未还镳	lian'shang'wei'huan'biao	0
凉风吹夜雨	liang'feng'chui'ye'yu	0
两个黄鹂鸣翠柳	liang'ge'huang'li'ming'cui'liu	0
两两时禽噪夕阳	liang'liang'shi'qin'zao'xi'yang	0
两山排闼送青来	liang'shan'pai'ta'song'qing'lai	0
两水夹明镜	liang'shui'jia'ming'jing	0
寥寥人境外	liao'liao'ren'jing'wai	0
猎马带禽归	lie'ma'dai'qin'gui	0
临风怀谢公	lin'feng'huai'xie'gong	0
林开扬子驿	lin'kai'yang'zi'yi	0
临眺独踌躇	lin'tiao'du'chou'chu	0
林下泉声静自来	lin'xia'quan'sheng'jing'zi'lai	0
林莺啼到无声处	lin'ying'ti'dao'wu'sheng'chu	0
林中观易罢	lin'zhong'guan'yi'ba	0
灵槎拟约同携手	ling'cha'ni'yue'tong'xie'shou	0
六鳌海上驾山来	liu'ao'hai'shang'jia'shan'lai	0
流出西湖载歌舞	liu'chu'xi'hu'zai'ge'wu	0
柳拂旌旗露未干	liu'fu'jing'qi'lu'wei'gan	0
留骑主人心	liu'qi'zhu'ren'xin	0
刘向传经心事违	liu'xiang'chuan'jing'xin'shi'wei	0
柳絮池塘淡淡风	liu'xu'chi'tang'dan'dan'feng	0
龙塞始应春	long'sai'shi'ying'chun	0
楼台倒影入池塘	lou'tai'dao'ying'ru'chi'tang	0
露冷莲房坠粉红	lu'leng'lian'fang'zhui'fen'hong	0
路上行人欲断魂	lu'shang'xing'ren'yu'duan'hun	0
鲈鱼正美不归去	lu'yu'zheng'mei'bu'gui'qu	0
路自中峰上	lu'zi'zhong'feng'shang	0
銮舆出狩回	luan'yu'chu'shou'hui	0
落落疏帘邀月影	luo'luo'shu'lian'yao'yue'ying	0
落日放船好	luo'ri'fang'chuan'hao	0
落日故人情	luo'ri'gu'ren'qing	0
落日五湖游	luo'ri'wu'hu'you	0
洛阳访才子	luo'yang'fang'cai'zi	0
洛阳三月花如锦	luo'yang'san'yue'hua'ru'jin	0
绿遍山原白满川	lv'bian'shan'yuan'bai'man'chuan	0
绿槐夹道集昏鸦	lv'huai'jia'dao'ji'hun'ya	0
律回岁晚冰霜少	lv'hui'sui'wan'bing'shuang'shao	0
绿柳才黄半未匀	lv'liu'cai'huang'ban'wei'yun	0
绿树阴浓夏日长	lv'shu'yin'nong'xia'ri'chang	0
绿水无痕夜气冲	lv'shui'wu'hen'ye'qi'chong	0
绿阴不减来时路	lv'yin'bu'jian'lai'shi'lu	0
绿阴冉冉遍天涯	lv'yin'ran'ran'bian'tian'ya	0
麻苎衣衫鬓发焦	ma'zhu'yi'shan'bin'fa'jiao	0
满壁画沧州	man'bi'hua'cang'zhou	0
满船明月浸虚空	man'chuan'ming'yue'jin'xu'kong	0
满架蔷薇一院香	man'jia'qiang'wei'yi'yuan'xiang	0
满阶梧叶月明中	man'jie'wu'ye'yue'ming'zhong	0
幔卷浪花浮	man'juan'lang'hua'fu	0
慢腾腾地暖烘烘	man'teng'teng'de'nuan'hong'hong	0
满眼蓬蒿共一丘	man'yan'peng'hao'gong'yi'qiu	0
茅檐常扫净无苔	mao'yan'chang'sao'jing'wu'tai	0
梅柳渡江春	mei'liu'du'jiang'chun	0
美人天上落	mei'ren'tian'shang'luo	0
每日江头尽醉归	mei'ri'jiang'tou'jin'zui'gui	0
梅须逊雪三分白	mei'xu'xun'xue'san'fen'bai	0
梅雪争春未肯降	mei'xue'zheng'chun'wei'ken'xiang	0
梅子黄时日日晴	mei'zi'huang'shi'ri'ri'qing	0
梅子留酸软齿牙	mei'zi'liu'suan'ruan'chi'ya	0
门泊东吴万里船	men'bo'dong'wu'wan'li'chuan	0
闷听笙歌聒醉人	men'ting'sheng'ge'guo'zui'ren	0
门外无人问落花	men'wai'wu'ren'wen'luo'hua	0
艨艟巨舰一毛轻	meng'chong'ju'jian'yi'mao'qing	0
梦魂摇曳橹声中	meng'hun'yao'ye'lu'sheng'zhong	0
梦与白云游	meng'yu'bai'yun'you	0
闽中我旧过	min'zhong'wo'jiu'guo	0
明朝有封事	ming'chao'you'feng'shi	0
明朝又是孤舟别	ming'chao'you'shi'gu'zhou'bie	0
鸣銮降紫霄	ming'luan'jiang'zi'xiao	0
明年此会知谁健	ming'nian'ci'hui'zhi'shui'jian	0
命仆安排新暖阁	ming'pu'an'pai'xin'nuan'ge	0
名岂文章著	ming'qi'wen'zhang'zhu	0
酩然直到太平时	ming'ran'zhi'dao'tai'ping'shi	0
明月来相照	ming'yue'lai'xiang'zhao	0
明月满前川	ming'yue'man'qian'chuan	0
明月明年何处看	ming'yue'ming'nian'he'chu'kan	0
明月随良掾	ming'yue'sui'liang'yuan	0
明月隐高树	ming'yue'yin'gao'shu	0
莫辞盏酒十分劝	mo'ci'zhan'jiu'shi'fen'quan	0
蓦地烧天蓦地空	mo'de'shao'tian'mo'de'kong	0
莫管城头奏暮笳	mo'guan'cheng'tou'zou'mu'jia	0
莫教枝上啼	mo'jiao'zhi'shang'ti	0
莫卖卢龙塞	mo'mai'lu'long'sai	0
莫谩愁沽酒	mo'man'chou'gu'jiu	0
漠漠水田飞白鹭	mo'mo'shui'tian'fei'bai'lu	0
莫遣纷纷点翠苔	mo'qian'fen'fen'dian'cui'tai	0
莫厌伤多酒入唇	mo'yan'shang'duo'jiu'ru'chun	0
暮惹御香归	mu're'yu'xiang'gui	0
牧人驱犊返	mu'ren'qu'du'fan	0
牧童归去横牛背	mu'tong'gui'qu'heng'niu'bei	0
牧童遥指杏花村	mu'tong'yao'zhi'xing'hua'cun	0
暮云收尽溢清寒	mu'yun'shou'jin'yi'qing'han	0
那堪时节正芳菲	na'kan'shi'jie'zheng'fang'fei	0
那知旧遗逸	na'zhi'jiu'yi'yi	0
南北山头多墓田	nan'bei'shan'tou'duo'mu'tian	0
南朝四百八十寺	nan'chao'si'bai'ba'shi'si	0
男儿到此是豪雄	nan'er'dao'ci'shi'hao'xiong	0
难分此夜中	nan'fen'ci'ye'zhong	0
南风不用蒲葵扇	nan'feng'bu'yong'pu'kui'shan	0
南楼纵目初	nan'lou'zong'mu'chu	0
南去北来休便休	nan'qu'bei'lai'xiu'bian'xiu	0
南山当户牖	nan'shan'dang'hu'you	0
南山当户转分明	nan'shan'dang'hu'zhuan'fen'ming	0
南山倚殿前	nan'shan'yi'dian'qian	0
南天瘴疠和	nan'tian'zhang'li'he	0
南枝才放两三花	nan'zhi'cai'fang'liang'san'hua	0
囊中自有钱	nang'zhong'zi'you'qian	0
能更几回眠	neng'geng'ji'hui'mian	0
能忘迟暮心	neng'wang'chi'mu'xin	0
呢喃燕子语梁间	ni'nan'yan'zi'yu'liang'jian	0
年来未觉新	nian'lai'wei'jue'xin	0
辇路生秋草	nian'lu'sheng'qiu'cao	0
年年不带看花眼	nian'nian'bu'dai'kan'hua'yan	0
年年乞与人间巧	nian'nian'qi'yu'ren'jian'qiao	0
鸟道高原去	niao'dao'gao'yuan'qu	0
浓墨淋漓两相麻	nong'mo'lin'li'liang'xiang'ma	0
暖风薰得游人醉	nuan'feng'xun'de'you'ren'zui	0
偶来松树下	ou'lai'song'shu'xia	0
偶坐为林泉	ou'zuo'wei'lin'quan	0
怕有渔郎来问津	pa'you'yu'lang'lai'wen'jin	0
盘回出薜萝	pan'hui'chu'bi'luo	0
佩声归到凤池头	pei'sheng'gui'dao'feng'chi'tou	0
蓬莱宫阙对南山	peng'lai'gong'que'dui'nan'shan	0
偏惊物候新	pian'jing'wu'hou'xin	0
偏宜上酒楼	pian'yi'shang'jiu'lou	0
片云头上黑	pian'yun'tou'shang'hei	0
飘飘何所似	piao'piao'he'suo'si	0
飘扬血色裙拖地	piao'yang'xue'se'qun'tuo'di	0
平分秋色一轮满	ping'fen'qiu'se'yi'lun'man	0
凭高何限意	ping'gao'he'xian'yi	0
凭栏十里芰荷香	ping'lan'shi'li'ji'he'xiang	0
平生一片心	ping'sheng'yi'pian'xin	0
平台访古游	ping'tai'fang'gu'you	0
凭轩涕泗流	ping'xuan'ti'si'liu	0
平野入青徐	ping'ye'ru'qing'xu	0
凄其霜露浓	qi'qi'shuang'lu'nong	0
崎岖不易行	qi'qu'bu'yi'xing	0
起视蚕稠怕叶稀	qi'shi'can'chou'pa'ye'xi	0
欹枕初惊一叶风	qi'zhen'chu'jing'yi'ye'feng	0
气蒸云梦泽	qi'zheng'yun'meng'ze	0
前度刘郎今又来	qian'du'liu'lang'jin'you'lai	0
千家山郭静朝晖	qian'jia'shan'guo'jing'zhao'hui	0
乾坤到十洲	qian'kun'dao'shi'zhou	0
乾坤日夜浮	qian'kun'ri'ye'fu	0
千里莺啼绿映红	qian'li'ying'ti'lv'ying'hong	0
前路日将斜	qian'lu'ri'jiang'xie	0
千门万户曈曈日	qian'men'wan'hu'tong'tong'ri	0
千条弱柳垂青琐	qian'tiao'ruo'liu'chui'qing'suo	0
强欲登高去	qiang'yu'deng'gao'qu	0
敲断玉钗红烛冷	qiao'duan'yu'chai'hong'zhu'leng	0
且看欲尽花经眼	qie'kan'yu'jin'hua'jing'yan	0
妾住在横塘	qie'zhu'zai'heng'tang	0
秦川朝望迥	qin'chuan'chao'wang'jiong	0
亲朋无一字	qin'peng'wu'yi'zi	0
青霭入看无	qing'ai'ru'kan'wu	0
轻薄桃花逐水流	qing'bo'tao'hua'zhu'shui'liu	0
青草池塘处处蛙	qing'cao'chi'tang'chu'chu'wa	0
青草池塘独听蛙	qing'cao'chi'tang'du'ting'wa	0
清晨入古寺	qing'chen'ru'gu'si	0
晴川历历汉阳树	qing'chuan'li'li'han'yang'shu	0
晴窗早觉爱朝曦	qing'chuang'zao'jiao'ai'zhao'xi	0
清风掠地秋先到	qing'feng'lve'di'qiu'xian'dao	0
清风明月无人管	qing'feng'ming'yue'wu'ren'guan	0
轻风生浪迟	qing'feng'sheng'lang'chi	0
晴光转绿蘋	qing'guang'zhuan'lv'pin	0
清和冷月到帘栊	qing'he'leng'yue'dao'lian'long	0
情怀小样杜陵诗	qing'huai'xiao'yang'du'ling'shi	0
清江一曲抱村流	qing'jiang'yi'qu'bao'cun'liu	0
情竭为知音	qing'jie'wei'zhi'yin	0
晴开万井树	qing'kai'wan'jing'shu	0
青莲喻法微	qing'lian'yu'fa'wei	0
轻罗小扇扑流萤	qing'luo'xiao'shan'pu'liu'ying	0
清明祭扫各纷然	qing'ming'ji'sao'ge'fen'ran	0
清明时节雨纷纷	qing'ming'shi'jie'yu'fen'fen	0
青女素娥俱耐冷	qing'nv'su'e'ju'nai'leng	0
清秋燕子故飞飞	qing'qiu'yan'zi'gu'fei'fei	0
青山横北郭	qing'shan'heng'bei'guo	0
青天江海流	qing'tian'jiang'hai'liu	0
清溪流过碧山头	qing'xi'liu'guo'bi'shan'tou	0
轻烟散入五侯家	qing'yan'san'ru'wu'hou'jia	0
青云羡鸟飞	qing'yun'xian'niao'fei	0
青云在目前	qing'yun'zai'mu'qian	0
秋风不相待	qiu'feng'bu'xiang'dai	0
秋风动禾黍	qiu'feng'dong'he'shu	0
秋风古北平	qiu'feng'gu'bei'ping	0
秋风落日斜	qiu'feng'luo'ri'xie	0
秋千院落夜沉沉	qiu'qian'yuan'luo'ye'chen'chen	0
秋色老梧桐	qiu'se'lao'wu'tong	0
秋声不可闻	qiu'sheng'bu'ke'wen	0
秋声万户竹	qiu'sheng'wan'hu'zhu	0
秋水才深四五尺	qiu'shui'cai'shen'si'wu'chi	0
曲罢不知人在否	qu'ba'bu'zhi'ren'zai'fou	0
曲径通幽处	qu'jing'tong'you'chu	0
去年花里逢君别	qu'nian'hua'li'feng'jun'bie	0
去日儿童皆长大	qu'ri'er'tong'jie'zhang'da	0
屈子怨何深	qu'zi'yuan'he'shen	0
劝君更尽一杯酒	quan'jun'geng'jin'yi'bei'jiu	0
泉声咽危石	quan'sheng'yan'wei'shi	0
却教明月送将来	que'jiao'ming'yue'song'jiang'lai	0
却疑春色在邻家	que'yi'chun'se'zai'lin'jia	0
惹得诗人说到今	re'de'shi'ren'shuo'dao'jin	0
人传有笙鹤	ren'chuan'you'sheng'he	0
人间长见画	ren'jian'chang'jian'hua	0
人间和气阁春阴	ren'jian'he'qi'ge'chun'yin	0
人间夜宿解双凫	ren'jian'ye'su'jie'shuang'fu	0
人乞祭余骄妾妇	ren'qi'ji'yu'jiao'qie'fu	0
人生七十古来稀	ren'sheng'qi'shi'gu'lai'xi	0
人生有酒须当醉	ren'sheng'you'jiu'xu'dang'zui	0
任是深山更深处	ren'shi'shen'shan'geng'shen'chu	0
人烟寒橘柚	ren'yan'han'ju'you	0
人烟小径通	ren'yan'xiao'jing'tong	0
日边红杏倚云栽	ri'bian'hong'xing'yi'yun'zai	0
日长似岁闲方觉	ri'chang'si'sui'xian'fang'jue	0
日出正东峰	ri'chu'zheng'dong'feng	0
日落狐狸眠冢上	ri'luo'hu'li'mian'zhong'shang	0
日暮汉宫传蜡烛	ri'mu'han'gong'chuan'la'zhu	0
日暮秋风起	ri'mu'qiu'feng'qi	0
日暮诗成天又雪	ri'mu'shi'cheng'tian'you'xue	0
日暮乡关何处是	ri'mu'xiang'guan'he'chu'shi	0
日绕龙鳞识圣颜	ri'rao'long'lin'shi'sheng'yan	0
日日江楼坐翠微	ri'ri'jiang'lou'zuo'cui'wei	0
日色才临仙掌动	ri'se'cai'lin'xian'zhang'dong	0
日色冷青松	ri'se'leng'qing'song	0
日长睡起无情思	ri'zhang'shui'qi'wu'qing'si	0
蓉菊满园皆可羡	rong'ju'man'yuan'jie'ke'xian	0
戎马关山北	rong'ma'guan'shan'bei	0
乳鸭池塘水浅深	ru'ya'chi'tang'shui'qian'shen	0
乳鸦啼散玉屏空	ru'ya'ti'san'yu'ping'kong	0
若待上林花似锦	ruo'dai'shang'lin'hua'si'jin	0
若非群玉山头见	ruo'fei'qun'yu'shan'tou'jian	0
塞上风云接地阴	sai'shang'feng'yun'jie'di'yin	0
塞上重笳音	sai'shang'zhong'jia'yin	0
散步咏凉天	san'bu'yong'liang'tian	0
三郎沉醉打球回	san'lang'chen'zui'da'qiu'hui	0
三月残花落更开	san'yue'can'hua'luo'geng'kai	0
三月正当三十日	san'yue'zheng'dang'san'shi'ri	0
桑柘废来犹纳税	sang'zhe'fei'lai'you'na'shui	0
桑柘影斜春社散	sang'zhe'ying'xie'chun'she'san	0
骚人阁笔费评章	sao'ren'ge'bi'fei'ping'zhang	0
纱窗宿斗牛	sha'chuang'su'dou'niu	0
纱帽闲眠对水鸥	sha'mao'xian'mian'dui'shui'ou	0
沙上凫雏傍母眠	sha'shang'fu'chu'bang'mu'mian	0
山出尽如鸣凤岭	shan'chu'jin'ru'ming'feng'ling	0
山出润州城	shan'chu'run'zhou'cheng	0
山从人面起	shan'cong'ren'mian'qi	0
山光悦鸟性	shan'guang'yue'niao'xing	0
山空松子落	shan'kong'song'zi'luo	0
山鸣万乘来	shan'ming'wan'sheng'lai	0
山色空蒙雨亦奇	shan'se'kong'meng'yu'yi'qi	0
山色远含空	shan'se'yuan'han'kong	0
山山惟落晖	shan'shan'wei'luo'hui	0
山外青山楼外楼	shan'wai'qing'shan'lou'wai'lou	0
山溪野径有梨花	shan'xi'ye'jing'you'li'hua	0
山衔落日浸寒漪	shan'xian'luo'ri'jin'han'yi	0
山晓望晴空	shan'xiao'wang'qing'kong	0
山意冲寒欲放梅	shan'yi'chong'han'yu'fang'mei	0
山中无历日	shan'zhong'wu'li'ri	0
山中习静观朝槿	shan'zhong'xi'jing'guan'chao'jin	0
上林花满枝	shang'lin'hua'man'zhi	0
商女不知亡国恨	shang'nv'bu'zhi'wang'guo'hen	0
赏心从此莫相违	shang'xin'cong'ci'mo'xiang'wei	0
尚衣方进翠云裘	shang'yi'fang'jin'cui'yun'qiu	0
上有黄鹂深树鸣	shang'you'huang'li'shen'shu'ming	0
尚有绨袍赠	shang'you'ti'pao'zeng	0
上冢亦携庞老家	shang'zhong'yi'xie'pang'lao'jia	0
谁与问东流	shei'yu'wen'dong'liu	0
身多疾病思田里	shen'duo'ji'bing'si'tian'li	0
身经两世太平日	shen'jing'liang'shi'tai'ping'ri	0
糁径杨花铺白毡	shen'jing'yang'hua'pu'bai'zhan	0
深林人不知	shen'lin'ren'bu'zhi	0
深山何处钟	shen'shan'he'chu'zhong	0
深深笼水浅笼沙	shen'shen'long'shui'qian'long'sha	0
圣朝无阙事	sheng'chao'wu'que'shi	0
升沉应已定	sheng'chen'ying'yi'ding	0
胜日寻芳泗水滨	sheng'ri'xun'fang'si'shui'bin	0
侍臣鹄立通明殿	shi'chen'hu'li'tong'ming'dian	0
诗成珠玉在挥毫	shi'cheng'zhu'yu'zai'hui'hao	0
事大如天醉亦休	shi'da'ru'tian'zui'yi'xiu	0
士甘焚死不公侯	shi'gan'fen'si'bu'gong'hou	0
时过北山头	shi'guo'bei'shan'tou	0
诗家清景在新春	shi'jia'qing'jing'zai'xin'chun	0
石鲸鳞甲动秋风	shi'jing'lin'jia'dong'qiu'feng	0
十年踪迹走红尘	shi'nian'zong'ji'zou'hong'chen	0
时人不识余心乐	shi'ren'bu'shi'yu'xin'le	0
世上漫相识	shi'shang'man'xiang'shi	0
世事茫茫难自料	shi'shi'mang'mang'nan'zi'liao	0
世事无端何足计	shi'shi'wu'duan'he'zu'ji	0
诗思浮沉樯影里	shi'si'fu'chen'qiang'ying'li	0
时挑野菜和根煮	shi'tiao'ye'cai'he'gen'zhu	0
手倦抛书午梦长	shou'juan'pao'shu'wu'meng'chang	0
数点渔灯依古岸	shu'dian'yu'deng'yi'gu'an	0
书寄北风遥	shu'ji'bei'feng'yao	0
书记远从征	shu'ji'yuan'cong'zheng	0
树接南山近	shu'jie'nan'shan'jin	0
数里入云峰	shu'li'ru'yun'feng	0
熟梅天气半晴阴	shu'mei'tian'qi'ban'qing'yin	0
树杪玉堂悬	shu'miao'yu'tang'xuan	0
淑气催黄鸟	shu'qi'cui'huang'niao	0
数声渔笛在沧浪	shu'sheng'yu'di'zai'cang'lang	0
树树皆秋色	shu'shu'jie'qiu'se	0
数问夜如何	shu'wen'ye'ru'he	0
疏影横斜水清浅	shu'ying'heng'xie'shui'qing'qian	0
疏凿控三巴	shu'zao'kong'san'ba	0
双蛾几许长	shuang'e'ji'xu'chang	0
双凤云中扶辇下	shuang'feng'yun'zhong'fu'nian'xia	0
霜落芝城柳影疏	shuang'luo'zhi'cheng'liu'ying'shu	0
双桥落彩虹	shuang'qiao'luo'cai'hong	0
霜禽欲下先偷眼	shuang'qin'yu'xia'xian'tou'yan	0
双双鸣玉珂	shuang'shuang'ming'yu'ke	0
双双瓦雀行书案	shuang'shuang'wa'que'xing'shu'an	0
水碧沙明两岸苔	shui'bi'sha'ming'liang'an'tai	0
水村山郭酒旗风	shui'cun'shan'guo'jiu'qi'feng	0
水光潋滟晴方好	shui'guang'lian'yan'qing'fang'hao	0
谁家吹笛画楼中	shui'jia'chui'di'hua'lou'zhong	0
谁家砧杵寂寥中	shui'jia'zhen'chu'ji'liao'zhong	0
睡觉东窗日已红	shui'jiao'dong'chuang'ri'yi'hong	0
水晶帘动微风起	shui'jing'lian'dong'wei'feng'qi	0
水流花谢两无情	shui'liu'hua'xie'liang'wu'qing	0
谁念北楼上	shui'nian'bei'lou'shang	0
睡起莞然成独笑	shui'qi'guan'ran'cheng'du'xiao	0
睡起秋声无觅处	shui'qi'qiu'sheng'wu'mi'chu	0
水心云影闲相照	shui'xin'yun'ying'xian'xiang'zhao	0
水远山长处处同	shui'yuan'shan'chang'chu'chu'tong	0
谁知恩遇深	shui'zhi'en'yu'shen	0
说与旁人浑不解	shuo'yu'pang'ren'hun'bu'jie	0
似得庐山路	si'de'lu'shan'lu	0
四顾山光接水光	si'gu'shan'guang'jie'shui'guang	0
丝纶阁下文章静	si'lun'ge'xia'wen'zhang'jing	0
思入风云变态中	si'ru'feng'yun'bian'tai'zhong	0
四时佳兴与人同	si'shi'jia'xing'yu'ren'tong	0
四十余年惠爱深	si'shi'yu'nian'hui'ai'shen	0
丝丝天棘出莓墙	si'si'tian'ji'chu'mei'qiang	0
四月清和雨乍晴	si'yue'qing'he'yu'zha'qing	0
送尽东风过楚城	song'jin'dong'feng'guo'chu'cheng	0
送君还旧府	song'jun'hai'jiu'fu	0
松清古殿扉	song'qing'gu'dian'fei	0
诵诗闻国政	song'shi'wen'guo'zheng	0
松下清斋折露葵	song'xia'qing'zhai'zhe'lu'kui	0
松下问童子	song'xia'wen'tong'zi	0
岁月人间促	sui'yue'ren'jian'cu	0
笋根稚子无人见	sun'gen'zhi'zi'wu'ren'jian	0
太平待诏归来日	tai'ping'dai'zhao'gui'lai'ri	0
太平天子朝元日	tai'ping'tian'zi'chao'yuan'ri	0
太乙近天都	tai'yi'jin'tian'du	0
弹琴复长啸	tan'qin'fu'chang'xiao	0
潭影空人心	tan'ying'kong'ren'xin	0
桃红又是一年春	tao'hong'you'shi'yi'nian'chun	0
桃花净尽菜花开	tao'hua'jing'jin'cai'hua'kai	0
啼时惊妾梦	ti'shi'jing'qie'meng	0
添得黄鹂四五声	tian'de'huang'li'si'wu'sheng	0
天地一沙鸥	tian'di'yi'sha'ou	0
天光云影共徘徊	tian'guang'yun'ying'gong'pai'huai	0
天花落不尽	tian'hua'luo'bu'jin	0
天街小雨润如酥	tian'jie'xiao'yu'run'ru'su	0
天阶夜色凉如水	tian'jie'ye'se'liang'ru'shui	0
天上碧桃和露种	tian'shang'bi'tao'he'lu'zhong	0
天上麒麟原有种	tian'shang'qi'lin'yuan'you'zhong	0
天上清光留此夕	tian'shang'qing'guang'liu'ci'xi	0
天上晓行骑只鹤	tian'shang'xiao'xing'qi'zhi'he	0
天时人事日相催	tian'shi'ren'shi'ri'xiang'cui	0
天台总映云	tian'tai'zong'ying'yun	0
天涯若比邻	tian'ya'ruo'bi'lin	0
田园荒尽尚征苗	tian'yuan'huang'jin'shang'zheng'miao	0
停船暂借问	ting'chuan'zan'jie'wen	0
庭昏未夕阴	ting'hun'wei'xi'yin	0
同来玩月人何在	tong'lai'wan'yue'ren'he'zai	0
同是宦游人	tong'shi'huan'you'ren	0
童孙未解供耕织	tong'sun'wei'jie'gong'geng'zhi	0
同学少年多不贱	tong'xue'shao'nian'duo'bu'jian	0
头上花枝照酒卮	tou'shang'hua'zhi'zhao'jiu'zhi	0
荼蘼香梦怯春寒	tu'mi'xiang'meng'qie'chun'han	0
涂抹新红上海棠	tu'mo'xin'hong'shang'hai'tang	0
徒有羡鱼情	tu'you'xian'yu'qing	0
豚栅鸡栖对掩扉	tun'shan'ji'qi'dui'yan'fei	0
万国衣冠拜冕旒	wan'guo'yi'guan'bai'mian'liu	0
万籁此俱寂	wan'lai'ci'ju'ji	0
万里渡河汾	wan'li'du'he'fen	0
万物静观皆自得	wan'wu'jing'guan'jie'zi'de	0
万物已随秋气改	wan'wu'yi'sui'qiu'qi'gai	0
万烛当楼宝扇开	wan'zhu'dang'lou'bao'shan'kai	0
万紫千红总是春	wan'zi'qian'hong'zong'shi'chun	0
王乔鹤不群	wang'qiao'he'bu'qun	0
王师非乐战	wang'shi'fei'le'zhan	0
为报空潭橘	wei'bao'kong'tan'ju	0
渭城朝雨浥轻尘	wei'cheng'zhao'yu'yi'qing'chen	0
未到晓钟犹是春	wei'dao'xiao'zhong'you'shi'chun	0
未会牵牛意若何	wei'hui'qian'niu'yi'ruo'he	0
惟解漫天作雪飞	wei'jie'man'tian'zuo'xue'fei	0
为客五更愁	wei'ke'wu'geng'chou	0
危樯独夜舟	wei'qiang'du'ye'zhou	0
位窃和羹重	wei'qie'he'geng'zhong	0
微躯此外更何求	wei'qu'ci'wai'geng'he'qiu	0
微躯敢一言	wei'qu'gan'yi'yan	0
为问门前客	wei'wen'men'qian'ke	0
为问蟠桃熟也无	wei'wen'pan'tao'shu'ye'wu	0
惟闻钟磬音	wei'wen'zhong'qing'yin	0
逶迤城阙重	wei'yi'cheng'que'zhong	0
惟有葵花向日倾	wei'you'kui'hua'xiang'ri'qing	0
为有源头活水来	wei'you'yuan'tou'huo'shui'lai	0
闻道欲来相问讯	wen'dao'yu'lai'xiang'wen'xun	0
问渠那得清如许	wen'qu'na'de'qing'ru'xu	0
闻说梅花早	wen'shuo'mei'hua'zao	0
文字鲁恭留	wen'zi'lu'gong'liu	0
卧看牵牛织女星	wo'kan'qian'niu'zhi'nv'xing	0
无边光景一时新	wu'bian'guang'jing'yi'shi'xin	0
吴楚东南坼	wu'chu'dong'nan'che	0
武帝旌旗在眼中	wu'di'jing'qi'zai'yan'zhong	0
无复明朝谏疏来	wu'fu'ming'chao'jian'shu'lai	0
无复侍臣知	wu'fu'shi'chen'zhi	0
舞阁金铺借日悬	wu'ge'jin'pu'jie'ri'xuan	0
五湖烟景有谁争	wu'hu'yan'jing'you'shui'zheng	0
无花无酒过清明	wu'hua'wu'jiu'guo'qing'ming	0
无将故人酒	wu'jiang'gu'ren'jiu	0
五陵贵公子	wu'ling'gui'gong'zi	0
五陵裘马自轻肥	wu'ling'qiu'ma'zi'qing'fei	0
无媒寄洛桥	wu'mei'ji'luo'qiao	0
乌鹊巢寒月一枝	wu'que'chao'han'yue'yi'zhi	0
无人不道看花回	wu'ren'bu'dao'kan'hua'hui	0
无人送酒来	wu'ren'song'jiu'lai	0
五色云车驾六龙	wu'se'yun'che'jia'liu'long	0
巫山巫峡气萧森	wu'shan'wu'xia'qi'xiao'sen	0
梧桐摇落故园秋	wu'tong'yao'luo'gu'yuan'qiu	0
无为在歧路	wu'wei'zai'qi'lu	0
五夜漏声催晓箭	wu'ye'lou'sheng'cui'xiao'jian	0
乌衣巷口夕阳斜	wu'yi'xiang'kou'xi'yang'xie	0
五月榴花照眼明	wu'yue'liu'hua'zhao'yan'ming	0
夕贬潮阳路八千	xi'bian'chao'yang'lu'ba'qian	0
细草微风岸	xi'cao'wei'feng'an	0
西出阳关无故人	xi'chu'yang'guan'wu'gu'ren	0
锡飞常近鹤	xi'fei'chang'jin'he	0
西湖歌舞几时休	xi'hu'ge'wu'ji'shi'xiu	0
西江取竹起高楼	xi'jiang'qu'zhu'qi'gao'lou	0
淅沥度秋声	xi'li'du'qiu'sheng	0
西楼望月几回圆	xi'lou'wang'yue'ji'hui'yuan	0
昔年亲友半凋零	xi'nian'qin'you'ban'diao'ling	0
昔人已乘黄鹤去	xi'ren'yi'cheng'huang'he'qu	0
溪上对鸥闲	xi'shang'dui'ou'xian	0
昔时人已没	xi'shi'ren'yi'mei	0
细数落花因坐久	xi'shu'luo'hua'yin'zuo'jiu	0
细推物理须行乐	xi'tui'wu'li'xu'xing'le	0
西望长安不见家	xi'wang'chang'an'bu'jian'jia	0
西望瑶池降王母	xi'wang'yao'chi'jiang'wang'mu	0
昔闻洞庭水	xi'wen'dong'ting'shui	0
夕阳连雨足	xi'yang'lian'yu'zu	0
夕阳箫鼓几船归	xi'yang'xiao'gu'ji'chuan'gui	0
徙倚欲何依	xi'yi'yu'he'yi	0
西园翰墨林	xi'yuan'han'mo'lin	0
下方城郭近	xia'fang'cheng'guo'jin	0
下来闲处从容立	xia'lai'xian'chu'cong'rong'li	0
峡云无迹任西东	xia'yun'wu'ji'ren'xi'dong	0
仙风吹下御炉香	xian'feng'chui'xia'yu'lu'xiang	0
仙管凤凰调	xian'guan'feng'huang'tiao	0
闲看儿童捉柳花	xian'kan'er'tong'zhuo'liu'hua	0
闲来无事不从容	xian'lai'wu'shi'bu'cong'rong	0
闲敲棋子落灯花	xian'qiao'qi'zi'luo'deng'hua	0
仙人掌上玉芙蓉	xian'ren'zhang'shang'yu'fu'rong	0
仙游实壮哉	xian'you'shi'zhuang'zai	0
贤愚千载知谁是	xian'yu'qian'zai'zhi'shui'shi	0
仙云拂马来	xian'yun'fu'ma'lai	0
先至洛阳城	xian'zhi'luo'yang'cheng	0
闲坐听春禽	xian'zuo'ting'chun'qin	0
闲坐小窗读周易	xian'zuo'xiao'chuang'du'zhou'yi	0
乡村四月闲人少	xiang'cun'si'yue'xian'ren'shao	0
响遏行云横碧落	xiang'e'xing'yun'heng'bi'luo	0
相逢剧孟家	xiang'feng'ju'meng'jia	0
香阁东山下	xiang'ge'dong'shan'xia	0
相顾无相识	xiang'gu'wu'xiang'shi	0
相看两不厌	xiang'kan'liang'bu'yan	0
向来枉费推移力	xiang'lai'wang'fei'tui'yi'li	0
相亲相近水中鸥	xiang'qin'xiang'jin'shui'zhong'ou	0
香刹夜忘归	xiang'sha'ye'wang'gui	0
乡书何由达	xiang'shu'he'you'da	0
相送柴门月色新	xiang'song'chai'men'yue'se'xin	0
香雾空蒙月转廊	xiang'wu'kong'meng'yue'zhuan'lang	0
香烟欲傍衮龙浮	xiang'yan'yu'bang'gun'long'fu	0
小臣持献寿	xiao'chen'chi'xian'shou	0
晓窗分与读书灯	xiao'chuang'fen'yu'du'shu'deng	0
晓风残月入华清	xiao'feng'can'yue'ru'hua'qing	0
小扣柴扉久不开	xiao'kou'chai'fei'jiu'bu'kai	0
笑倩旁人为正冠	xiao'qian'pang'ren'wei'zheng'guan	0
萧瑟动寒林	xiao'se'dong'han'lin	0
晓随天仗入	xiao'sui'tian'zhang'ru	0
小溪泛尽却山行	xiao'xi'fan'jin'que'shan'xing	0
潇湘何事等闲回	xiao'xiang'he'shi'deng'xian'hui	0
潇湘水北流	xiao'xiang'shui'bei'liu	0
萧萧班马鸣	xiao'xiao'ban'ma'ming	0
萧萧枫树林	xiao'xiao'feng'shu'lin	0
萧萧送雁群	xiao'xiao'song'yan'qun	0
小檐日日燕飞来	xiao'yan'ri'ri'yan'fei'lai	0
小苑莺歌歇	xiao'yuan'ying'ge'xie	0
晓云连幕卷	xiao'yun'lian'mu'juan	0
携取旧书归旧隐	xie'qu'jiu'shu'gui'jiu'yin	0
谢却海棠飞尽絮	xie'que'hai'tang'fei'jin'xu	0
信宿渔人还泛泛	xin'su'yu'ren'hai'fan'fan	0
心绪逢摇落	xin'xu'feng'yao'luo	0
星辰冷落碧潭水	xing'chen'leng'luo'bi'tan'shui	0
行尽江南数十程	xing'jin'jiang'nan'shu'shi'cheng	0
兴来今日尽君欢	xing'lai'jin'ri'jin'jun'huan	0
兴来三弄有桓子	xing'lai'san'nong'you'huan'zi	0
兴来书自圣	xing'lai'shu'zi'sheng	0
星临万户动	xing'lin'wan'hu'dong	0
星随平野阔	xing'sui'ping'ye'kuo	0
兴味萧然似野僧	xing'wei'xiao'ran'si'ye'seng	0
行矣慎风波	xing'yi'shen'feng'bo	0
幸有微吟可相狎	xing'you'wei'yin'ke'xiang'xia	0
行舟绿水前	xing'zhou'lv'shui'qian	0
兴逐乱红穿柳巷	xing'zhu'luan'hong'chuan'liu'xiang	0
羞将短发还吹帽	xiu'jiang'duan'fa'hai'chui'mao	0
须邀织女弄金梭	xu'yao'zhi'nv'nong'jin'suo	0
悬灯千嶂夕	xuan'deng'qian'zhang'xi	0
玄都观里桃千树	xuan'du'guan'li'tao'qian'shu	0
悬军幕井干	xuan'jun'mu'jing'gan	0
旋斫生柴带叶烧	xuan'zhuo'sheng'chai'dai'ye'shao	0
雪里吟香弄粉些	xue'li'yin'xiang'nong'fen'xie	0
雪却输梅一段香	xue'que'shu'mei'yi'duan'xiang	0
雪消华月满仙台	xue'xiao'hua'yue'man'xian'tai	0
雪拥蓝关马不前	xue'yong'lan'guan'ma'bu'qian	0
穴中蝼蚁岂能逃	xue'zhong'lou'yi'qi'neng'tao	0
寻常一样窗前月	xun'chang'yi'yang'chuang'qian'yue	0
寻得桃源好避秦	xun'de'tao'yuan'hao'bi'qin	0
烟波处处愁	yan'bo'chu'chu'chou	0
烟波江上使人愁	yan'bo'jiang'shang'shi'ren'chou	0
烟含北渚遥	yan'han'bei'zhu'yao	0
烟花象外幽	yan'hua'xiang'wai'you	0
燕姬翠黛愁	yan'ji'cui'dai'chou	0
眼见四朝全盛时	yan'jian'si'chao'quan'sheng'shi	0
眼看春又去	yan'kan'chun'you'qu	0
烟笼寒水月笼沙	yan'long'han'shui'yue'long'sha	0
言师采药去	yan'shi'cai'yao'qu	0
烟霞此地多	yan'xia'ci'di'duo	0
檐牙燕雀已生成	yan'ya'yan'que'yi'sheng'cheng	0
燕赵悲歌士	yan'zhao'bei'ge'shi	0
砚中旗影动龙蛇	yan'zhong'qi'ying'dong'long'she	0
养成寒碧映涟漪	yang'cheng'han'bi'ying'lian'yi	0
阳春一曲和皆难	yang'chun'yi'qu'he'jie'nan	0
杨花榆荚无才思	yang'hua'yu'jia'wu'cai'si	0
腰横秋水雁翎刀	yao'heng'qiu'shui'yan'ling'dao	0
遥怜故园菊	yao'lian'gu'yuan'ju	0
妖蟆休向眼前生	yao'ma'xiu'xiang'yan'qian'sheng	0
遥天浸白波	yao'tian'jin'bai'bo	0
要知尽庆华封祝	yao'zhi'jin'qing'hua'feng'zhu	0
夜半钟声到客船	ye'ban'zhong'sheng'dao'ke'chuan	0
也傍桑阴学种瓜	ye'bang'sang'yin'xue'zhong'gua	0
夜泊秦淮近酒家	ye'bo'qin'huai'jin'jiu'jia	0
野渡无人舟自横	ye'du'wu'ren'zhou'zi'heng	0
野芳虽晚不须嗟	ye'fang'sui'wan'bu'xu'jie	0
叶浮嫩绿酒初熟	ye'fu'nen'lv'jiu'chu'shu	0
夜归儿女笑灯前	ye'gui'er'nv'xiao'deng'qian	0
野航恰受两三人	ye'hang'qia'shou'liang'san'ren	0
夜合花开香满庭	ye'he'hua'kai'xiang'man'ting	0
野花啼鸟一般春	ye'hua'ti'niao'yi'ban'chun	0
夜火杂星回	ye'huo'za'xing'hui	0
也教插柳纪年华	ye'jiao'cha'liu'ji'nian'hua	0
夜来风雨声	ye'lai'feng'yu'sheng	0
野老与人争席罢	ye'lao'yu'ren'zheng'xi'ba	0
夜深搔首叹飞蓬	ye'shen'sao'shou'tan'fei'peng	0
夜深微雨醉初醒	ye'shen'wei'yu'zui'chu'xing	0
野田荒冢只生愁	ye'tian'huang'zhong'zhi'sheng'chou	0
夜闻啼雁生乡思	ye'wen'ti'yan'sheng'xiang'si	0
也应无计避征徭	ye'ying'wu'ji'bi'zheng'yao	0
一墀月浸紫薇花	yi'chi'yue'jin'zi'wei'hua	0
一从梅粉褪残妆	yi'cong'mei'fen'tui'can'zhuang	0
一滴何曾到九泉	yi'di'he'ceng'dao'jiu'quan	0
一朵红云捧玉皇	yi'duo'hong'yun'peng'yu'huang	0
一番萧瑟禁烟中	yi'fan'xiao'se'jin'yan'zhong	0
一封朝奏九重天	yi'feng'chao'zou'jiu'chong'tian	0
义公习禅寂	yi'gong'xi'chan'ji	0
衣冠身惹御炉香	yi'guan'shen're'yu'lu'xiang	0
一行白鹭上青天	yi'hang'bai'lu'shang'qing'tian	0
一泓清可沁诗脾	yi'hong'qing'ke'qin'shi'pi	0
一年好景君须记	yi'nian'hao'jing'jun'xu'ji	0
一片花飞减却春	yi'pian'hua'fei'jian'que'chun	0
一曲升平人共乐	yi'qu'sheng'ping'ren'gong'le	0
依然枉却一东风	yi'ran'wang'que'yi'dong'feng	0
一任晚山相对愁	yi'ren'wan'shan'xiang'dui'chou	0
疑是蟾宫谪降仙	yi'shi'chan'gong'zhe'jiang'xian	0
疑是地上霜	yi'shi'di'shang'shuang	0
一事无成两鬓丝	yi'shi'wu'cheng'liang'bin'si	0
一水护田将绿绕	yi'shui'hu'tian'jiang'lv'rao	0
一团茅草乱蓬蓬	yi'tuan'mao'cao'luan'peng'peng	0
一为迁客去长沙	yi'wei'qian'ke'qu'chang'sha	0
一卧沧江惊岁晚	yi'wo'cang'jiang'jing'sui'wan	0
邑有流亡愧俸钱	yi'you'liu'wang'kui'feng'qian	0
一枕新凉一扇风	yi'zhen'xin'liang'yi'shan'feng	0
一枝红杏出墙来	yi'zhi'hong'xing'chu'qiang'lai	0
一樽竟藉青苔卧	yi'zun'jing'ji'qing'tai'wo	0
一樽聊为晚凉开	yi'zun'liao'wei'wan'liang'kai	0
因风想玉坷	yin'feng'xiang'yu'ke	0
因过竹院逢僧话	yin'guo'zhu'yuan'feng'seng'hua	0
银汉无声转玉盘	yin'han'wu'sheng'zhuan'yu'pan	0
殷勤送客出鄱湖	yin'qin'song'ke'chu'po'hu	0
殷勤竹林寺	yin'qin'zhu'lin'si	0
阴晴众壑殊	yin'qing'zhong'he'shu	0
阴阴夏木啭黄鹂	yin'yin'xia'mu'zhuan'huang'li	0
银烛朝天紫陌长	yin'zhu'chao'tian'zi'mo'chang	0
银烛秋光冷画屏	yin'zhu'qiu'guang'leng'hua'ping	0
银烛吐清烟	yin'zhu'tu'qing'yan	0
应傍战场开	ying'bang'zhan'chang'kai	0
应怜范叔寒	ying'lian'fan'shu'han	0
应怜屐齿印苍苔	ying'lian'ji'chi'yin'cang'tai	0
映门淮水绿	ying'men'huai'shui'lv	0
映日荷花别样红	ying'ri'he'hua'bie'yang'hong	0
应是雨催诗	ying'shi'yu'cui'shi	0
萤焰高低照暮空	ying'yan'gao'di'zhao'mu'kong	0
莺啭皇州春色阑	ying'zhuan'huang'zhou'chun'se'lan	0
油壁香车不再逢	you'bi'xiang'che'bu'zai'feng	0
又得浮生半日闲	you'dei'fu'sheng'ban'ri'xian	0
忧来谁共语	you'lai'shui'gong'yu	0
由来天下传	you'lai'tian'xia'chuan	0
有梅无雪不精神	you'mei'wu'xue'bu'jing'shen	0
游人五陵去	you'ren'wu'ling'qu	0
幽人应未眠	you'ren'ying'wei'mian	0
有雪无诗俗了人	you'xue'wu'shi'su'le'ren	0
犹有六朝僧	you'you'liu'chao'seng	0
悠悠洛阳去	you'you'luo'yang'qu	0
有约不来过夜半	you'yue'bu'lai'guo'ye'ban	0
犹作布衣看	you'zuo'bu'yi'kan	0
欲把西湖比西子	yu'ba'xi'hu'bi'xi'zi	0
鱼海路常难	yu'hai'lu'chang'nan	0
雨后全无叶底花	yu'hou'quan'wu'ye'di'hua	0
欲济无舟楫	yu'ji'wu'zhou'ji	0
玉阶仙仗拥千官	yu'jie'xian'zhang'yong'qian'guan	0
与君离别意	yu'jun'li'bie'yi	0
雨来沾席上	yu'lai'zhan'xi'shang	0
玉露凋伤枫树林	yu'lu'diao'shang'feng'shu'lin	0
与梅井作十分春	yu'mei'jing'zuo'shi'fen'chun	0
禹庙空山里	yu'miao'kong'shan'li	0
雨前初见花间蕊	yu'qian'chu'jian'hua'jian'rui	0
欲穷千里目	yu'qiong'qian'li'mu	0
玉人歌舞未曾归	yu'ren'ge'wu'wei'ceng'gui	0
玉山高并两峰寒	yu'shan'gao'bing'liang'feng'han	0
欲舒老眼无高处	yu'shu'lao'yan'wu'gao'chu	0
鱼书欲寄何由达	yu'shu'yu'ji'he'you'da	0
欲投人处宿	yu'tou'ren'chu'su	0
玉碗盛来琥珀光	yu'wan'sheng'lai'hu'po'guang	0
余香乍入衣	yu'xiang'zha'ru'yi	0
余音嘹亮尚飘空	yu'yin'liao'liang'shang'piao'kong	0
欲知世掌丝纶美	yu'zhi'shi'zhang'si'lun'mei	0
雨足郊原草木柔	yu'zu'jiao'yuan'cao'mu'rou	0
苑边高冢卧麒麟	yuan'bian'gao'zhong'wo'qi'lin	0
愿教青帝常为主	yuan'jiao'qing'di'chang'wei'zhu	0
远近山河净	yuan'jin'shan'he'jing	0
园收芋栗未全贫	yuan'shou'yu'li'wei'quan'pin	0
远书珍重何由达	yuan'shu'zhen'zhong'he'you'da	0
沅湘流不尽	yuan'xiang'liu'bu'jin	0
月傍九霄多	yue'bang'jiu'xiao'duo	0
月陂堤上四徘徊	yue'bei'di'shang'si'pai'huai	0
月钩初上紫薇花	yue'gou'chu'shang'zi'wei'hua	0
月光如水水如天	yue'guang'ru'shui'shui'ru'tian	0
月过北庭寒	yue'guo'bei'ting'han	0
月落乌啼霜满天	yue'luo'wu'ti'shuang'man'tian	0
越女红裙湿	yue'nv'hong'qun'shi	0
乐圣且衔杯	yue'sheng'qie'xian'bei	0
月移花影上栏杆	yue'yi'hua'ying'shang'lan'gan	0
月涌大江流	yue'yong'da'jiang'liu	0
月中霜里斗婵娟	yue'zhong'shuang'li'dou'chan'juan	0
云傍马头生	yun'bang'ma'tou'sheng	0
云标金阙迥	yun'biao'jin'que'jiong	0
云淡风轻近午天	yun'dan'feng'qing'jin'wu'tian	0
云阁薄边功	yun'ge'bo'bian'gong	0
云横秦岭家何在	yun'heng'qin'ling'jia'he'zai	0
云间仙籁寂无声	yun'jian'xian'lai'ji'wu'sheng	0
云气生虚壁	yun'qi'sheng'xu'bi	0
云深不知处	yun'shen'bu'zhi'chu	0
云物不殊乡国异	yun'wu'bu'shu'xiang'guo'yi	0
云物凄凉拂曙流	yun'wu'qi'liang'fu'shu'liu	0
云霞出海曙	yun'xia'chu'hai'shu	0
云想衣裳花想容	yun'xiang'yi'shang'hua'xiang'rong	0
云移雉尾开宫扇	yun'yi'zhi'wei'kai'gong'shan	0
载歌春兴曲	zai'ge'chun'xing'qu	0
暂时相赏莫相违	zan'shi'xiang'shang'mo'xiang'wei	0
早知乘四载	zao'zhi'cheng'si'zai	0
早知清净理	zao'zhi'qing'jing'li	0
摘尽枇杷一树金	zhai'jin'pi'pa'yi'shu'jin	0
占尽风情向小园	zhan'jin'feng'qing'xiang'xiao'yuan	0
沾衣欲湿杏花雨	zhan'yi'yu'shi'xing'hua'yu	0
帐殿郁崔嵬	zhang'dian'yu'cui'wei	0
仗剑行千里	zhang'jian'xing'qian'li	0
杖藜扶我过桥东	zhang'li'fu'wo'guo'qiao'dong	0
杖藜携酒看芝山	zhang'li'xie'jiu'kan'zhi'shan	0
杖藜徐步立芳洲	zhang'li'xu'bu'li'fang'zhou	0
赵氏连城璧	zhao'shi'lian'cheng'bi	0
朝朝染翰侍君王	zhao'zhao'ran'han'shi'jun'wang	0
谪去君无恨	zhe'qu'jun'wu'hen	0
砧杵敲残深巷月	zhen'chu'qiao'can'shen'xiang'yue	0
枕簟仍教到处随	zhen'dian'reng'jiao'dao'chu'sui	0
真随惠远游	zhen'sui'hui'yuan'you	0
朕与先生解战袍	zhen'yu'xian'sheng'jie'zhan'pao	0
蒸藜炊黍饷东菑	zheng'li'chui'shu'xiang'dong'zi	0
争忍花前不醉归	zheng'ren'hua'qian'bu'zui'gui	0
争似满炉煨榾柮	zheng'si'man'lu'wei'gu'duo	0
正有高堂宴	zheng'you'gao'tang'yan	0
直把杭州作汴州	zhi'ba'hang'zhou'zuo'bian'zhou	0
咫尺愁风雨	zhi'chi'chou'feng'yu	0
纸灰飞作白蝴蝶	zhi'hui'fei'zuo'bai'hu'die	0
枝间时见子初成	zhi'jian'shi'jian'zi'chu'cheng	0
只恐风花一片飞	zhi'kong'feng'hua'yi'pian'fei	0
只恐夜深花睡去	zhi'kong'ye'shen'hua'shui'qu	0
掷柳迁乔太有情	zhi'liu'qian'qiao'tai'you'qing	0
织女机丝虚夜月	zhi'nv'ji'si'xu'ye'yue	0
纸屏石枕竹方床	zhi'ping'shi'zhen'zhu'fang'chuang	0
直堑回塘滟滟时	zhi'qian'hui'tang'yan'yan'shi	0
知汝远来应有意	zhi'ru'yuan'lai'ying'you'yi	0
只是夜猿多	zhi'shi'ye'yuan'duo	0
只疑云雾窟	zhi'yi'yun'wu'ku	0
只因误识林和靖	zhi'yin'wu'shi'lin'he'jing	0
只有敬亭山	zhi'you'jing'ting'shan	0
知有前期在	zhi'you'qian'qi'zai	0
直欲樵渔过此生	zhi'yu'qiao'yu'guo'ci'sheng	0
只在此山中	zhi'zai'ci'shan'zhong	0
稚子敲针作钓钩	zhi'zi'qiao'zhen'zuo'diao'gou	0
之子慎佳兵	zhi'zi'shen'jia'bing	0
终乏掞天才	zhong'fa'shan'tian'cai	0
众芳摇落独暄妍	zhong'fang'yao'luo'du'xuan'yan	0
中峰绕瑞烟	zhong'feng'rao'rui'yan	0
钟鼓楼中刻漏长	zhong'gu'lou'zhong'ke'lou'chang	0
众鸟高飞尽	zhong'niao'gao'fei'jin	0
钟磬杂笙歌	zhong'qing'za'sheng'ge	0
终日昏昏醉梦间	zhong'ri'hun'hun'zui'meng'jian	0
种桃道士归何处	zhong'tao'dao'shi'gui'he'chu	0
昼出耘田夜绩麻	zhou'chu'yun'tian'ye'ji'ma	0
竹覆经冬雪	zhu'fu'jing'dong'xue	0
竹篱茅舍自甘心	zhu'li'mao'she'zi'gan'xin	0
竹炉汤沸火初红	zhu'lu'tang'fei'huo'chu'hong	0
朱门虽富不如贫	zhu'men'sui'fu'bu'ru'pin	0
朱雀桥边野草花	zhu'que'qiao'bian'ye'cao'hua	0
主人不相识	zhu'ren'bu'xiang'shi	0
竹深留客处	zhu'shen'liu'ke'chu	0
竹外秋声渐作威	zhu'wai'qiu'sheng'jian'zuo'wei	0
蛛网添丝屋角晴	zhu'wang'tian'si'wu'jiao'qing	0
珠系比丘衣	zhu'xi'bi'qiu'yi	0
竹摇清影罩幽窗	zhu'yao'qing'ying'zhao'you'chuang	0
妆楼翠幌教春住	zhuang'lou'cui'huang'jiao'chun'zhu	0
壮士发冲冠	zhuang'shi'fa'chong'guan	0
准拟今春乐事浓	zhun'ni'jin'chun'le'shi'nong	0
自当逢雨露	zi'dang'feng'yu'lu	0
子规声里雨如烟	zi'gui'sheng'li'yu'ru'yan	0
子规啼彻四更时	zi'gui'ti'che'si'geng'shi	0
子规夜半犹啼血	zi'gui'ye'ban'you'ti'xue	0
自觉谏书稀	zi'jue'jian'shu'xi	0
紫陌红尘拂面来	zi'mo'hong'chen'fu'mian'lai	0
自去自来梁上燕	zi'qu'zi'lai'liang'shang'yan	0
自是不归归便得	zi'shi'bu'gui'gui'bian'dei	0
紫绶纵荣争及睡	zi'shou'zong'rong'zheng'ji'shui	0
紫薇花对紫薇郎	zi'wei'hua'dui'zi'wei'lang	0
紫艳半开篱菊静	zi'yan'ban'kai'li'ju'jing	0
总把新桃换旧符	zong'ba'xin'tao'huan'jiu'fu	0
纵横礼乐三千字	zong'heng'li'yue'san'qian'zi	0
踪迹大纲王粲传	zong'ji'da'gang'wang'can'chuan	0
祖帐连河阙	zu'zhang'lian'he'que	0
醉把茱萸仔细看	zui'ba'zhu'yu'zi'xi'kan	0
醉后语尤颠	zui'hou'yu'you'dian	0
最是橙黄橘绿时	zui'shi'cheng'huang'ju'lv'shi	0
最是一年春好处	zui'shi'yi'nian'chun'hao'chu	0
坐观垂钓者	zuo'guan'chui'diao'zhe	0
坐觉烟尘扫	zuo'jue'yan'chen'sao	0
昨日邻家乞新火	zuo'ri'lin'jia'qi'xin'huo	0
昨夜江边春水生	zuo'ye'jiang'bian'chun'shui'sheng	0
