哀牢山带	ai'lao'shan'dai	0
板块边界地震	ban'kuai'bian'jie'di'zhen	0
板块运动	ban'kuai'yun'dong	0
板内地震	ban'nei'di'zhen	0
板缘地震	ban'yuan'di'zhen	0
崩塌	beng'ta	0
变位错动	bian'wei'cuo'dong	0
测量场地	ce'liang'chang'di	0
测震	ce'zhen	0
长周期	chang'zhou'qi	0
传播方向	chuan'bo'fang'xiang	0
次生灾害	ci'sheng'zai'hai	0
大地电磁	da'di'dian'ci	0
大地振动	da'di'zhen'dong	0
大陆裂谷地震活动带	da'lu'lie'gu'di'zhen'huo'dong'dai	0
大洋中脊地震活动带	da'yang'zhong'ji'di'zhen'huo'dong'dai	0
单发型序列	dan'fa'xing'xu'lie	0
地表	di'biao	0
地表地质特征	di'biao'di'zhi'te'zheng	0
地层陷落	di'ceng'xian'luo	0
地磁	di'ci	0
地磁测量	di'ci'ce'liang	0
地电	di'dian	0
地电观测	di'dian'guan'ce	0
地动仪	di'dong'yi	0
地方震	di'fang'zhen	0
地光	di'guang	0
地光烧伤	di'guang'shao'shang	0
地裂缝	di'lie'feng	0
地面的破坏	di'mian'de'po'huai	0
地面振动	di'mian'zhen'dong	0
地壳	di'qiao	0
地壳形变观测	di'qiao'xing'bian'guan'ce	0
地壳振动	di'qiao'zhen'dong	0
地球表层	di'qiu'biao'ceng	0
地球动力学	di'qiu'dong'li'xue	0
地球内部传播	di'qiu'nei'bu'chuan'bo	0
地球深部构造	di'qiu'shen'bu'gou'zao	0
地球重力场	di'qiu'zhong'li'chang	0
地声	di'sheng	0
地下核爆炸	di'xia'he'bao'zha	0
地下流体	di'xia'liu'ti	0
地下水异常	di'xia'shui'yi'chang	0
地心轨道	di'xin'gui'dao	0
地心角	di'xin'jiao	0
地心经度	di'xin'jing'du	0
地心距离	di'xin'ju'li	0
地心圈	di'xin'quan	0
地心体系	di'xin'ti'xi	0
地心天顶	di'xin'tian'ding	0
地心纬度	di'xin'wei'du	0
地心位置	di'xin'wei'zhi	0
地心引力	di'xin'yin'li	0
地心坐标	di'xin'zuo'biao	0
地形变	di'xing'bian	0
地学大断面探测研究	di'xue'da'duan'mian'tan'ce'yan'jiu	0
地应力观测	di'ying'li'guan'ce	0
地震	di'zhen	0
地震保险	di'zhen'bao'xian	0
地震避难	di'zhen'bi'nan	0
地震波	di'zhen'bo	0
地震波传播	di'zhen'bo'chuan'bo	0
地震波衰减	di'zhen'bo'shuai'jian	0
地震波速比	di'zhen'bo'su'bi	0
地震波速度	di'zhen'bo'su'du	0
地震波体波	di'zhen'bo'ti'bo	0
地震波走时	di'zhen'bo'zou'shi	0
地震波走时异常	di'zhen'bo'zou'shi'yi'chang	0
地震不连续面	di'zhen'bu'lian'xu'mian	0
地震参数	di'zhen'can'shu	0
地震测震学	di'zhen'ce'zhen'xue	0
地震层序	di'zhen'ceng'xu	0
地震场	di'zhen'chang	0
地震长期预报	di'zhen'chang'qi'yu'bao	0
地震成像	di'zhen'cheng'xiang	0
地震成因	di'zhen'cheng'yin	0
地震重复间隔	di'zhen'chong'fu'jian'ge	0
地震初波	di'zhen'chu'bo	0
地震错距	di'zhen'cuo'ju	0
地震大地构造学	di'zhen'da'di'gou'zao'xue	0
地震带	di'zhen'dai	0
地震道	di'zhen'dao	0
地震的原生现象	di'zhen'de'yuan'sheng'xian'xiang	0
地震地磁	di'zhen'di'ci	0
地震地貌	di'zhen'di'mao	0
地震地质	di'zhen'di'zhi	0
地震地质效应	di'zhen'di'zhi'xiao'ying	0
地震地质学	di'zhen'di'zhi'xue	0
地震地质灾害	di'zhen'di'zhi'zai'hai	0
地震电效应	di'zhen'dian'xiao'ying	0
地震调查	di'zhen'diao'cha	0
地震定量	di'zhen'ding'liang	0
地震定位	di'zhen'ding'wei	0
地震动参数	di'zhen'dong'can'shu	0
地震陡坎	di'zhen'dou'kan	0
地震断层	di'zhen'duan'ceng	0
地震断层错动	di'zhen'duan'ceng'cuo'dong	0
地震短期预报	di'zhen'duan'qi'yu'bao	0
地震对策	di'zhen'dui'ce	0
地震反射	di'zhen'fan'she	0
地震反演	di'zhen'fan'yan	0
地震反应	di'zhen'fan'ying	0
地震反应谱	di'zhen'fan'ying'pu	0
地震反应小区划	di'zhen'fan'ying'xiao'qu'hua	0
地震放大器	di'zhen'fang'da'qi	0
地震分布图	di'zhen'fen'bu'tu	0
地震分类	di'zhen'fen'lei	0
地震复发	di'zhen'fu'fa	0
地震各向异性	di'zhen'ge'xiang'yi'xing	0
地震工程	di'zhen'gong'cheng	0
地震工程地质条件	di'zhen'gong'cheng'di'zhi'tiao'jian	0
地震工程地质学	di'zhen'gong'cheng'di'zhi'xue	0
地震工程学	di'zhen'gong'cheng'xue	0
地震构造	di'zhen'gou'zao	0
地震构造区	di'zhen'gou'zao'qu	0
地震构造区划	di'zhen'gou'zao'qu'hua	0
地震构造图	di'zhen'gou'zao'tu	0
地震观测	di'zhen'guan'ce	0
地震光缆	di'zhen'guang'lan	0
地震过程	di'zhen'guo'cheng	0
地震海啸	di'zhen'hai'xiao	0
地震荷载	di'zhen'he'zai	0
地震横波	di'zhen'heng'bo	0
地震宏观调查	di'zhen'hong'guan'diao'cha	0
地震湖	di'zhen'hu	0
地震回放仪	di'zhen'hui'fang'yi	0
地震会商	di'zhen'hui'shang	0
地震活动带	di'zhen'huo'dong'dai	0
地震活动动态分析	di'zhen'huo'dong'dong'tai'fen'xi	0
地震活动度	di'zhen'huo'dong'du	0
地震活动断层	di'zhen'huo'dong'duan'ceng	0
地震活动平静期	di'zhen'huo'dong'ping'jing'qi	0
地震活动图	di'zhen'huo'dong'tu	0
地震活动性	di'zhen'huo'dong'xing	0
地震活动性区划	di'zhen'huo'dong'xing'qu'hua	0
地震活动异常	di'zhen'huo'dong'yi'chang	0
地震活跃期	di'zhen'huo'yue'qi	0
地震计	di'zhen'ji	0
地震基本烈度	di'zhen'ji'ben'lie'du	0
地震记录	di'zhen'ji'lu	0
地震机制	di'zhen'ji'zhi	0
地震加速度	di'zhen'jia'su'du	0
地震加速度图	di'zhen'jia'su'du'tu	0
地震检波器	di'zhen'jian'bo'qi	0
地震监测	di'zhen'jian'ce	0
地震监视系统	di'zhen'jian'shi'xi'tong	0
地震界面	di'zhen'jie'mian	0
地震解耦	di'zhen'jie'ou	0
地震静力学	di'zhen'jing'li'xue	0
地震矩	di'zhen'ju	0
地震矩张量	di'zhen'ju'zhang'liang	0
地震勘探	di'zhen'kan'tan	0
地震科学	di'zhen'ke'xue	0
地震空区	di'zhen'kong'qu	0
地震控制	di'zhen'kong'zhi	0
地震力	di'zhen'li	0
地震历时	di'zhen'li'shi	0
地震烈度	di'zhen'lie'du	0
地震烈度表	di'zhen'lie'du'biao	0
地震烈度评定	di'zhen'lie'du'ping'ding	0
地震烈度区划	di'zhen'lie'du'qu'hua	0
地震烈度小区划	di'zhen'lie'du'xiao'qu'hua	0
地震烈度异常	di'zhen'lie'du'yi'chang	0
地震流体地质学	di'zhen'liu'ti'di'zhi'xue	0
地震滤波	di'zhen'lv'bo	0
地震盲区	di'zhen'mang'qu	0
地震面波	di'zhen'mian'bo	0
地震模拟	di'zhen'mo'ni	0
地震能	di'zhen'neng	0
地震能级	di'zhen'neng'ji	0
地震耦合	di'zhen'ou'he	0
地震频度	di'zhen'pin'du	0
地震平静期	di'zhen'ping'jing'qi	0
地震平静区	di'zhen'ping'jing'qu	0
地震剖面	di'zhen'pou'mian	0
地震谱	di'zhen'pu	0
地震迁移	di'zhen'qian'yi	0
地震前兆	di'zhen'qian'zhao	0
地震前兆效应	di'zhen'qian'zhao'xiao'ying	0
地震强度	di'zhen'qiang'du	0
地震区	di'zhen'qu	0
地震区划	di'zhen'qu'hua	0
地震区划图	di'zhen'qu'hua'tu	0
地震趋势分析	di'zhen'qu'shi'fen'xi	0
地震全息照相	di'zhen'quan'xi'zhao'xiang	0
地震群	di'zhen'qun	0
地震扰动	di'zhen'rao'dong	0
地震散射	di'zhen'san'she	0
地震三要素	di'zhen'san'yao'su	0
地震社会学	di'zhen'she'hui'xue	0
地震设计烈度	di'zhen'she'ji'lie'du	0
地震射线	di'zhen'she'xian	0
地震射线理论	di'zhen'she'xian'li'lun	0
地震深度	di'zhen'shen'du	0
地震声学	di'zhen'sheng'xue	0
地震史	di'zhen'shi	0
地震事件	di'zhen'shi'jian	0
地震时空分布	di'zhen'shi'kong'fen'bu	0
地震首波	di'zhen'shou'bo	0
地震衰减	di'zhen'shuai'jian	0
地震水文地球化学	di'zhen'shui'wen'di'qiu'hua'xue	0
地震台	di'zhen'tai	0
地震台网	di'zhen'tai'wang	0
地震台阵	di'zhen'tai'zhen	0
地震弹性回跳理论	di'zhen'tan'xing'hui'tiao'li'lun	0
地震体波	di'zhen'ti'bo	0
地震天气	di'zhen'tian'qi	0
地震天文学	di'zhen'tian'wen'xue	0
地震条件	di'zhen'tiao'jian	0
地震统计学	di'zhen'tong'ji'xue	0
地震图	di'zhen'tu	0
地震图像	di'zhen'tu'xiang	0
地震图像识别	di'zhen'tu'xiang'shi'bie	0
地震尾波	di'zhen'wei'bo	0
地震位错	di'zhen'wei'cuo	0
地震位能	di'zhen'wei'neng	0
地震危险估计	di'zhen'wei'xian'gu'ji	0
地震危险评价	di'zhen'wei'xian'ping'jia	0
地震危险区	di'zhen'wei'xian'qu	0
地震危险区划	di'zhen'wei'xian'qu'hua	0
地震危险图	di'zhen'wei'xian'tu	0
地震危险性	di'zhen'wei'xian'xing	0
地震危险性分析	di'zhen'wei'xian'xing'fen'xi	0
地震危险性评定	di'zhen'wei'xian'xing'ping'ding	0
地震位置	di'zhen'wei'zhi	0
地震物理学	di'zhen'wu'li'xue	0
地震系列	di'zhen'xi'lie	0
地震系数	di'zhen'xi'shu	0
地震线	di'zhen'xian	0
地震现场科考	di'zhen'xian'chang'ke'kao	0
地震响应	di'zhen'xiang'ying	0
地震效率	di'zhen'xiao'lv	0
地震小区划	di'zhen'xiao'qu'hua	0
地震效应	di'zhen'xiao'ying	0
地震信号	di'zhen'xin'hao	0
地震行波	di'zhen'xing'bo	0
地震序列	di'zhen'xu'lie	0
地震序列类型	di'zhen'xu'lie'lei'xing	0
地震学	di'zhen'xue	0
地震遥测	di'zhen'yao'ce	0
地震遥感	di'zhen'yao'gan	0
地震仪	di'zhen'yi	0
地震仪标定	di'zhen'yi'biao'ding	0
地震仪参数	di'zhen'yi'can'shu	0
地震异常	di'zhen'yi'chang	0
地震易损性	di'zhen'yi'sun'xing	0
地震易损性分析	di'zhen'yi'sun'xing'fen'xi	0
地震应急	di'zhen'ying'ji	0
地震影区	di'zhen'ying'qu	0
地震影响场区划	di'zhen'ying'xiang'chang'qu'hua	0
地震有感范围	di'zhen'you'gan'fan'wei	0
地震预报	di'zhen'yu'bao	0
地震预报对策	di'zhen'yu'bao'dui'ce	0
地震预防	di'zhen'yu'fang	0
地震云	di'zhen'yun	0
地震灾害	di'zhen'zai'hai	0
地震噪声	di'zhen'zao'sheng	0
地震震动	di'zhen'zhen'dong	0
地震震级	di'zhen'zhen'ji	0
地震震相	di'zhen'zhen'xiang	0
地震震源	di'zhen'zhen'yuan	0
地震震中	di'zhen'zhen'zhong	0
地震震中分布图	di'zhen'zhen'zhong'fen'bu'tu	0
地震中期预报	di'zhen'zhong'qi'yu'bao	0
地震周期	di'zhen'zhou'qi	0
地震周期性	di'zhen'zhou'qi'xing	0
地震专用测量标志	di'zhen'zhuan'yong'ce'liang'biao'zhi	0
地震纵波	di'zhen'zong'bo	0
地震走时表	di'zhen'zou'shi'biao	0
地震走时曲线	di'zhen'zou'shi'qu'xian	0
地震作用	di'zhen'zuo'yong	0
电磁异常	dian'ci'yi'chang	0
典型大震震害	dian'xing'da'zhen'zhen'hai	0
东北深震带	dong'bei'shen'zhen'dai	0
抖动	dou'dong	0
断裂地震	duan'lie'di'zhen	0
短期预报	duan'qi'yu'bao	0
短周期	duan'zhou'qi	0
多震型序列	duo'zhen'xing'xu'lie	0
尔格	er'ge	0
反常变化	fan'chang'bian'hua	0
翻花冒泡	fan'hua'mao'pao	0
房屋加固	fang'wu'jia'gu	0
非洲板块	fei'zhou'ban'kuai	0
工程震害	gong'cheng'zhen'hai	0
供电设施	gong'dian'she'shi	0
公共场所避震	gong'gong'chang'suo'bi'zhen	0
供水设施	gong'shui'she'shi	0
工业爆破	gong'ye'bao'po	0
构造地震	gou'zao'di'zhen	0
构造地震的分类	gou'zao'di'zhen'de'fen'lei	0
构造物理实验	gou'zao'wu'li'shi'yan	0
构筑物	gou'zhu'wu	0
孤立型地震	gu'li'xing'di'zhen	0
孤立型序列	gu'li'xing'xu'lie	0
观测井	guan'ce'jing	0
观测数据	guan'ce'shu'ju	0
观测线路	guan'ce'xian'lu	0
海啸	hai'xiao	0
海原松潘雅安带	hai'yuan'song'pan'ya'an'dai	0
河北平原带	he'bei'ping'yuan'dai	0
河西走廊带	he'xi'zou'lang'dai	0
横波	heng'bo	0
宏观前兆	hong'guan'qian'zhao	0
宏观震中	hong'guan'zhen'zhong	0
户外避震	hu'wai'bi'zhen	0
滑坡	hua'po	0
花石峡带	hua'shi'xia'dai	0
环太平洋地震带	huan'tai'ping'yang'di'zhen'dai	0
火山爆发	huo'shan'bao'fa	0
火山地震	huo'shan'di'zhen	0
火山监测研究	huo'shan'jian'ce'yan'jiu	0
火灾	huo'zai	0
极震区	ji'zhen'qu	0
家庭避震	jia'ting'bi'zhen	0
监测环境	jian'ce'huan'jing	0
监测设施	jian'ce'she'shi	0
监测仪器设备	jian'ce'yi'qi'she'bei	0
间接伤害	jian'jie'shang'hai	0
建筑物	jian'zhu'wu	0
建筑物结构抗震实验	jian'zhu'wu'jie'gou'kang'zhen'shi'yan	0
近震	jin'zhen	0
井壁变形	jing'bi'bian'xing	0
经常性微动	jing'chang'xing'wei'dong	0
井房	jing'fang	0
经纬度	jing'wei'du	0
巨大地震	ju'da'di'zhen	0
抗御行动	kang'yu'xing'dong	0
抗震场地	kang'zhen'chang'di	0
抗震设计	kang'zhen'she'ji	0
抗震施工	kang'zhen'shi'gong	0
旷地带避震	kuang'di'dai'bi'zhen	0
矿震监测研究	kuang'zhen'jian'ce'yan'jiu	0
拉萨察隅带	la'sa'cha'yu'dai	0
兰州天水带	lan'zhou'tian'shui'dai	0
勒夫波	le'fu'bo	0
里氏地震规模	li'shi'di'zhen'gui'mo	0
里氏规模	li'shi'gui'mo	0
烈度	lie'du	0
临震预报	lin'zhen'yu'bao	0
炉霍乾宁带	lu'huo'qian'ning'dai	0
马边巧家通海带	ma'bian'qiao'jia'tong'hai'dai	0
脉动	mai'dong	0
美洲板块	mei'zhou'ban'kuai	0
面波	mian'bo	0
冕宁西昌鱼鮓带	mian'ning'xi'chang'yu'zha'dai	0
闽粤沿海带	min'yue'yan'hai'dai	0
南极洲板块	nan'ji'zhou'ban'kuai	0
能量冲击	neng'liang'chong'ji	0
能量单位	neng'liang'dan'wei	0
泥石流	ni'shi'liu	0
粘滑	nian'hua	0
粘滑地震	nian'hua'di'zhen	0
粘滞耦合地震计	nian'zhi'ou'he'di'zhen'ji	0
欧亚大陆内部	ou'ya'da'lu'nei'bu	0
欧亚地震带	ou'ya'di'zhen'dai	0
喷气发响	pen'qi'fa'xiang	0
破坏程度	po'huai'cheng'du	0
破坏特点	po'huai'te'dian	0
破坏现象	po'huai'xian'xiang	0
破坏性地震	po'huai'xing'di'zhen	0
浅源地震	qian'yuan'di'zhen	0
前震	qian'zhen	0
强震	qiang'zhen	0
强震动	qiang'zhen'dong	0
强震震级	qiang'zhen'zhen'ji	0
人工地震	ren'gong'di'zhen	0
日本关东地震	ri'ben'guan'dong'di'zhen	0
瑞利波	rui'li'bo	0
弱震	ruo'zhen	0
弱震震级	ruo'zhen'zhen'ji	0
三点法	san'dian'fa	0
三点校正法	san'dian'jiao'zheng'fa	0
三分量动圈式地震仪	san'fen'liang'dong'quan'shi'di'zhen'yi	0
三分量加速度仪	san'fen'liang'jia'su'du'yi	0
三分量强震仪	san'fen'liang'qiang'zhen'yi	0
三分向地震仪	san'fen'xiang'di'zhen'yi	0
三合地震台网	san'he'di'zhen'tai'wang	0
三角测量	san'jiao'ce'liang	0
三角洲	san'jiao'zhou	0
三维波速结构	san'wei'bo'su'jie'gou	0
三维地震模型	san'wei'di'zhen'mo'xing	0
三轴地震计	san'zhou'di'zhen'ji	0
山西带	shan'xi'dai	0
陕西渭河平原地震带	shan'xi'wei'he'ping'yuan'di'zhen'dai	0
上下颠簸振动	shang'xia'dian'bo'zhen'dong	0
深井注水	shen'jing'zhu'shui	0
深源地震	shen'yuan'di'zhen	0
生物异常	sheng'wu'yi'chang	0
世界地震分布	shi'jie'di'zhen'fen'bu	0
实验数据	shi'yan'shu'ju	0
双震型地震	shuang'zhen'xing'di'zhen	0
水点	shui'dian	0
水库地震监测研究	shui'ku'di'zhen'jian'ce'yan'jiu	0
水库蓄水	shui'ku'xu'shui	0
水量增加	shui'liang'zeng'jia	0
水位上升	shui'wei'shang'sheng	0
水灾	shui'zai	0
瞬时性	shun'shi'xing	0
太平洋板块	tai'ping'yang'ban'kuai	0
台湾带	tai'wan'dai	0
特大破坏性地震	te'da'po'huai'xing'di'zhen	0
腾冲澜沧带	teng'chong'lan'cang'dai	0
体波	ti'bo	0
天然地震	tian'ran'di'zhen	0
天山带	tian'shan'dai	0
通信设施	tong'xin'she'shi	0
微观前兆	wei'guan'qian'zhao	0
微观震	wei'guan'zhen	0
微观震中	wei'guan'zhen'zhong	0
渭河平原带	wei'he'ping'yuan'dai	0
瘟疫	wen'yi	0
西藏西部带	xi'zang'xi'bu'dai	0
陷落地震	xian'luo'di'zhen	0
新构造年代测试	xin'gou'zao'nian'dai'ce'shi	0
修订麦加利地震烈度表	xiu'ding'mai'jia'li'di'zhen'lie'du'biao	0
亚欧板块	ya'ou'ban'kuai	0
岩崩地震	yan'beng'di'zhen	0
岩层断裂	yan'ceng'duan'lie	0
岩层界面	yan'ceng'jie'mian	0
雁行式断裂	yan'hang'shi'duan'lie	0
岩浆冲击说	yan'jiang'chong'ji'shuo	0
岩浆库	yan'jiang'ku	0
岩浆水	yan'jiang'shui	0
岩浆岩	yan'jiang'yan	0
沿界面	yan'jie'mian	0
雁列构造	yan'lie'gou'zao	0
岩溶景观	yan'rong'jing'guan	0
岩溶水	yan'rong'shui	0
赝瑞利波	yan'rui'li'bo	0
燕山运动	yan'shan'yun'dong	0
岩石断裂力学	yan'shi'duan'lie'li'xue	0
岩石静压力	yan'shi'jing'ya'li	0
岩石力学	yan'shi'li'xue	0
岩石力学性质	yan'shi'li'xue'xing'zhi	0
岩石漆	yan'shi'qi	0
岩石圈	yan'shi'quan	0
岩石圈板块	yan'shi'quan'ban'kuai	0
岩石圈地震	yan'shi'quan'di'zhen	0
岩石圈断裂	yan'shi'quan'duan'lie	0
岩石水理性质	yan'shi'shui'li'xing'zhi	0
岩体静压力	yan'ti'jing'ya'li	0
岩体强度	yan'ti'qiang'du	0
验震器	yan'zhen'qi	0
赝重力	yan'zhong'li	0
严重破坏性地震	yan'zhong'po'huai'xing'di'zhen	0
仰冲板块	yang'chong'ban'kuai	0
阳离子交替吸附作用	yang'li'zi'jiao'ti'xi'fu'zuo'yong	0
杨氏模量	yang'shi'mo'liang	0
遥测地震台网	yao'ce'di'zhen'tai'wang	0
遥测地震仪	yao'ce'di'zhen'yi	0
遥测点用房	yao'ce'dian'yong'fang	0
遥感	yao'gan	0
遥感应用	yao'gan'ying'yong	0
液化	ye'hua	0
野外避震	ye'wai'bi'zhen	0
一般破坏性地震	yi'ban'po'huai'xing'di'zhen	0
夷平面	yi'ping'mian	0
仪器房	yi'qi'fang	0
仪器震中	yi'qi'zhen'zhong	0
易损性分析	yi'sun'xing'fen'xi	0
伊通火山群	yi'tong'huo'shan'qun	0
一致概率反应谱	yi'zhi'gai'lv'fan'ying'pu	0
银川带	yin'chuan'dai	0
印度板块	yin'du'ban'kuai	0
印度洋板块	yin'du'yang'ban'kuai	0
隐伏断层	yin'fu'duan'ceng	0
银河系	yin'he'xi	0
引力定律	yin'li'ding'lv	0
应变场	ying'bian'chang	0
应变地震图	ying'bian'di'zhen'tu	0
应变地震仪	ying'bian'di'zhen'yi	0
应变分布图	ying'bian'fen'bu'tu	0
应变积累	ying'bian'ji'lei	0
应变释放	ying'bian'shi'fang	0
应变图	ying'bian'tu	0
应变椭球	ying'bian'tuo'qiu	0
应变仪	ying'bian'yi	0
应变张量	ying'bian'zhang'liang	0
营口郯城庐江带	ying'kou'tan'cheng'lu'jiang'dai	0
应力场	ying'li'chang	0
应力积累	ying'li'ji'lei	0
应力集中	ying'li'ji'zhong	0
应力降	ying'li'jiang	0
应力释放	ying'li'shi'fang	0
应力松弛	ying'li'song'chi	0
应力椭圆	ying'li'tuo'yuan	0
应力状态	ying'li'zhuang'tai	0
应用地球物理学	ying'yong'di'qiu'wu'li'xue	0
应用地震学	ying'yong'di'zhen'xue	0
诱发地震	you'fa'di'zhen	0
有感地震	you'gan'di'zhen	0
阈限应力	yu'xian'ying'li	0
预应力	yu'ying'li	0
余震	yu'zhen	0
预震	yu'zhen	0
远场体波	yuan'chang'ti'bo	0
原始大气圈	yuan'shi'da'qi'quan	0
原始火球假说	yuan'shi'huo'qiu'jia'shuo	0
元素的地球化学分布	yuan'su'de'di'qiu'hua'xue'fen'bu	0
远震	yuan'zhen	0
远震台网	yuan'zhen'tai'wang	0
远震仪	yuan'zhen'yi	0
陨石坠落	yun'shi'zhui'luo	0
孕震构造	yun'zhen'gou'zao	0
孕震构造体系	yun'zhen'gou'zao'ti'xi	0
灾变说	zai'bian'shuo	0
灾害链	zai'hai'lian	0
灾害破坏	zai'hai'po'huai	0
灾害性地震	zai'hai'xing'di'zhen	0
灾后生活	zai'hou'sheng'huo	0
造陆运动	zao'lu'yun'dong	0
造山带	zao'shan'dai	0
造山幕	zao'shan'mu	0
造山运动	zao'shan'yun'dong	0
炸药爆破	zha'yao'bao'po	0
占星学	zhan'xing'xue	0
张德勒运动	zhang'de'le'yun'dong	0
张德勒周期	zhang'de'le'zhou'qi	0
张节理	zhang'jie'li	0
胀缩波	zhang'suo'bo	0
张性断裂	zhang'xing'duan'lie	0
张性结构面	zhang'xing'jie'gou'mian	0
折射波	zhe'she'bo	0
折射波地震勘探	zhe'she'bo'di'zhen'kan'tan	0
折射层	zhe'she'ceng	0
折射地震仪	zhe'she'di'zhen'yi	0
折射面	zhe'she'mian	0
折射剖面	zhe'she'pou'mian	0
褶皱带	zhe'zhou'dai	0
褶皱地震	zhe'zhou'di'zhen	0
褶皱幕	zhe'zhou'mu	0
褶皱运动	zhe'zhou'yun'dong	0
褶皱作用	zhe'zhou'zuo'yong	0
震波图	zhen'bo'tu	0
震磁效应	zhen'ci'xiao'ying	0
震电效应	zhen'dian'xiao'ying	0
震动	zhen'dong	0
振动方向	zhen'dong'fang'xiang	0
真方位角	zhen'fang'wei'jiao	0
震感区	zhen'gan'qu	0
震害	zhen'hai	0
震害重复性	zhen'hai'chong'fu'xing	0
震害调查	zhen'hai'diao'cha	0
震害统计	zhen'hai'tong'ji	0
震害预测	zhen'hai'yu'ce	0
震后效应	zhen'hou'xiao'ying	0
震级	zhen'ji	0
震级残差	zhen'ji'can'cha	0
震级档	zhen'ji'dang	0
震级上限	zhen'ji'shang'xian	0
震级时间曲线	zhen'ji'shi'jian'qu'xian	0
震级限值	zhen'ji'xian'zhi	0
震裂带	zhen'lie'dai	0
震前滑动	zhen'qian'hua'dong	0
震前平静	zhen'qian'ping'jing	0
震前形变	zhen'qian'xing'bian	0
震情	zhen'qing	0
震区	zhen'qu	0
震群	zhen'qun	0
震群型地震	zhen'qun'xing'di'zhen	0
震相	zhen'xiang	0
震相分析	zhen'xiang'fen'xi	0
震影	zhen'ying	0
震源	zhen'yuan	0
震源参数	zhen'yuan'can'shu	0
震源尺度	zhen'yuan'chi'du	0
震源道	zhen'yuan'dao	0
震源定位	zhen'yuan'ding'wei	0
震源动力学	zhen'yuan'dong'li'xue	0
震源几何学	zhen'yuan'ji'he'xue	0
震源机制	zhen'yuan'ji'zhi	0
震源距	zhen'yuan'ju	0
震源力	zhen'yuan'li	0
震源谱	zhen'yuan'pu	0
震源浅	zhen'yuan'qian	0
震源球	zhen'yuan'qiu	0
震源深度	zhen'yuan'shen'du	0
震源时间函数	zhen'yuan'shi'jian'han'shu	0
震源体积	zhen'yuan'ti'ji	0
震源孕育	zhen'yuan'yun'yu	0
震中	zhen'zhong	0
震中对点	zhen'zhong'dui'dian	0
震中加速度	zhen'zhong'jia'su'du	0
震中距	zhen'zhong'ju	0
震中烈度	zhen'zhong'lie'du	0
正常重力	zheng'chang'zhong'li	0
正常重力场	zheng'chang'zhong'li'chang	0
正断层	zheng'duan'ceng	0
整合	zheng'he	0
正应力	zheng'ying'li	0
直达波	zhi'da'bo	0
直接记录地震仪	zhi'jie'ji'lu'di'zhen'yi	0
直接伤害	zhi'jie'shang'hai	0
直接灾害破坏	zhi'jie'zai'hai'po'huai	0
质谱仪	zhi'pu'yi	0
直下型地震	zhi'xia'xing'di'zhen	0
质子磁力仪	zhi'zi'ci'li'yi	0
中长期预报	zhong'chang'qi'yu'bao	0
中等破坏性地震	zhong'deng'po'huai'xing'di'zhen	0
中国板块	zhong'guo'ban'kuai	0
中国大陆地壳应力环境数据	zhong'guo'da'lu'di'qiao'ying'li'huan'jing'shu'ju	0
中国第四纪冰川期	zhong'guo'di'si'ji'bing'chuan'qi	0
中国地震分布	zhong'guo'di'zhen'fen'bu	0
中国南北地震带	zhong'guo'nan'bei'di'zhen'dai	0
中国主要地震带	zhong'guo'zhu'yao'di'zhen'dai	0
中继站	zhong'ji'zhan	0
重力	zhong'li	0
重力波	zhong'li'bo	0
重力测量	zhong'li'ce'liang	0
重力场	zhong'li'chang	0
重力沉降	zhong'li'chen'jiang	0
重力低	zhong'li'di	0
重力高	zhong'li'gao	0
重力构造	zhong'li'gou'zao	0
重力观测	zhong'li'guan'ce	0
重力加速度	zhong'li'jia'su'du	0
重力校正	zhong'li'jiao'zheng	0
重力均衡校正	zhong'li'jun'heng'jiao'zheng	0
重力均衡异常	zhong'li'jun'heng'yi'chang	0
重力能	zhong'li'neng	0
重力势	zhong'li'shi	0
重力水	zhong'li'shui	0
重力梯度	zhong'li'ti'du	0
重力图	zhong'li'tu	0
重力仪	zhong'li'yi	0
重力异常	zhong'li'yi'chang	0
重力异常场	zhong'li'yi'chang'chang	0
重量分析	zhong'liang'fen'xi	0
中强震	zhong'qiang'zhen	0
中强震震级	zhong'qiang'zhen'zhen'ji	0
中心式喷发	zhong'xin'shi'pen'fa	0
中源地震	zhong'yuan'di'zhen	0
中周期地震仪	zhong'zhou'qi'di'zhen'yi	0
驻波	zhu'bo	0
主应力	zhu'ying'li	0
主震	zhu'zhen	0
主震型地震	zhu'zhen'xing'di'zhen	0
主震型序列	zhu'zhen'xing'xu'lie	0
主震震级	zhu'zhen'zhen'ji	0
转换波	zhuan'huan'bo	0
转换断层	zhuan'huan'duan'ceng	0
专用道路	zhuan'yong'dao'lu	0
专用堤坝	zhuan'yong'di'ba	0
卓越周期	zhuo'yue'zhou'qi	0
子波	zi'bo	0
自流水	zi'liu'shui	0
自然电位	zi'ran'dian'wei	0
自然电位法	zi'ran'dian'wei'fa	0
自然物	zi'ran'wu	0
自旋磁共振	zi'xuan'ci'gong'zhen	0
自由空间校正	zi'you'kong'jian'jiao'zheng	0
自由空间异常	zi'you'kong'jian'yi'chang	0
纵波	zong'bo	0
走时表	zou'shi'biao	0
走时差	zou'shi'cha	0
走向	zou'xiang	0
走向滑动断层	zou'xiang'hua'dong'duan'ceng	0
最大概率地震	zui'da'gai'lv'di'zhen	0
最大烈度	zui'da'lie'du	0
最大主应力	zui'da'zhu'ying'li	0
最可信地震	zui'ke'xin'di'zhen	0
