百年国恨	bai'nian'guo'hen	0
白起	bai'qi	0
败于懦弱知足者	bai'yu'nuo'ruo'zhi'zu'zhe	0
败于无知	bai'yu'wu'zhi	0
败在心之弱也	bai'zai'xin'zhi'ruo'ye	0
邦交邦交	bang'jiao'bang'jiao	0
悲痛於心	bei'tong'yu'xin	0
本公即位	ben'gong'ji'wei	0
奔忙一生	ben'mang'yi'sheng	0
本色不夺	ben'shai'bu'duo	0
必将为大争之世所遗弃	bi'jiang'wei'da'zheng'zhi'shi'suo'yi'qi	0
必朗照之	bi'lang'zhao'zhi	0
彼其之子	bi'qi'zhi'zi	0
碧水长天兮	bi'shui'chang'tian'xi	0
必以律法而后正	bi'yi'lv'fa'er'hou'zheng	0
必有隐情	bi'you'yin'qing	0
变法强秦	bian'fa'qiang'qin	0
便取兵道	bian'qu'bing'dao	0
便是惧怕有违民情	bian'shi'ju'pa'you'wei'min'qing	0
卞涛	bian'tao	0
便在于三国变法只走半途	bian'zai'yu'san'guo'bian'fa'zhi'zou'ban'tu	0
不摧不折	bu'cui'bu'zhe	0
不得其所	bu'de'qi'suo	0
不合民情么	bu'he'min'qing'me	0
不合铭心么	bu'he'ming'xin'me	0
不见江山	bu'jian'jiang'shan	0
不禁私相贺礼	bu'jin'si'xiang'he'li	0
不觉如梦	bu'jue'ru'meng	0
不可留余心	bu'ke'liu'yu'xin	0
不能者退	bu'neng'zhe'tui	0
不能折腰	bu'neng'zhe'yao	0
不强永远	bu'qiang'yong'yuan	0
不容些许负义之行	bu'rong'xie'xu'fu'yi'zhi'xing	0
不韦执拗于义本	bu'wei'zhi'niu'yu'yi'ben	0
不问因由	bu'wen'yin'you	0
不因其学满	bu'yin'qi'xue'man	0
不与会盟	bu'yu'hui'meng	0
不足道也	bu'zu'dao'ye	0
不足效法	bu'zu'xiao'fa	0
才乃苍生之幸	cai'nai'cang'sheng'zhi'xing	0
才有财货土地之争夺	cai'you'cai'huo'tu'di'zhi'zheng'duo	0
才有盗贼暴力与杀戮	cai'you'dao'zei'bao'li'yu'sha'lu	0
才有法度	cai'you'fa'du	0
才有声色犬马	cai'you'sheng'se'quan'ma	0
沧海难平	cang'hai'nan'ping	0
藏污纳垢	cang'wu'na'gou	0
曾不知	ceng'bu'zhi	0
差池其羽	cha'chi'qi'yu	0
察道者帝	cha'dao'zhe'di	0
柴蔚	chai'wei	0
长平	chang'ping	0
常思国耻	chang'si'guo'chi	0
朝野就会糜烂	chao'ye'jiu'hui'mi'lan	0
陈冰	chen'bing	0
陈昊	chen'hao	0
陈继铭	chen'ji'ming	0
陈良	chen'liang	0
陈思宇	chen'si'yu	0
陈晓	chen'xiao	0
成年男子无故嚎啕者	cheng'nian'nan'zi'wu'gu'hao'tao'zhe	0
耻笑在先	chi'xiao'zai'xian	0
重蹈昨日覆辙	chong'dao'zuo'ri'fu'zhe	0
楚国范式	chu'guo'fan'shi	0
楚考烈王	chu'kao'lie'wang	0
初衷无改	chu'zhong'wu'gai	0
创业三难	chuang'ye'san'nan	0
此乃纵容恶行	ci'nai'zong'rong'e'xing	0
此为棋道	ci'wei'qi'dao	0
此中虽有变法者	ci'zhong'sui'you'bian'fa'zhe	0
大爱乃爱天下	da'ai'nai'ai'tian'xia	0
大谬	da'miu	0
大秦之强	da'qin'zhi'qiang	0
大仁则必舍小义	da'ren'ze'bi'she'xiao'yi	0
大魏军法	da'wei'jun'fa	0
大业有望	da'ye'you'wang	0
大鱼吞舟	da'yu'tun'zhou	0
大争之世	da'zheng'zhi'shi	0
达子	da'zi	0
但必以取势为根本	dan'bi'yi'qu'shi'wei'gen'ben	0
但不要放肆	dan'bu'yao'fang'si	0
但有能出长策奇计	dan'you'neng'chu'chang'ce'qi'ji	0
但与人评	dan'yu'ren'ping	0
当初本宫侍奉我王时	dang'chu'ben'gong'shi'feng'wo'wang'shi	0
当此之时	dang'ci'zhi'shi	0
当今之世	dang'jin'zhi'shi	0
当王天下	dang'wang'tian'xia	0
当真如此滑稽	dang'zhen'ru'ci'hua'ji	0
德行乃为政之末	de'xing'nai'wei'zheng'zhi'mo	0
砥砺心志	di'li'xin'zhi	0
地小民少	di'xiao'min'shao	0
点点渔火不同眠	dian'dian'yu'huo'bu'tong'mian	0
断少数人财路	duan'shao'shu'ren'cai'lu	0
对手实力强大	dui'shou'shi'li'qiang'da	0
尔等只是沧海之一粟	er'deng'zhi'shi'cang'hai'zhi'yi'su	0
而己竟不知强人之所在	er'ji'jing'bu'zhi'qiang'ren'zhi'suo'zai	0
而今律法在前	er'jin'lv'fa'zai'qian	0
而目下之秦国	er'mu'xia'zhi'qin'guo	0
而使秦国恢复穆公霸业者	er'shi'qin'guo'hui'fu'mu'gong'ba'ye'zhe	0
而停之	er'ting'zhi	0
而眼下秦国	er'yan'xia'qin'guo	0
而在力行	er'zai'li'xing	0
而在推行中各有侧重	er'zai'tui'xing'zhong'ge'you'ce'zhong	0
而这三强	er'zhe'san'qiang	0
而终至拜将入相	er'zhong'zhi'bai'jiang'ru'xiang	0
法贵时效	fa'gui'shi'xiao	0
法家何派	fa'jia'he'pai	0
法家强国	fa'jia'qiang'guo	0
法家三派	fa'jia'san'pai	0
法家术治派	fa'jia'shu'zhi'pai	0
法立如山	fa'li'ru'shan	0
法令半新半旧	fa'ling'ban'xin'ban'jiu	0
法外无恩	fa'wai'wu'en	0
法治成家成派	fa'zhi'cheng'jia'cheng'pai	0
法治也好	fa'zhi'ye'hao	0
范雎	fan'ju	0
方得其所	fang'de'qi'suo	0
方为无价至宝	fang'wei'wu'jia'zhi'bao	0
放眼天下	fang'yan'tian'xia	0
粉身碎骨	fen'shen'sui'gu	0
否则便是空谈大道贻误天下	fou'ze'bian'shi'kong'tan'da'dao'yi'wu'tian'xia	0
伏草惟存	fu'cao'wei'cun	0
府库财货日见空空	fu'ku'cai'huo'ri'jian'kong'kong	0
府库充盈	fu'ku'chong'ying	0
府库空空	fu'ku'kong'kong	0
复我河山	fu'wo'he'shan	0
付之一笑也是天下	fu'zhi'yi'xiao'ye'shi'tian'xia	0
夫子大谬	fu'zi'da'miu	0
夫子断章取义	fu'zi'duan'zhang'qu'yi	0
夫子立论无据	fu'zi'li'lun'wu'ju	0
夫子论学先定罪	fu'zi'lun'xue'xian'ding'zui	0
夫子无视法家根本	fu'zi'wu'shi'fa'jia'gen'ben	0
夫子有意抹煞根本	fu'zi'you'yi'mo'sha'gen'ben	0
甘茂	gan'mao	0
高英	gao'ying	0
更乏其心	geng'fa'qi'xin	0
更有苦	geng'you'ku	0
共赴国难	gong'fu'guo'nan	0
攻其一点不及其余	gong'qi'yi'dian'bu'ji'qi'yu	0
公如青山	gong'ru'qing'shan	0
工田不振	gong'tian'bu'zhen	0
共享秦国	gong'xiang'qin'guo	0
公之雄心图霸小矣	gong'zhi'xiong'xin'tu'ba'xiao'yi	0
狗盗	gou'dao	0
孤舟一叶兮	gu'zhou'yi'ye'xi	0
故自安者	gu'zi'an'zhe	0
官被君围	guan'bei'jun'wei	0
关山四固	guan'shan'si'gu	0
关中土地平坦	guan'zhong'tu'di'ping'tan	0
国被天下围	guo'bei'tian'xia'wei	0
国耻族恨	guo'chi'zu'hen	0
国家之幸	guo'jia'zhi'xing	0
国库空空	guo'ku'kong'kong	0
国弱民穷	guo'ruo'min'qiong	0
国势有成	guo'shi'you'cheng	0
函关易手	han'guan'yi'shou	0
韩聂	han'nie	0
韩徐为	han'xu'wei	0
好生吃喝	hao'sheng'chi'he	0
何曾意气	he'ceng'yi'qi	0
何得康宁	he'de'kang'ning	0
何得康甯	he'de'kang'ning	0
何乐而不为	he'le'er'bu'wei	0
何其浅薄哉	he'qi'qian'bo'zai	0
何树标	he'shu'biao	0
何谓综合国力	he'wei'zong'he'guo'li	0
河西尽失	he'xi'jin'shi	0
何以秦据渭水数百年	he'yi'qin'ju'wei'shui'shu'bai'nian	0
何以在秦数百年	he'yi'zai'qin'shu'bai'nian	0
合纵锁函谷	he'zong'suo'han'gu	0
何足论之	he'zu'lun'zhi	0
横强扫六合	heng'qiang'sao'lu'he	0
横扫六合	heng'sao'lu'he	0
胡佳旭	hu'jia'xu	0
胡伤	hu'shang	0
护卫皆斩	hu'wei'jie'zhan	0
化腐为金	hua'fu'wei'jin	0
华阳	hua'yang	0
化做了淡梦寒烟	hua'zuo'le'dan'meng'han'yan	0
黄歇	huang'xie	0
回到夏商周三代	hui'dao'xia'shang'zhou'san'dai	0
贿赂就会风行	hui'lu'jiu'hui'feng'xing	0
霍青	huo'qing	0
鸡鸣	ji'ming	0
济万物	ji'wan'wu	0
稷下学宫言无不尽	ji'xia'xue'gong'yan'wu'bu'jin	0
纪永清	ji'yong'qing	0
季子	ji'zi	0
甲兵老旧	jia'bing'lao'jiu	0
甲兵强盛	jia'bing'qiang'sheng	0
家远人单	jia'yuan'ren'dan	0
见识太浅	jian'shi'tai'qian	0
减刑溃法	jian'xing'kui'fa	0
将乱世罪孽归于法墨兵三家	jiang'luan'shi'zui'nie'gui'yu'fa'mo'bing'san'jia	0
将治世之功归于人性之善	jiang'zhi'shi'zhi'gong'gui'yu'ren'xing'zhi'shan	0
焦俊翔	jiao'jun'xiang	0
焦阳	jiao'yang	0
皆非根本之强	jie'fei'gen'ben'zhi'qiang	0
皆环环相围而生	jie'huan'huan'xiang'wei'er'sheng	0
竭尽其力	jie'jin'qi'li	0
皆以认同法治为根本	jie'yi'ren'tong'fa'zhi'wei'gen'ben	0
进而骄其学	jin'er'jiao'qi'xue	0
禁劳民伤财之风	jin'lao'min'shang'cai'zhi'feng	0
金钱乃人世流火	jin'qian'nai'ren'shi'liu'huo	0
靳尚	jin'shang	0
金盛宇	jin'sheng'yu	0
敬那大争之世	jing'na'da'zheng'zhi'shi	0
敬那小酌之时	jing'na'xiao'zhuo'zhi'shi	0
敬犀首	jing'xi'shou	0
敬张子	jing'zhang'zi	0
敬这大争之世	jing'zhe'da'zheng'zhi'shi	0
敬这小酌之时	jing'zhe'xiao'zhuo'zhi'shi	0
纠纠不倒	jiu'jiu'bu'dao	0
纠纠老秦	jiu'jiu'lao'qin	0
赳赳老秦	jiu'jiu'lao'qin	0
就是动刀子前的动作	jiu'shi'dong'dao'zi'qian'de'dong'zuo	0
就是为杜绝此等腐败风习	jiu'shi'wei'du'jue'ci'deng'fu'bai'feng'xi	0
就要走根本强大之路	jiu'yao'zou'gen'ben'qiang'da'zhi'lu	0
就在于没有综合混一的强大国力	jiu'zai'yu'mei'you'zong'he'hun'yi'de'qiang'da'guo'li	0
飓风过岗	ju'feng'guo'gang	0
居高官	ju'gao'guan	0
据山川形胜而沦丧	ju'shan'chuan'xing'sheng'er'lun'sang	0
决不负君	jue'bu'fu'jun	0
绝不为自己安身立命谋职谋路	jue'bu'wei'zi'ji'an'shen'li'ming'mou'zhi'mou'lu	0
崛起	jue'qi	0
君被国围	jun'bei'guo'wei	0
君不识我	jun'bu'shi'wo	0
君命如此	jun'ming'ru'ci	0
君上洞若观火	jun'shang'dong'ruo'guan'huo	0
君上有何评判	jun'shang'you'he'ping'pan	0
君为青山	jun'wei'qing'shan	0
君之热血	jun'zhi're'xue	0
堪称强国	kan'cheng'qiang'guo	0
可望有成也	ke'wang'you'cheng'ye	0
可为何秦国却没有一支攻必克	ke'wei'he'qin'guo'que'mei'you'yi'zhi'gong'bi'ke	0
可为何秦据渭水数百年	ke'wei'he'qin'ju'wei'shui'shu'bai'nian	0
可谓天赐佳水	ke'wei'tian'ci'jia'shui	0
可要改弦易辙	ke'yao'gai'xian'yi'zhe	0
苛政猛于虎而已	ke'zheng'meng'yu'hu'er'yi	0
孔孟毕生求之	kong'meng'bi'sheng'qiu'zhi	0
孔孟为天下求一仁	kong'meng'wei'tian'xia'qiu'yi'ren	0
苦茶一盏	ku'cha'yi'zhan	0
困辱尽尝	kun'ru'jin'chang	0
老楚王	lao'chu'wang	0
老夫未尝闻也	lao'fu'wei'chang'wen'ye	0
老夫愿闻足下性恶之说	lao'fu'yuan'wen'zu'xia'xing'e'zhi'shuo	0
老龙贾不禁一个激灵	lao'long'jia'bu'jin'yi'ge'ji'ling	0
老秦人朴实厚重	lao'qin'ren'pu'shi'hou'zhong	0
李冰	li'bing	0
李兑	li'dui	0
李二郎	li'er'lang	0
李槐龙	li'huai'long	0
历来不以德行操守论人	li'lai'bu'yi'de'xing'cao'shou'lun'ren	0
立论当有理有据	li'lun'dang'you'li'you'ju	0
李明晨	li'ming'chen	0
立清正廉洁之俗	li'qing'zheng'lian'jie'zhi'su	0
李元	li'yuan	0
连年苦战	lian'nian'ku'zhan	0
廉颇	lian'po	0
两行老泪夺眶而出	liang'hang'lao'lei'duo'kuang'er'chu	0
良禽固然择木	liang'qin'gu'ran'ze'mu	0
廖伟	liao'wei	0
列国卑秦	lie'guo'bei'qin	0
列国伐交频频	lie'guo'fa'jiao'pin'pin	0
辚辚远去	lin'lin'yuan'qu	0
蔺相如	lin'xiang'ru	0
林秀强	lin'xiu'qiang	0
领国政	ling'guo'zheng	0
六国各异	liu'guo'ge'yi	0
六国旧制不可救	liu'guo'jiu'zhi'bu'ke'jiu	0
刘辉	liu'hui	0
刘军	liu'jun	0
刘乃艺	liu'nai'yi	0
流水已逝	liu'shui'yi'shi	0
楼缓	lou'huan	0
鲁佳	lu'jia	0
碌碌无为	lu'lu'wu'wei	0
沦为鱼肉	lun'wei'yu'rou	0
罗天佑	luo'tian'you	0
吕文军	lv'wen'jun	0
马赛	ma'sai	0
马小宁	ma'xiao'ning	0
茫茫中国代有人才	mang'mang'zhong'guo'dai'you'ren'cai	0
毛遂	mao'sui	0
美如玉	mei'ru'yu	0
每一户人家的窗台	mei'yi'hu'ren'jia'de'chuang'tai	0
没有多少年了	mei'you'duo'shao'nian'le	0
蒙骜	meng'ao	0
蒙蔽幼稚	meng'bi'you'zhi	0
孟夫子空言性本善	meng'fu'zi'kong'yan'xing'ben'shan	0
孟夫子如此断言	meng'fu'zi'ru'ci'duan'yan	0
芈横	mi'heng	0
芈老宦	mi'lao'huan	0
芈戎	mi'rong	0
芈琰	mi'yan	0
芈原	mi'yuan	0
庙堂如此	miao'tang'ru'ci	0
民被官围	min'bei'guan'wei	0
民心安稳	min'xin'an'wen	0
民勇公战	min'yong'gong'zhan	0
民众会不满	min'zhong'hui'bu'man	0
明君吏治之强	ming'jun'li'zhi'zhi'qiang	0
名士暮年	ming'shi'mu'nian	0
名士无冠	ming'shi'wu'guan	0
名为法制	ming'wei'fa'zhi	0
明一者皇	ming'yi'zhe'huang	0
明月作证	ming'yue'zuo'zheng	0
莫大于此	mo'da'yu'ci	0
莫说为时太晚	mo'shuo'wei'shi'tai'wan	0
谋得兵胜者霸	mou'de'bing'sheng'zhe'ba	0
乃参透天地人者	nai'can'tou'tian'di'ren'zhe	0
乃法家精义之学	nai'fa'jia'jing'yi'zhi'xue	0
内乱频出	nei'luan'pin'chu	0
能者上	neng'zhe'shang	0
你们可以放牧	ni'men'ke'yi'fang'mu	0
你是何人	ni'shi'he'ren	0
年年辛苦	nian'nian'xin'ku	0
宁静	ning'jing	0
宁可不愿生在王族	ning'ke'bu'yuan'sheng'zai'wang'zu	0
宁露	ning'lu	0
农工兴旺	nong'gong'xing'wang	0
努而习之	nu'er'xi'zhi	0
彭波	peng'bo	0
彭国斌	peng'guo'bin	0
彭建明	peng'jian'ming	0
凭据有三	ping'ju'you'san	0
棋道	qi'dao	0
起伏震荡不定	qi'fu'zhen'dang'bu'ding	0
其根同一	qi'gen'tong'yi	0
齐国范式	qi'guo'fan'shi	0
其后诸君不贤	qi'hou'zhu'jun'bu'xian	0
其理同一	qi'li'tong'yi	0
其论断之轻率无以复加	qi'lun'duan'zhi'qing'shuai'wu'yi'fu'jia	0
其实又有何喜何恼	qi'shi'you'you'he'xi'he'nao	0
齐涛	qi'tao	0
泣涕如雨	qi'ti'ru'yu	0
齐王	qi'wang	0
其心也蠢	qi'xin'ye'chun	0
棋以围命名	qi'yi'wei'ming'ming	0
千秋功罪	qian'qiu'gong'zui	0
强不能守定心志	qiang'bu'neng'shou'ding'xin'zhi	0
强国范式不同	qiang'guo'fan'shi'bu'tong	0
强国何须借代而生	qiang'guo'he'xu'jie'dai'er'sheng	0
强国之道	qiang'guo'zhi'dao	0
强化查勘官吏	qiang'hua'cha'kan'guan'li	0
强力乃国家之本	qiang'li'nai'guo'jia'zhi'ben	0
强则强	qiang'ze'qiang	0
切莫悲悯自己	qie'mo'bei'min'zi'ji	0
且欲分秦灭秦而后快	qie'yu'fen'qin'mie'qin'er'hou'kuai	0
秦国要崛起	qin'guo'yao'jue'qi	0
秦能敌否	qin'neng'di'fou	0
秦人穷困	qin'ren'qiong'kun	0
秦人硬骨	qin'ren'ying'gu	0
秦始由大国而僻处一隅	qin'shi'you'da'guo'er'pi'chu'yi'yu	0
秦宣太后	qin'xuan'tai'hou	0
秦有锐士	qin'you'rui'shi	0
秦昭襄王	qin'zhao'xiang'wang	0
青山如黛兮	qing'shan'ru'dai'xi	0
青史只论成败	qing'shi'zhi'lun'cheng'bai	0
邱东江	qiu'dong'jiang	0
秋风掠过原野	qiu'feng'lve'guo'yuan'ye	0
渠梁愿闻强国之道	qu'liang'yuan'wen'qiang'guo'zhi'dao	0
渠梁愿闻先生新论	qu'liang'yuan'wen'xian'sheng'xin'lun	0
屈原	qu'yuan	0
权力功业如战场	quan'li'gong'ye'ru'zhan'chang	0
却按兵不动	que'an'bing'bu'dong	0
却荒芜薄收	que'huang'wu'bo'shou	0
却磨其心	que'mo'qi'xin	0
却坐失鱼盐航运之利	que'zuo'shi'yu'yan'hang'yun'zhi'li	0
然而如何啊	ran'er'ru'he'a	0
然非正道	ran'fei'zheng'dao	0
然无奈悲苦之一生	ran'wu'nai'bei'ku'zhi'yi'sheng	0
然有自安者	ran'you'zi'an'zhe	0
然则美梦成真	ran'ze'mei'meng'cheng'zhen	0
仁不能取予自如	ren'bu'neng'qu'yu'zi'ru	0
人口众多	ren'kou'zhong'duo	0
人情冷暖	ren'qing'leng'nuan	0
人人可论	ren'ren'ke'lun	0
人世无常	ren'shi'wu'chang	0
人性本恶	ren'xing'ben'e	0
人性本善	ren'xing'ben'shan	0
人性才能向善有序	ren'xing'cai'neng'xiang'shan'you'xu	0
人性之恶	ren'xing'zhi'e	0
人烟稀少	ren'yan'xi'shao	0
仁政井田不可复	ren'zheng'jing'tian'bu'ke'fu	0
人治也好	ren'zhi'ye'hao	0
人治与复古之论	ren'zhi'yu'fu'gu'zhi'lun	0
仍需努力	reng'xu'nu'li	0
如此邦国	ru'ci'bang'guo	0
如何能以今日之志	ru'he'neng'yi'jin'ri'zhi'zhi	0
如何如何	ru'he'ru'he	0
如日方升	ru'ri'fang'sheng	0
如日方生	ru'ri'fang'sheng	0
如若比肩	ru'ruo'bi'jian	0
如若大秦	ru'ruo'da'qin	0
如因不堪受其磨而弃之	ru'yin'bu'kan'shou'qi'mo'er'qi'zhi	0
如与他人比肩	ru'yu'ta'ren'bi'jian	0
若能遇见斗沙片刻之美好	ruo'neng'yu'jian'dou'sha'pian'ke'zhi'mei'hao	0
若嬴稷可以选	ruo'ying'ji'ke'yi'xuan	0
若赢稷可以选	ruo'ying'ji'ke'yi'xuan	0
弱则亡	ruo'ze'wang	0
三道玄谈	san'dao'xuan'tan	0
三关能过	san'guan'neng'guo	0
三横乃天地人	san'heng'nai'tian'di'ren	0
三横一竖	san'heng'yi'shu	0
山河广袤之强	shan'he'guang'mao'zhi'qiang	0
上古造字	shang'gu'zao'zi	0
商人无恩	shang'ren'wu'en	0
尚武之风深植朝野	shang'wu'zhi'feng'shen'zhi'chao'ye	0
少年寒窗苦读	shao'nian'han'chuang'ku'du	0
少年时总是在意别人	shao'nian'shi'zong'shi'zai'yi'bie'ren	0
少之其实	shao'zhi'qi'shi	0
社稷昌盛	she'ji'chang'sheng	0
谁与争雄	shei'yu'zheng'xiong	0
沈保平	shen'bao'ping	0
神大于形者智	shen'da'yu'xing'zhe'zhi	0
身后之名	shen'hou'zhi'ming	0
沈佳妮	shen'jia'ni	0
甚者辱	shen'zhe'ru	0
生不带来	sheng'bu'dai'lai	0
省多数人钱财	sheng'duo'shu'ren'qian'cai	0
生而贪欲	sheng'er'tan'yu	0
生而有奢望	sheng'er'you'she'wang	0
生恒爱之	sheng'heng'ai'zhi	0
生恒敬之	sheng'heng'jing'zhi	0
生死相扶	sheng'si'xiang'fu	0
势卑则围小	shi'bei'ze'wei'xiao	0
势高则围广	shi'gao'ze'wei'guang	0
世间事	shi'jian'shi	0
世间万物	shi'jian'wan'wu	0
视人不如己	shi'ren'bu'ru'ji	0
事虽相异	shi'sui'xiang'yi	0
实为人治	shi'wei'ren'zhi	0
是为王	shi'wei'wang	0
是谓王	shi'wei'wang	0
视学为无物	shi'xue'wei'wu'wu	0
是在行法根基之上着重整肃吏治	shi'zai'hang'fa'gen'ji'zhi'shang'zhuo'zhong'zheng'su'li'zhi	0
十指相扣便是良辰	shi'zhi'xiang'kou'bian'shi'liang'chen	0
守富饶土地而贫穷	shou'fu'rao'tu'di'er'pin'qiong	0
殊异乎公族	shu'yi'hu'gong'zu	0
谁便是正道	shui'bian'shi'zheng'dao	0
谁能融入大争潮流而强国富民	shui'neng'rong'ru'da'zheng'chao'liu'er'qiang'guo'fu'min	0
说的话是假的	shuo'de'hua'shi'jia'de	0
死不带去	si'bu'dai'qu	0
死不休战	si'bu'xiu'zhan	0
私斗成风	si'dou'cheng'feng	0
司马错	si'ma'cuo	0
四世政昏	si'shi'zheng'hun	0
送官府	song'guan'fu	0
宋重东	song'zhong'dong	0
苏秦	su'qin	0
苏秦全力救之	su'qin'quan'li'jiu'zhi	0
苏秦为天下求一公	su'qin'wei'tian'xia'qiu'yi'gong	0
苏一	su'yi	0
虽华而绚丽	sui'hua'er'xuan'li	0
隋眳杨	sui'ming'yang	0
虽能乐己	sui'neng'le'ji	0
虽以围地为归宿	sui'yi'wei'di'wei'gui'su	0
虽有败	sui'you'bai	0
虽有成败	sui'you'cheng'bai	0
虽有天命	sui'you'tian'ming	0
虽欲学吾术	sui'yu'xue'wu'shu	0
孙翰文	sun'han'wen	0
孙皓辉	sun'hao'hui	0
孙强	sun'qiang	0
所谓王者	suo'wei'wang'zhe	0
唐八子	tang'ba'zi	0
桃李满天下	tao'li'man'tian'xia	0
天地间真英雄也	tian'di'jian'zhen'ying'xiong'ye	0
田凯	tian'kai	0
天命星象从不垂怜弱者	tian'ming'xing'xiang'cong'bu'chui'lian'ruo'zhe	0
田文	tian'wen	0
天下被宇宙围	tian'xia'bei'yu'zhou'wei	0
天下纷扰	tian'xia'fen'rao	0
天下人生而好利	tian'xia'ren'sheng'er'hao'li	0
天下士子听了	tian'xia'shi'zi'ting'le	0
天下学派皆有分支	tian'xia'xue'pai'jie'you'fen'zhi	0
天下治道不在空谈	tian'xia'zhi'dao'bu'zai'kong'tan	0
铁马冰河	tie'ma'bing'he	0
通德者王	tong'de'zhe'wang	0
痛而持之	tong'er'chi'zhi	0
铜臭如粪土	tong'xiu'ru'fen'tu	0
外患交迫	wai'huan'jiao'po	0
王道不行	wang'dao'bu'xing	0
王海平	wang'hai'ping	0
王龁	wang'he	0
王侯将相	wang'hou'jiang'xiang	0
王绘春	wang'hui'chun	0
王稽	wang'ji	0
王上可曾见过世间至善至美	wang'shang'ke'ceng'jian'guo'shi'jian'zhi'shan'zhi'mei	0
王上可曾有心头至爱	wang'shang'ke'ceng'you'xin'tou'zhi'ai	0
王双宝	wang'shuang'bao	0
妄图安之	wang'tu'an'zhi	0
忘我实多	wang'wo'shi'duo	0
王小毅	wang'xiao'yi	0
亡羊补牢未曾可知	wang'yang'bu'lao'wei'ceng'ke'zhi	0
王者之仁义	wang'zhe'zhi'ren'yi	0
王者尊之	wang'zhe'zun'zhi	0
王梓桐	wang'zi'tong	0
王族的血是冷的	wang'zu'de'xue'shi'leng'de	0
魏丑夫	wei'chou'fu	0
唯法适从	wei'fa'shi'cong	0
魏国范式甲兵财货之强	wei'guo'fan'shi'jia'bing'cai'huo'zhi'qiang	0
魏华	wei'hua	0
未见君子	wei'jian'jun'zi	0
唯借不赐	wei'jie'bu'ci	0
魏伶优	wei'ling'you	0
魏齐楚三强范式	wei'qi'chu'san'qiang'fan'shi	0
魏冉	wei'ran	0
为商之道	wei'shang'zhi'dao	0
渭水汤汤	wei'shui'shang'shang	0
渭水滔滔	wei'shui'tao'tao	0
为天下立制	wei'tian'xia'li'zhi	0
为天下列强所无	wei'tian'xia'lie'qiang'suo'wu	0
为万民立法	wei'wan'min'li'fa	0
卫先生	wei'xian'sheng	0
唯学为正道	wei'xue'wei'zheng'dao	0
为学之本却在于此	wei'xue'zhi'ben'que'zai'yu'ci	0
卫鞅孟子论战	wei'yang'meng'zi'lun'zhan	0
卫鞅唯告夫子	wei'yang'wei'gao'fu'zi	0
卫鞅之志	wei'yang'zhi'zhi	0
唯以实力见长	wei'yi'shi'li'jian'zhang	0
魏优旃	wei'you'zhan	0
我不识君	wo'bu'shi'jun	0
我大秦的明月	wo'da'qin'de'ming'yue	0
我大秦的明月必朗照之	wo'da'qin'de'ming'yue'bi'lang'zhao'zhi	0
我等却要下不为例	wo'deng'que'yao'xia'bu'wei'li	0
我法家法治派名士	wo'fa'jia'fa'zhi'pai'ming'shi	0
我如松柏	wo'ru'song'bai	0
我为松柏	wo'wei'song'bai	0
我心何缺	wo'xin'he'que	0
我心伤悲	wo'xin'shang'bei	0
沃野千里	wo'ye'qian'li	0
武安君	wu'an'jun	0
五百年一卷雄文	wu'bai'nian'yi'juan'xiong'wen	0
吾辈为学	wu'bei'wei'xue	0
无法长期聚集国力而稳定强大	wu'fa'chang'qi'ju'ji'guo'li'er'wen'ding'qiang'da	0
无非是要重申仁政	wu'fei'shi'yao'chong'shen'ren'zheng	0
吴连生	wu'lian'sheng	0
无纳可贡	wu'na'ke'gong	0
务求国家实力增长	wu'qiu'guo'jia'shi'li'zeng'zhang	0
务求激励朝野士气	wu'qiu'ji'li'chao'ye'shi'qi	0
侮辱之语睚眦必报	wu'ru'zhi'yu'ya'zi'bi'bao	0
五无其一	wu'wu'qi'yi	0
物有所用	wu'you'suo'yong	0
武雨泽	wu'yu'ze	0
无足道也	wu'zu'dao'ye	0
细细品味	xi'xi'pin'wei	0
西有大秦	xi'you'da'qin	0
夏侯镔	xia'hou'bin	0
献公即位欲图振兴	xian'gong'ji'wei'yu'tu'zhen'xing	0
先生终显大才本色啊	xian'sheng'zhong'xian'da'cai'ben'shai'a	0
小魏伶优	xiao'wei'ling'you	0
斜阳浊酒	xie'yang'zhuo'jiu	0
心境非昨	xin'jing'fei'zuo	0
信君如信我	xin'jun'ru'xin'wo	0
形大于神者迂	xing'da'yu'shen'zhe'yu	0
邢佳栋	xing'jia'dong	0
徐东生	xu'dong'sheng	0
许敏	xu'min	0
宣太后	xuan'tai'hou	0
悬崖不勒马的是王	xuan'ya'bu'le'ma'de'shi'wang	0
雪白的长须拂过脸颊	xue'bai'de'chang'xu'fu'guo'lian'jia	0
血不流干	xue'bu'liu'gan	0
薛继军	xue'ji'jun	0
雪原营涛	xue'yuan'ying'tao	0
雅言纯正	ya'yan'chun'zheng	0
眼高手低	yan'gao'shou'di	0
燕燕于飞	yan'yan'yu'fei	0
言之辱也	yan'zhi'ru'ye	0
杨志刚	yang'zhi'gang	0
要放眼于天下	yao'fang'yan'yu'tian'xia	0
要谨防对手策动内乱	yao'jin'fang'dui'shou'ce'dong'nei'luan	0
也需持节自立	ye'xu'chi'jie'zi'li	0
叶阳	ye'yang	0
也足矣	ye'zu'yi	0
以此心入仕途	yi'ci'xin'ru'shi'tu	0
以法治防范恶意	yi'fa'zhi'fang'fan'e'yi	0
以法治疏导人性	yi'fa'zhi'shu'dao'ren'xing	0
一国对六国	yi'guo'dui'liu'guo	0
以乐其好而逐其他	yi'le'qi'hao'er'zhu'qi'ta	0
一谋之功	yi'mou'zhi'gong	0
一谋之过	yi'mou'zhi'guo	0
义渠骇	yi'qu'hai	0
伊阙	yi'que	0
亦是天道人道	yi'shi'tian'dao'ren'dao	0
一竖	yi'shu	0
一竖乃参通天地人者	yi'shu'nai'can'tong'tian'di'ren'zhe	0
以术治派为法家全貌	yi'shu'zhi'pai'wei'fa'jia'quan'mao	0
以为世人鉴戒	yi'wei'shi'ren'jian'jie	0
一样孤零	yi'yang'gu'ling	0
以义行之	yi'yi'xing'zhi	0
饮恨身亡	yin'hen'shen'wang	0
尹静	yin'jing	0
因人性有恶	yin'ren'xing'you'e	0
阴阳谶诲不足以断大事	yin'yang'chen'hui'bu'zu'yi'duan'da'shi	0
殷殷荐我	yin'yin'jian'wo	0
殷殷惊我	yin'yin'jing'wo	0
郢都	ying'dou	0
嬴芾	ying'fu	0
嬴疾	ying'ji	0
嬴稷	ying'ji	0
嬴摎	ying'jiao	0
嬴悝	ying'kui	0
应强	ying'qiang	0
赢渠梁对天明誓	ying'qu'liang'dui'tian'ming'shi	0
嬴渠梁明告天下	ying'qu'liang'ming'gao'tian'xia	0
嬴壮	ying'zhuang	0
嬴倬	ying'zhuo	0
永不相负	yong'bu'xiang'fu	0
勇不足以临机决断	yong'bu'zu'yi'lin'ji'jue'duan	0
用得其所	yong'de'qi'suo	0
拥强悍之民而兵弱	yong'qiang'han'zhi'min'er'bing'ruo	0
庸者下	yong'zhe'xia	0
有此五者	you'ci'wu'zhe	0
有酒便好	you'jiu'bian'hao	0
由人而神	you'ren'er'shen	0
由神而鬼	you'shen'er'gui	0
忧心如醉	you'xin'ru'zui	0
悠悠可期	you'you'ke'qi	0
悠悠难归	you'you'nan'gui	0
幽幽吴钩共秦剑	you'you'wu'gou'gong'qin'jian	0
与搬弄权谋有天壤之别	yu'ban'nong'quan'mou'you'tian'rang'zhi'bie	0
与本公共治秦国	yu'ben'gong'gong'zhi'qin'guo	0
遇常君则弱	yu'chang'jun'ze'ruo	0
雨打风吹	yu'da'feng'chui	0
于公器之道实为偏执	yu'gong'qi'zhi'dao'shi'wei'pian'zhi	0
于后世千秋万代	yu'hou'shi'qian'qiu'wan'dai	0
遇昏君则亡	yu'hun'jun'ze'wang	0
遇明君则强	yu'ming'jun'ze'qiang	0
与前述三道天壤之别	yu'qian'shu'san'dao'tian'rang'zhi'bie	0
虞卿	yu'qing	0
与逝者的哀伤澎湃也绝非一物	yu'shi'zhe'de'ai'shang'peng'pai'ye'jue'fei'yi'wu	0
玉王同字	yu'wang'tong'zi	0
预先立法	yu'xian'li'fa	0
宇宙被造物围	yu'zhou'bei'zao'wu'wei	0
玉字	yu'zi	0
玉字三横一竖	yu'zi'san'heng'yi'shu	0
远送于野	yuan'song'yu'ye	0
愿闻卫鞅之论	yuan'wen'wei'yang'zhi'lun	0
原雨	yuan'yu	0
愿与秦军对等骑兵结阵冲杀	yuan'yu'qin'jun'dui'deng'qi'bing'jie'zhen'chong'sha	0
再会便好	zai'hui'bian'hao	0
在秦无险	zai'qin'wu'xian	0
赞赏之言喜不自禁	zan'shang'zhi'yan'xi'bu'zi'jin	0
造物最终又被芸芸众生围	zao'wu'zui'zhong'you'bei'yun'yun'zhong'sheng'wei	0
则公器化为私道	ze'gong'qi'hua'wei'si'dao	0
战必胜的强大新军	zhan'bi'sheng'de'qiang'da'xin'jun	0
瞻望弗及	zhan'wang'fu'ji	0
张博	zhang'bo	0
张迪	zhang'di	0
张晶伟	zhang'jing'wei	0
张译文	zhang'yi'wen	0
赵豹	zhao'bao	0
赵纯阳	zhao'chun'yang	0
赵惠文王	zhao'hui'wen'wang	0
赵括	zhao'kuo	0
赵括母	zhao'kuo'mu	0
赵栗	zhao'li	0
赵麟	zhao'lin	0
赵蔓	zhao'man	0
朝秦暮楚	zhao'qin'mu'chu	0
赵奢	zhao'she	0
赵胜	zhao'sheng	0
赵娃	zhao'wa	0
赵孝成王	zhao'xiao'cheng'wang	0
昭阳	zhao'yang	0
昭昭日月不同弦	zhao'zhao'ri'yue'bu'tong'xian	0
真情天道	zhen'qing'tian'dao	0
真正的大伪之言	zhen'zheng'de'da'wei'zhi'yan	0
郑安平	zheng'an'ping	0
郑好	zheng'hao	0
正合天地万物之法则	zheng'he'tian'di'wan'wu'zhi'fa'ze	0
郑天庸	zheng'tian'yong	0
正心而矣	zheng'xin'er'yi	0
智不足以通权变	zhi'bu'zu'yi'tong'quan'bian	0
知向谁边兮	zhi'xiang'shui'bian'xi	0
只因自我认知不够	zhi'yin'zi'wo'ren'zhi'bu'gou	0
知足者	zhi'zu'zhe	0
终不告之	zhong'bu'gao'zhi	0
终不能成	zhong'bu'neng'cheng	0
终不能纳百川	zhong'bu'neng'na'bai'chuan	0
终将大毁也	zhong'jiang'da'hui'ye	0
终将自毁	zhong'jiang'zi'hui	0
终我一生	zhong'wo'yi'sheng	0
终有尽时	zhong'you'jin'shi	0
中有所得	zhong'you'suo'de	0
周波	zhou'bo	0
周乐	zhou'le	0
主帅有失	zhu'shuai'you'shi	0
壮年列国漂泊	zhuang'nian'lie'guo'piao'bo	0
自安者	zi'an'zhe	0
自当修身养性	zi'dang'xiu'shen'yang'xing	0
子兰	zi'lan	0
自穆公称霸	zi'mu'gong'cheng'ba	0
自学之始	zi'xue'zhi'shi	0
自应坦然受之	zi'ying'tan'ran'shou'zhi	0
自应有居安思危之觉	zi'ying'you'ju'an'si'wei'zhi'jue	0
纵情享乐	zong'qing'xiang'le	0
足下无端指斥	zu'xia'wu'duan'zhi'chi	0
做的事不可渎	zuo'de'shi'bu'ke'du	0
坐失鱼盐航运之利	zuo'shi'yu'yan'hang'yun'zhi'li	0
