阿哈玩偶	a'ha'wan'ou	0
阿卡夏记录	a'ka'xia'ji'lu	0
阿兰	a'lan	0
哀荣泣石	ai'rong'qi'shi	0
艾丝妲	ai'si'da	0
艾丝妲与商业精英	ai'si'da'yu'shang'ye'jing'ying	0
黯淡黑曜	an'dan'hei'yao	0
安排	an'pai	0
安全载荷	an'quan'zai'he	0
遨游天外	ao'you'tian'wai	0
巴列维	ba'lie'wei	0
白露	bai'lu	0
白矢决射御	bai'shi'jue'she'yu	0
百无聊赖	bai'wu'liao'lai	0
宝饵堂	bao'er'tang	0
暴风之眼	bao'feng'zhi'yan	0
宝光烛日月	bao'guang'zhu'ri'yue	0
暴击	bao'ji	0
暴击率	bao'ji'lv	0
暴击伤害	bao'ji'shang'hai	0
爆辣蓬蓬菇	bao'la'peng'peng'gu	0
宝命长存的莳者	bao'ming'chang'cun'de'shi'zhe	0
宝石蜥肉串食谱	bao'shi'xi'rou'chuan'shi'pu	0
被废弃与损害的	bei'fei'qi'yu'sun'hai'de	0
背孤击虚	bei'gu'ji'xu	0
悲剧讲座	bei'ju'jiang'zuo	0
贝洛伯格	bei'luo'bo'ge	0
贝洛伯格的音乐家	bei'luo'bo'ge'de'yin'yue'jia	0
贝洛伯格红肠	bei'luo'bo'ge'hong'chang	0
贝洛伯格七大不思议	bei'luo'bo'ge'qi'da'bu'si'yi	0
贝洛伯格学院期中测试卷	bei'luo'bo'ge'xue'yuan'qi'zhong'ce'shi'juan	0
倍润矿脂	bei'run'kuang'zhi	0
背生击死	bei'sheng'ji'si	0
被涂污的信天翁	bei'tu'wu'de'xin'tian'weng	0
被装在套子里的人	bei'zhuang'zai'tao'zi'li'de'ren	0
迸发	beng'fa	0
崩坏	beng'huai	0
崩坏星穹铁道	beng'huai'xing'qiong'tie'dao	0
迸裂晶格	beng'lie'jing'ge	0
变更通知	bian'geng'tong'zhi	0
边缘通路	bian'yuan'tong'lu	0
别让世界静下来	bie'rang'shi'jie'jing'xia'lai	0
冰风暴成因	bing'feng'bao'cheng'yin	0
病痛的折磨	bing'tong'de'zhe'mo	0
冰之芯	bing'zhi'xin	0
铂金时代	bo'jin'shi'dai	0
博识学会	bo'shi'xue'hui	0
博士之袍	bo'shi'zhi'pao	0
博识尊	bo'shi'zun	0
补偿	bu'chang	0
不寒而栗	bu'han'er'li	0
不可制造偶像	bu'ke'zhi'zao'ou'xiang	0
不老者的仙舟	bu'lao'zhe'de'xian'zhou	0
布洛妮娅	bu'luo'ni'ya	0
卜筮	bu'shi	0
不同属性	bu'tong'shu'xing	0
不完整的录音自动转译文档	bu'wan'zheng'de'lu'yin'zi'dong'zhuan'yi'wen'dang	0
不稳定带	bu'wen'ding'dai	0
不消耗能量	bu'xiao'hao'neng'liang	0
不夜候	bu'ye'hou	0
猜拳游戏	cai'quan'you'xi	0
蚕食者之影	can'shi'zhe'zhi'ying	0
残响回廊	can'xiang'hui'lang	0
残页	can'ye	0
舱段	cang'duan	0
操行满分	cao'xing'man'fen	0
测不准匣	ce'bu'zhun'xia	0
长乐天	chang'le'tian	0
怅然若失	chang'ran'ruo'shi	0
长右	chang'you	0
超静定场	chao'jing'ding'chang	0
潮流品牌郊外	chao'liu'pin'pai'jiao'wai	0
晨昏交界的翔鹰	chen'hun'jiao'jie'de'xiang'ying	0
沉沦黑曜	chen'lun'hei'yao	0
沉默且闪耀	chen'mo'qie'shan'yao	0
城郊雪原	cheng'jiao'xue'yuan	0
惩戒粮食	cheng'jie'liang'shi	0
惩戒能量	cheng'jie'neng'liang	0
承露天人	cheng'lu'tian'ren	0
承受	cheng'shou	0
成员火热募集中	cheng'yuan'huo're'mu'ji'zhong	0
齿狼	chi'lang	0
持明族	chi'ming'zu	0
炽燃徘徊者	chi'ran'pai'huai'zhe	0
持续	chi'xu	0
持续时间	chi'xu'shi'jian	0
持续状态	chi'xu'zhuang'tai	0
斥逐	chi'zhu	0
虫巢	chong'chao	0
重返幽冥	chong'fan'you'ming	0
充能效率	chong'neng'xiao'lv	0
充能值	chong'neng'zhi	0
虫网	chong'wang	0
重新获取	chong'xin'huo'qu	0
储备度规	chu'bei'du'gui	0
触不可及	chu'bu'ke'ji	0
触电	chu'dian	0
穿过风雪的旅人	chuan'guo'feng'xue'de'lv'ren	0
垂髫之年	chui'tiao'zhi'nian	0
蠢动原核	chun'dong'yuan'he	0
纯美之袍	chun'mei'zhi'pao	0
春神和战争之神雅利洛	chun'shen'he'zhan'zheng'zhi'shen'ya'li'luo	0
春水初生	chun'shui'chu'sheng	0
纯真	chun'zhen	0
此时恰好	ci'shi'qia'hao	0
次元扑满	ci'yuan'pu'man	0
篡改的野心	cuan'gai'de'ye'xin	0
篡改者	cuan'gai'zhe	0
淬火工坊	cui'huo'gong'fang	0
催吐剂	cui'tu'ji	0
存护	cun'hu	0
存护之影	cun'hu'zhi'ying	0
存护筑材	cun'hu'zhu'cai	0
存在的黄昏	cun'zai'de'huang'hun	0
错误道具	cuo'wu'dao'ju	0
大寒潮	da'han'chao	0
大矿区	da'kuang'qu	0
大矿区排班表	da'kuang'qu'pai'ban'biao	0
大矿区生活守则	da'kuang'qu'sheng'huo'shou'ze	0
大矿区铁道之夜	da'kuang'qu'tie'dao'zhi'ye	0
大守护者	da'shou'hu'zhe	0
大宇宙炒饭	da'yu'zhou'chao'fan	0
大愿般若船	da'yuan'bo're'chuan	0
代码	dai'ma	0
蛋白米	dan'bai'mi	0
单场战斗	dan'chang'zhan'dou	0
丹鼎司	dan'ding'si	0
丹恒	dan'heng	0
丹恒饮月	dan'heng'yin'yue	0
单体	dan'ti	0
但战斗还未结束	dan'zhan'dou'hai'wei'jie'shu	0
当前攻击力	dang'qian'gong'ji'li	0
当前生命值	dang'qian'sheng'ming'zhi	0
到不了的彼岸	dao'bu'liao'de'bi'an	0
盗匪荒漠的废土客	dao'fei'huang'mo'de'fei'tu'ke	0
稻花	dao'hua	0
盗贼公国塔利亚	dao'zei'gong'guo'ta'li'ya	0
等价交换	deng'jia'jiao'huan	0
等量	deng'liang	0
等同于	deng'tong'yu	0
灯昼龙鱼	deng'zhou'long'yu	0
第八条也是最后一条	di'ba'tiao'ye'shi'zui'hou'yi'tiao	0
帝车超光所向捷	di'che'chao'guang'suo'xiang'jie	0
地道仙舟俗语一百句	di'dao'xian'zhou'su'yu'yi'bai'ju	0
地底百科	di'di'bai'ke	0
地底反抗组织	di'di'fan'kang'zu'zhi	0
敌对物种	di'dui'wu'zhong	0
第二次初恋	di'er'ci'chu'lian	0
第二十一条军规	di'er'shi'yi'tiao'jun'gui	0
帝弓断空彻太清	di'gong'duan'kong'che'tai'qing	0
地火	di'huo	0
地火组织的宣传单	di'huo'zu'zhi'de'xuan'chuan'dan	0
嫡灭笞罚	di'mie'chi'fa	0
抵消	di'xiao	0
帝星君临制穹桑	di'xing'jun'lin'zhi'qiong'sang	0
地炎	di'yan	0
递增性末日	di'zeng'xing'mo'ri	0
点个关注吧	dian'ge'guan'zhu'ba	0
奠基	dian'ji	0
电射牛斗	dian'she'niu'dou	0
电视购物频道	dian'shi'gou'wu'pin'dao	0
叠加	die'jia	0
蝶立锋锷	die'li'feng'e	0
叠影器	die'ying'qi	0
丢失的记忆	diu'shi'de'ji'yi	0
冬城过去之灵	dong'cheng'guo'qu'zhi'ling	0
冻结状态	dong'jie'zhuang'tai	0
动物	dong'wu	0
动物凶猛	dong'wu'xiong'meng	0
躲不过十五	duo'bu'guo'shi'wu	0
多愁善感	duo'chou'shan'gan	0
躲得过初一	duo'de'guo'chu'yi	0
额外	e'wai	0
额外回复	e'wai'hui'fu	0
额外消耗	e'wai'xiao'hao	0
发条苹果	fa'tiao'ping'guo	0
法雨	fa'yu	0
翻倍	fan'bei	0
反抗组织	fan'kang'zu'zhi	0
反物质非逆方程	fan'wu'zhi'fei'ni'fang'cheng	0
反物质力场生成器	fan'wu'zhi'li'chang'sheng'cheng'qi	0
蕃息	fan'xi	0
繁星璀璨的天才	fan'xing'cui'can'de'tian'cai	0
繁星竞技场	fan'xing'jing'ji'chang	0
泛银河商业公司	fan'yin'he'shang'ye'gong'si	0
反震	fan'zhen	0
反重子	fan'zhong'zi	0
防御力	fang'yu'li	0
飞虹诛凿齿	fei'hong'zhu'zao'chi	0
飞向明天	fei'xiang'ming'tian	0
焚化工	fen'hua'gong	0
分裂金币	fen'lie'jin'bi	0
愤怒拳套	fen'nu'quan'tao	0
风暴中怒放的花	feng'bao'zhong'nu'fang'de'hua	0
锋镝	feng'di	0
丰厚战利品	feng'hou'zhan'li'pin	0
风化	feng'hua	0
锋芒之形	feng'mang'zhi'xing	0
丰饶	feng'rao	0
丰饶灵兽	feng'rao'ling'shou	0
丰饶香涎	feng'rao'xiang'xian	0
丰饶玄鹿	feng'rao'xuan'lu	0
丰饶之种	feng'rao'zhi'zhong	0
丰饶众生	feng'rao'zhong'sheng	0
丰饶众生一法界心	feng'rao'zhong'sheng'yi'fa'jie'xin	0
风雪免疫	feng'xue'mian'yi	0
风雪之角	feng'xue'zhi'jiao	0
风之旋	feng'zhi'xuan	0
附加伤害	fu'jia'shang'hai	0
浮黎	fu'li	0
福灵胶	fu'ling'jiao	0
负面效果	fu'mian'xiao'guo	0
拂晓之前	fu'xiao'zhi'qian	0
复兴剿荡	fu'xing'jiao'dang	0
复兴之路	fu'xing'zhi'lu	0
符玄	fu'xuan	0
感官追奉者的葬礼	gan'guan'zhui'feng'zhe'de'zang'li	0
感官追猎	gan'guan'zhui'lie	0
甘露	gan'lu	0
告罪书	gao'zui'shu	0
歌德宾馆的夜与雾	ge'de'bin'guan'de'ye'yu'wu	0
歌德宾馆下午茶餐单	ge'de'bin'guan'xia'wu'cha'can'dan	0
各抒己见	ge'shu'ji'jian	0
各自	ge'zi	0
给新手检修员的留言	gei'xin'shou'jian'xiu'yuan'de'liu'yan	0
根除恶孽	gen'chu'e'nie	0
攻击力	gong'ji'li	0
共晶反应	gong'jing'fan'ying	0
公司	gong'si	0
工造迴轮	gong'zao'hui'lun	0
工造浑心	gong'zao'hun'xin	0
工造机杼	gong'zao'ji'zhu	0
工造司	gong'zao'si	0
购物清单	gou'wu'qing'dan	0
构筑	gou'zhu	0
古代零件	gu'dai'ling'jian	0
古代引擎	gu'dai'yin'qing	0
古代转轴	gu'dai'zhuan'zhou	0
固定概率	gu'ding'gai'lv	0
咕咕钟	gu'gu'zhong	0
固溶强化	gu'rong'qiang'hua	0
固态净水	gu'tai'jing'shui	0
观察日记	guan'cha'ri'ji	0
棺的回响	guan'de'hui'xiang	0
冠军晚餐	guan'jun'wan'can	0
冠军晚餐猫的摇篮	guan'jun'wan'can'mao'de'yao'lan	0
关于	guan'yu	0
关于宠物小麻的日记	guan'yu'chong'wu'xiao'ma'de'ri'ji	0
关于梦境分析	guan'yu'meng'jing'fen'xi	0
罐装快乐水	guan'zhuang'kuai'le'shui	0
广场干道增设路障	guang'chang'gan'dao'zeng'she'lu'zhang	0
光巡天矢	guang'xun'tian'shi	0
光锥	guang'zhui	0
光锥呈现	guang'zhui'cheng'xian	0
轨道红移	gui'dao'hong'yi	0
轨迹	gui'ji	0
规则	gui'ze	0
贵重战利品	gui'zhong'zhan'li'pin	0
果腹粮食	guo'fu'liang'shi	0
国际服	guo'ji'fu	0
过往未来	guo'wang'wei'lai	0
骇域漫游的信使	hai'yu'man'you'de'xin'shi	0
寒冬的战士们	han'dong'de'zhan'shi'men	0
寒铁的誓言	han'tie'de'shi'yan	0
好看的垃圾	hao'kan'de'la'ji	0
合成机	he'cheng'ji	0
黑面包汽水冰山	hei'mian'bao'qi'shui'bing'shan	0
黑森林	hei'sen'lin	0
黑塔	hei'ta	0
黑塔的商店	hei'ta'de'shang'dian	0
黑塔的手稿	hei'ta'de'shou'gao	0
黑塔情诗	hei'ta'qing'shi	0
黑塔研究图鉴	hei'ta'yan'jiu'tu'jian	0
恒冰	heng'bing	0
恒温晶壳	heng'wen'jing'ke	0
宏观偏析	hong'guan'pian'xi	0
后会有期	hou'hui'you'qi	0
蝴蝶	hu'die	0
护盾	hu'dun	0
护盾量	hu'dun'liang	0
护盾总量	hu'dun'zong'liang	0
虎克	hu'ke	0
琥珀	hu'po	0
琥珀的坚守	hu'po'de'jian'shou	0
化外民也能学会	hua'wai'min'ye'neng'xue'hui	0
怀疑	huai'yi	0
怀疑的四重根	huai'yi'de'si'chong'gen	0
换境桂冠	huan'jing'gui'guan	0
换境树叶	huan'jing'shu'ye	0
幻胧	huan'long	0
寰宇热寂特征数	huan'yu're'ji'te'zheng'shu	0
黄金大地	huang'jin'da'di	0
灰暗的火	hui'an'de'huo	0
回到未来	hui'dao'wei'lai	0
回灯塔去	hui'deng'ta'qu	0
恢复	hui'fu	0
回光效应	hui'guang'xiao'ying	0
回归	hui'gui	0
慧海度慈航	hui'hai'du'ci'hang	0
回合	hui'he	0
回馈庇护	hui'kui'bi'hu	0
毁灭	hui'mie	0
毁灭性吸积	hui'mie'xing'xi'ji	0
毁灭异质	hui'mie'yi'zhi	0
毁灭者的覆灭	hui'mie'zhe'de'fu'mie	0
毁灭者的末路	hui'mie'zhe'de'mo'lu	0
毁灭之影	hui'mie'zhi'ying	0
回生	hui'sheng	0
回味	hui'wei	0
回响共鸣	hui'xiang'gong'ming	0
回响构音	hui'xiang'gou'yin	0
会心	hui'xin	0
迴星港	hui'xing'gang	0
灰熊	hui'xiong	0
回忆之蕾	hui'yi'zhi'lei	0
回应的兴奋	hui'ying'de'xing'fen	0
回转	hui'zhuan	0
混沌云芝	hun'dun'yun'zhi	0
混乱行至深处	hun'luan'xing'zhi'shen'chu	0
火帝动炉销剑戟	huo'di'dong'lu'xiao'jian'ji	0
火堆外的夜	huo'dui'wai'de'ye	0
火焚灾影	huo'fen'zai'ying	0
火漆	huo'qi	0
火之翎	huo'zhi'ling	0
祸祖砺兵寻旧恨愚人挥剑斩金身	huo'zu'li'bing'xun'jiu'hen'yu'ren'hui'jian'zhan'jin'shen	0
基本食材	ji'ben'shi'cai	0
基本有害	ji'ben'you'hai	0
激变变星	ji'bian'bian'xing	0
记长乐天夜游	ji'chang'le'tian'ye'you	0
继承人	ji'cheng'ren	0
基础概率	ji'chu'gai'lv	0
激冻人心的大冒险	ji'dong'ren'xin'de'da'mao'xian	0
极端氦闪	ji'duan'hai'shan	0
极端体验	ji'duan'ti'yan	0
集会所的留言板	ji'hui'suo'de'liu'yan'ban	0
机壳中的宇宙	ji'ke'zhong'de'yu'zhou	0
吉姆罗杰面包味汽水	ji'mu'luo'jie'mian'bao'wei'qi'shui	0
击破敌方目标弱点	ji'po'di'fang'mu'biao'ruo'dian	0
机械	ji'xie	0
机械聚落	ji'xie'ju'luo	0
记忆	ji'yi	0
记忆的质料	ji'yi'de'zhi'liao	0
记一位星神的陨落	ji'yi'wei'xing'shen'de'yun'luo	0
记忆中的模样	ji'yi'zhong'de'mu'yang	0
基于	ji'yu	0
姬子	ji'zi	0
激奏雷电的乐队	ji'zou'lei'dian'de'yue'dui	0
基座舱段	ji'zuo'cang'duan	0
加持	jia'chi	0
甲虫	jia'chong	0
嘉果	jia'guo	0
家人	jia'ren	0
家书	jia'shu	0
家族颂歌	jia'zu'song'ge	0
坚定	jian'ding	0
健康炒米	jian'kang'chao'mi	0
缄默	jian'mo	0
践踏的意志	jian'ta'de'yi'zhi	0
践踏者	jian'ta'zhe	0
简易护具	jian'yi'hu'ju	0
简易抢救器	jian'yi'qiang'jiu'qi	0
降维骰子	jiang'wei'tou'zi	0
教她做人	jiao'ta'zuo'ren	0
交通	jiao'tong	0
解除	jie'chu	0
接渡使	jie'du'shi	0
戒律性闪变	jie'lv'xing'shan'bian	0
杰姆哈克与杰姆哈尔	jie'mu'ha'ke'yu'jie'mu'ha'er	0
杰帕德	jie'pa'de	0
杰帕德朗道	jie'pa'de'lang'dao	0
接受治疗	jie'shou'zhi'liao	0
结算	jie'suan	0
街头笔友	jie'tou'bi'you	0
街头出身的拳王	jie'tou'chu'shen'de'quan'wang	0
界域定锚	jie'yu'ding'mao	0
禁锢状态	jin'gu'zhuang'tai	0
近况汇总	jin'kuang'hui'zong	0
金人司阍	jin'ren'si'hun	0
今日亦是和平的一日	jin'ri'yi'shi'he'ping'de'yi'ri	0
金属	jin'shu	0
静静的星河	jing'jing'de'xing'he	0
精确优雅	jing'que'you'ya	0
净世残刃	jing'shi'can'ren	0
净庭教宗的圣骑士	jing'ting'jiao'zong'de'sheng'qi'shi	0
景星助狩月	jing'xing'zhu'shou'yue	0
精英敌人	jing'ying'di'ren	0
景元	jing'yuan	0
久安长治	jiu'an'chang'zhi	0
九十九亿个名字	jiu'shi'jiu'yi'ge'ming'zi	0
俱乐部券	ju'le'bu'quan	0
俱殁	ju'mo	0
聚塑	ju'su	0
局外人	ju'wai'ren	0
决绝的痛恨	jue'jue'de'tong'hen	0
角色	jue'se	0
决心如汗珠般闪耀	jue'xin'ru'han'zhu'ban'shan'yao	0
均晶转变	jun'jing'zhuan'bian	0
军用机械例行检修记录表	jun'yong'ji'xie'li'xing'jian'xiu'ji'lu'biao	0
卡芙卡	ka'fu'ka	0
卡利白秘方	ka'li'bai'mi'fang	0
卡利白特派	ka'li'bai'te'pai	0
开端与终结	kai'duan'yu'zhong'jie	0
开盖有奖	kai'gai'you'jiang	0
开疆	kai'jiang	0
开拓力	kai'tuo'li	0
开拓者	kai'tuo'zhe	0
看不见的手	kan'bu'jian'de'shou	0
科技护具	ke'ji'hu'ju	0
可可利亚	ke'ke'li'ya	0
可可利亚虚妄之母	ke'ke'li'ya'xu'wang'zhi'mu	0
克拉拉	ke'la'la	0
克拉拉保护协会	ke'la'la'bao'hu'xie'hui	0
科员间的聊天记录	ke'yuan'jian'de'liao'tian'ji'lu	0
科员们的留言便条	ke'yuan'men'de'liu'yan'bian'tiao	0
科员荣仓终的日记	ke'yuan'rong'cang'zhong'de'ri'ji	0
空乏	kong'fa	0
空间站黑塔	kong'jian'zhan'hei'ta	0
空间站介绍手册	kong'jian'zhan'jie'shao'shou'ce	0
空间站体检事项公告	kong'jian'zhan'ti'jian'shi'xiang'gong'gao	0
空间站员工餐厅反馈记录表	kong'jian'zhan'yuan'gong'can'ting'fan'kui'ji'lu'biao	0
空无烛剪	kong'wu'zhu'jian	0
苦寒晶壳	ku'han'jing'ke	0
苦难与阳光	ku'nan'yu'yang'guang	0
矿灯巴列维	kuang'deng'ba'lie'wei	0
矿灯巴列维的告顾客信	kuang'deng'ba'lie'wei'de'gao'gu'ke'xin	0
矿灯古代遗物鉴定录	kuang'deng'gu'dai'yi'wu'jian'ding'lu	0
矿毒清鼻用吸入剂说明书	kuang'du'qing'bi'yong'xi'ru'ji'shuo'ming'shu	0
矿队的通牒	kuang'dui'de'tong'die	0
矿工病诊断书	kuang'gong'bing'zhen'duan'shu	0
矿工每周报	kuang'gong'mei'zhou'bao	0
旷野的呼告	kuang'ye'de'hu'gao	0
矿业机械采购单据	kuang'ye'ji'xie'cai'gou'dan'ju	0
矿业机械订单列表	kuang'ye'ji'xie'ding'dan'lie'biao	0
奎木	kui'mu	0
垃圾	la'ji	0
朗道的选择	lang'dao'de'xuan'ze	0
老矿头的宝贝	lao'kuang'tou'de'bao'bei	0
乐圮	le'pi	0
雷车动地	lei'che'dong'di	0
雷之眼	lei'zhi'yan	0
冷吃夕红鱼	leng'chi'xi'hong'yu	0
利尔他引力之虹	li'er'ta'yin'li'zhi'hong	0
立即回复	li'ji'hui'fu	0
立刻行动	li'ke'xing'dong	0
离神	li'shen	0
离弦	li'xian	0
历战余响	li'zhan'yu'xiang	0
炼形者	lian'xing'zhe	0
炼形者雷枝	lian'xing'zhe'lei'zhi	0
量子	liang'zi	0
量子涟漪	liang'zi'lian'yi	0
列车	lie'che	0
列车组	lie'che'zu	0
猎慧人宝藏	lie'hui'ren'bao'zang	0
猎慧人来信	lie'hui'ren'lai'xin	0
裂界	lie'jie	0
裂界来电	lie'jie'lai'dian	0
裂伤	lie'shang	0
猎兽之矢	lie'shou'zhi'shi	0
猎物的视线	lie'wu'de'shi'xian	0
劣质护具	lie'zhi'hu'ju	0
鳞渊冰泉	lin'yuan'bing'quan	0
鳞渊境	lin'yuan'jing	0
灵感之钥	ling'gan'zhi'yao	0
零件	ling'jian	0
玲可	ling'ke	0
零维强化	ling'wei'qiang'hua	0
灵钥	ling'yao	0
流吧你的眼泪	liu'ba'ni'de'yan'lei	0
流光定影	liu'guang'ding'ying	0
流光忆庭	liu'guang'yi'ting	0
流岚追孽物	liu'lan'zhui'nie'wu	0
流浪者	liu'lang'zhe	0
流星追迹的怪盗	liu'xing'zhui'ji'de'guai'dao	0
流云渡	liu'yun'du	0
娄金	lou'jin	0
镂月裁云之意	lou'yue'cai'yun'zhi'yi	0
露比冲剂	lu'bi'chong'ji	0
卢卡	lu'ka	0
勠力偕行	lu'li'xie'xing	0
录音带	lu'yin'dai	0
乱七八糟	luan'qi'ba'zao	0
掠夺的本能	lve'duo'de'ben'neng	0
掠夺者	lve'duo'zhe	0
沦浃肌髓	lun'jia'ji'sui	0
论剑	lun'jian	0
轮契	lun'qi	0
罗刹	luo'cha	0
逻辑语言中枢	luo'ji'yu'yan'zhong'shu	0
落日余晖	luo'ri'yu'hui	0
率从狻猊	lv'cong'suan'ni	0
旅情见闻	lv'qing'jian'wen	0
旅途正在继续	lv'tu'zheng'zai'ji'xu	0
麻木不仁	ma'mu'bu'ren	0
漫游指南	man'you'zhi'nan	0
茫茫白夜	mang'mang'bai'ye	0
盲目视界	mang'mu'shi'jie	0
猫的摇篮	mao'de'yao'lan	0
铆钉镇	mao'ding'zhen	0
冒险记录	mao'xian'ji'lu	0
冒险鼹鼠队	mao'xian'yan'shu'dui	0
每次行动	mei'ci'xing'dong	0
梅登矿洞要塌了	mei'deng'kuang'dong'yao'ta'le	0
美服	mei'fu	0
每日实训	mei'ri'shi'xun	0
没有注释	mei'you'zhu'shi	0
迷彩油漆	mi'cai'you'qi	0
秘传	mi'chuan	0
弥合	mi'he	0
密林卧雪的猎人	mi'lin'wo'xue'de'lie'ren	0
密密麻麻的日程	mi'mi'ma'ma'de'ri'cheng	0
秘密誓心	mi'mi'shi'xin	0
迷思绳结	mi'si'sheng'jie	0
宓堂传语	mi'tang'chuan'yu	0
宓堂空境	mi'tang'kong'jing	0
迷惘	mi'wang	0
灭罪累生善	mie'zui'lei'sheng'shan	0
明澈琉璃身	ming'che'liu'li'shen	0
鸣雷造物	ming'lei'zao'wu	0
鸣藕糕	ming'ou'gao	0
命途	ming'tu	0
命途回响	ming'tu'hui'xiang	0
命运的足迹	ming'yun'de'zu'ji	0
貘馍卷	mo'mo'juan	0
模拟宇宙	mo'ni'yu'zhou	0
末日狂欢	mo'ri'kuang'huan	0
末日兽	mo'ri'shou	0
漠视主义	mo'shi'zhu'yi	0
抹消者	mo'xiao'zhe	0
魔阴身士卒	mo'yin'shen'shi'zu	0
某个包裹上的附信	mou'ge'bao'guo'shang'de'fu'xin	0
某个民间科学家的日记	mou'ge'min'jian'ke'xue'jia'de'ri'ji	0
某位界种科科员的周记残页	mou'wei'jie'zhong'ke'ke'yuan'de'zhou'ji'can'ye	0
目标	mu'biao	0
纳努克	na'nu'ke	0
娜塔莎	na'ta'sha	0
娜塔莎的名单	na'ta'sha'de'ming'dan	0
难吃的炒饭	nan'chi'de'chao'fan	0
难言的羞耻	nan'yan'de'xiu'chi	0
内丹士	nei'dan'shi	0
内购专员	nei'gou'zhuan'yuan	0
能量上限	neng'liang'shang'xian	0
能量饮料	neng'liang'yin'liao	0
能量饮料无糖	neng'liang'yin'liao'wu'tang	0
匿影	ni'ying	0
拟造花萼	ni'zao'hua'e	0
凝缩以太	ning'suo'yi'tai	0
凝滞虚影	ning'zhi'xu'ying	0
浓云金蟾	nong'yun'jin'chan	0
暖夜不会漫长	nuan'ye'bu'hui'man'chang	0
欧服	ou'fu	0
帕姆	pa'mu	0
派系	pai'xi	0
攀升的刺激	pan'sheng'de'ci'ji	0
磐岩镇	pan'yan'zhen	0
磐岩镇超级联赛	pan'yan'zhen'chao'ji'lian'sai	0
磐岩镇奇妙夜	pan'yan'zhen'qi'miao'ye	0
佩拉	pei'la	0
朋克洛德精神	peng'ke'luo'de'jing'shen	0
偏振受体	pian'zhen'shou'ti	0
拼接而成的信件	pin'jie'er'cheng'de'xin'jian	0
破坏性耀发	po'huai'xing'yao'fa	0
破裂时	po'lie'shi	0
破碎残刃	po'sui'can'ren	0
普通战利品	pu'tong'zhan'li'pin	0
奇爱医生	qi'ai'yi'sheng	0
启迪之钥	qi'di'zhi'yao	0
奇巧零食	qi'qiao'ling'shi	0
齐颂	qi'song	0
气态流体	qi'tai'liu'ti	0
其渊渺渺	qi'yuan'miao'miao	0
器元士	qi'yuan'shi	0
千面变相	qian'mian'bian'xiang	0
强化膏	qiang'hua'gao	0
切变结构	qie'bian'jie'gou	0
侵蚀隧洞	qin'shi'sui'dong	0
侵蚀隧洞炽火之径	qin'shi'sui'dong'chi'huo'zhi'jing	0
清唱剧	qing'chang'ju	0
清唱剧排练时间	qing'chang'ju'pai'lian'shi'jian	0
青年近卫军	qing'nian'jin'wei'jun	0
青雀	qing'que	0
青铜的执着	qing'tong'de'zhi'zhuo	0
情绪舍锅	qing'xu'she'guo	0
轻雨浥尘	qing'yu'yi'chen	0
琼实鸟串	qiong'shi'niao'chuan	0
全面回忆	quan'mian'hui'yi	0
拳台即戏台	quan'tai'ji'xi'tai	0
全新启程	quan'xin'qi'cheng	0
群星乐章	qun'xing'yue'zhang	0
燃料	ran'liao	0
燃烧男子的肖像	ran'shao'nan'zi'de'xiao'xiang	0
燃素	ran'su	0
禳灾	rang'zai	0
热浮羊奶	re'fu'yang'nai	0
人非草木	ren'fei'cao'mu	0
日常生活采访	ri'chang'sheng'huo'cai'fang	0
日出之前	ri'chu'zhi'qian	0
茸客鸣呦	rong'ke'ming'you	0
茸客鸣呦玉角盘虬	rong'ke'ming'you'yu'jiao'pan'qiu	0
熔岩锻铸的火匠	rong'yan'duan'zhu'de'huo'jiang	0
如果在冬夜	ru'guo'zai'dong'ye	0
入魔机巧	ru'mo'ji'qiao	0
如泥酣眠	ru'ni'han'mian	0
阮梅	ruan'mei	0
睿见	rui'jian	0
弱点击破	ruo'dian'ji'po	0
弱点击破效率	ruo'dian'ji'po'xiao'lv	0
若罪若福	ruo'zui'ruo'fu	0
若罪若福施诸愿印	ruo'zui'ruo'fu'shi'zhu'yuan'yin	0
三余书肆	san'yu'shu'si	0
三月七	san'yue'qi	0
三只小猪	san'zhi'xiao'zhu	0
桑博	sang'bo	0
桑弧蓬矢	sang'hu'peng'shi	0
砂时镜下的幼园	sha'shi'jing'xia'de'you'yuan	0
闪耀的偏方三八面骰	shan'yao'de'pian'fang'san'ba'mian'tou	0
上层区	shang'ceng'qu	0
伤害	shang'hai	0
伤害降低	shang'hai'jiang'di	0
哨戒	shao'jie	0
哨戒卫星	shao'jie'wei'xing	0
射不主皮	she'bu'zhu'pi	0
社会性梦境	she'hui'xing'meng'jing	0
深寒徘徊者	shen'han'pai'huai'zhe	0
身世故事	shen'shi'gu'shi	0
深邃的星外质	shen'sui'de'xing'wai'zhi	0
神性构筑	shen'xing'gou'zhu	0
生存智慧	sheng'cun'zhi'hui	0
生而服从	sheng'er'fu'cong	0
生活物资需求征集	sheng'huo'wu'zi'xu'qiu'zheng'ji	0
胜军	sheng'jun	0
生命传输器	sheng'ming'chuan'shu'qi	0
生命的翁瓦克	sheng'ming'de'weng'wa'ke	0
生命上限	sheng'ming'shang'xian	0
生命值回复量	sheng'ming'zhi'hui'fu'liang	0
生命之泉	sheng'ming'zhi'quan	0
生命之芽	sheng'ming'zhi'ya	0
生命值总量	sheng'ming'zhi'zong'liang	0
士兵们默默无言	shi'bing'men'mo'mo'wu'yan	0
十二猴子与怒汉	shi'er'hou'zi'yu'nu'han	0
始发跃迁	shi'fa'yue'qian	0
施放技能	shi'fang'ji'neng	0
事件视界	shi'jian'shi'jie	0
时节不居	shi'jie'bu'ju	0
失控	shi'kong	0
时空棱镜	shi'kong'leng'jing	0
史瓦罗	shi'wa'luo	0
诗仙机器人	shi'xian'ji'qi'ren	0
实验记录	shi'yan'ji'lu	0
施诸愿印	shi'zhu'yuan'yin	0
守护者的悲愿	shou'hu'zhe'de'bei'yuan	0
守护者之影	shou'hu'zhe'zhi'ying	0
售货机	shou'huo'ji	0
收容舱段	shou'rong'cang'duan	0
狩星巡日	shou'xing'xun'ri	0
首演盛况	shou'yan'sheng'kuang	0
书库管理员	shu'ku'guan'li'yuan	0
疏离的煎熬	shu'li'de'jian'ao	0
树苗长高舞	shu'miao'zhang'gao'wu	0
戍卫风雪的铁卫	shu'wei'feng'xue'de'tie'wei	0
戍卫官	shu'wei'guan	0
属性	shu'xing	0
属性伤害	shu'xing'shang'hai	0
戍御	shu'yu	0
赎珠阁	shu'zhu'ge	0
霜晶造物	shuang'jing'zao'wu	0
水晶日报的送审样稿	shui'jing'ri'bao'de'song'shen'yang'gao	0
说唱大战投票通道开启	shuo'chang'da'zhan'tou'piao'tong'dao'kai'qi	0
四号屠场	si'hao'tu'chang	0
四棱锥体	si'leng'zhui'ti	0
苏打豆汁儿	su'da'dou'zhi'er	0
速度	su'du	0
速度提高	su'du'ti'gao	0
素裳	su'shang	0
随后	sui'hou	0
随机敌方	sui'ji'di'fang	0
随机属性	sui'ji'shu'xing	0
碎星芳饵	sui'xing'fang'er	0
她等待刀尖已经太久	ta'deng'dai'dao'jian'yi'jing'tai'jiu	0
祂们	ta'men	0
他人即地狱	ta'ren'ji'di'yu	0
太卜司	tai'bu'si	0
探索模式	tan'suo'mo'shi	0
躺在铁锈中	tang'zai'tie'xiu'zhong	0
陶德雷奥登	tao'de'lei'ao'deng	0
套装效果	tao'zhuang'xiao'guo	0
特立独行	te'li'du'xing	0
特殊护盾	te'shu'hu'dun	0
特殊商店	te'shu'shang'dian	0
提纯以太	ti'chun'yi'tai	0
提高	ti'gao	0
提高数值	ti'gao'shu'zhi	0
提供护盾	ti'gong'hu'dun	0
提供治疗后	ti'gong'zhi'liao'hou	0
体验	ti'yan	0
体验的富翁	ti'yan'de'fu'weng	0
天棓步危	tian'bei'bu'wei	0
天舶司	tian'bo'si	0
天才俱乐部	tian'cai'ju'le'bu	0
天才们的休憩	tian'cai'men'de'xiu'qi	0
天艟求仙迷航录	tian'chong'qiu'xian'mi'hang'lu	0
天戈麾斥	tian'ge'hui'chi	0
天倾	tian'qing	0
天人不动众	tian'ren'bu'dong'zhong	0
天人遗垢	tian'ren'yi'gou	0
天使型谢债发行机	tian'shi'xing'xie'zhai'fa'xing'ji	0
天外重声大碟	tian'wai'zhong'sheng'da'die	0
天舟缴夙敌	tian'zhou'jiao'su'di	0
调伏诸厄	tiao'fu'zhu'e	0
调和	tiao'he	0
挑战模式	tiao'zhan'mo'shi	0
铁狼碎齿	tie'lang'sui'chi	0
铁卫禁区	tie'wei'jin'qu	0
铁卫军徽	tie'wei'jun'hui	0
铁卫扣饰	tie'wei'kou'shi	0
铁卫勋章	tie'wei'xun'zhang	0
停云	ting'yun	0
停转的萨尔索图	ting'zhuan'de'sa'er'suo'tu	0
彤弓素赠	tong'gong'su'zeng	0
通往群星的轨道	tong'wang'qun'xing'de'gui'dao	0
同谐	tong'xie	0
同谐黏液	tong'xie'nian'ye	0
同谐之蕾	tong'xie'zhi'lei	0
同一种心情	tong'yi'zhong'xin'qing	0
偷闲摸鱼	tou'xian'mo'yu	0
头晕目眩	tou'yun'mu'xuan	0
屠魔之矢	tu'mo'zhi'shi	0
突破	tu'po	0
兔子在哪里	tu'zi'zai'na'li	0
拓扑加速带	tuo'pu'jia'su'dai	0
拓宇行疆之志	tuo'yu'xing'jiang'zhi'zhi	0
瓦尔特	wa'er'te	0
外宇宙之冰	wai'yu'zhou'zhi'bing	0
外宇宙之炎	wai'yu'zhou'zhi'yan	0
晚安与睡颜	wan'an'yu'shui'yan	0
完美体验	wan'mei'ti'yan	0
万能合成机	wan'neng'he'cheng'ji	0
万识囊	wan'shi'nang	0
万寿无情丹	wan'shou'wu'qing'dan	0
万象无常骰	wan'xiang'wu'chang'tou	0
往来邮件副本	wang'lai'you'jian'fu'ben	0
忘却之庭	wang'que'zhi'ting	0
往日之影的金饰	wang'ri'zhi'ying'de'jin'shi	0
往日之影的雷冠	wang'ri'zhi'ying'de'lei'guan	0
汪散步时间	wang'san'bu'shi'jian	0
卫兵卫兵	wei'bing'wei'bing	0
微光原核	wei'guang'yuan'he	0
危害性余光	wei'hai'xing'yu'guang	0
为何一切尚未消失	wei'he'yi'qie'shang'wei'xiao'shi	0
未能寄出的家书	wei'neng'ji'chu'de'jia'shu	0
葳蕤繁祉	wei'rui'fan'zhi	0
葳蕤繁祉延彼遐龄	wei'rui'fan'zhi'yan'bi'xia'ling	0
维修科室的不传之秘	wei'xiu'ke'shi'de'bu'chuan'zhi'mi	0
唯有沉默	wei'you'chen'mo	0
温世齐	wen'shi'qi	0
我的诞生	wo'de'dan'sheng	0
我方全体	wo'fang'quan'ti	0
我们是地火	wo'men'shi'di'huo	0
我们是牛仔	wo'men'shi'niu'zai	0
无处可逃	wu'chu'ke'tao	0
无根据颂歌	wu'gen'ju'song'ge	0
乌号基笞	wu'hao'ji'chi	0
无可取代的东西	wu'ke'qu'dai'de'dong'xi	0
物理	wu'li	0
无名客	wu'ming'ke	0
无名客服	wu'ming'ke'fu	0
无名之地	wu'ming'zhi'di	0
无名之人	wu'ming'zhi'ren	0
无穷假身的遗恨	wu'qiong'jia'shen'de'yi'hen	0
物穰	wu'rang	0
无生残刃	wu'sheng'can'ren	0
呜呜伯	wu'wu'bo	0
呜呜伯行为考	wu'wu'bo'xing'wei'kao	0
舞舞舞	wu'wu'wu	0
无限递归	wu'xian'di'gui	0
无想面具	wu'xiang'mian'ju	0
无余涅槃	wu'yu'nie'pan	0
无中生友指南	wu'zhong'sheng'you'zhi'nan	0
稀薄以太	xi'bo'yi'tai	0
希儿	xi'er	0
熄火	xi'huo	0
希拉的人物剧本	xi'la'de'ren'wu'ju'ben	0
希露瓦	xi'lu'wa	0
熄灭原核	xi'mie'yuan'he	0
希佩	xi'pei	0
下层区	xia'ceng'qu	0
下次行动	xia'ci'xing'dong	0
陷入	xian'ru	0
陷入无法战斗状态	xian'ru'wu'fa'zhan'dou'zhuang'tai	0
衔药龙女	xian'yao'long'nv	0
仙舟联盟	xian'zhou'lian'meng	0
仙舟罗浮	xian'zhou'luo'fu	0
仙舟罗浮持明族	xian'zhou'luo'fu'chi'ming'zu	0
向导佯谬	xiang'dao'yang'miu	0
相关事宜	xiang'guan'shi'yi	0
相关意见	xiang'guan'yi'jian	0
相抗	xiang'kang	0
相邻目标	xiang'lin'mu'biao	0
相位灵火	xiang'wei'ling'huo	0
香涎干酪	xiang'xian'gan'lao	0
小吃摊	xiao'chi'tan	0
效果抵抗	xiao'guo'di'kang	0
消耗能量	xiao'hao'neng'liang	0
小虎克的宝贝	xiao'hu'ke'de'bao'bei	0
魈魅寻踪	xiao'mei'xun'zong	0
消灭敌方目标	xiao'mie'di'fang'mu'biao	0
消灭目标	xiao'mie'mu'biao	0
消灭失控机兵	xiao'mie'shi'kong'ji'bing	0
小朋友	xiao'peng'you	0
小朋友的信	xiao'peng'you'de'xin	0
谐乐小调	xie'le'xiao'diao	0
谢债发行机	xie'zhai'fa'xing'ji	0
谐振传递	xie'zhen'chuan'di	0
信标着色剂	xin'biao'zhuo'se'ji	0
新淬火工坊开张	xin'cui'huo'gong'fang'kai'zhang	0
信使	xin'shi	0
新手任务开始前	xin'shou'ren'wu'kai'shi'qian	0
辛四一云乡讯音	xin'si'yi'yun'xiang'xun'yin	0
信仰债券	xin'yang'zhai'quan	0
信用点	xin'yong'dian	0
星槎海中枢	xing'cha'hai'zhong'shu	0
星槎进出港报告管理办法	xing'cha'jin'chu'gang'bao'gao'guan'li'ban'fa	0
行动序列	xing'dong'xu'lie	0
行动延后	xing'dong'yan'hou	0
兴风者	xing'feng'zhe	0
星海巡航	xing'hai'xun'hang	0
星核	xing'he	0
星核猎手	xing'he'lie'shou	0
星核猎手卡芙卡	xing'he'lie'shou'ka'fu'ka	0
星魂	xing'hun	0
星级	xing'ji	0
行迹	xing'ji	0
星际和平公司	xing'ji'he'ping'gong'si	0
星际和平指南	xing'ji'he'ping'zhi'nan	0
星间构筑	xing'jian'gou'zhu	0
星间流浪	xing'jian'liu'lang	0
星琼	xing'qiong	0
星穹列车	xing'qiong'lie'che	0
星穹列车服	xing'qiong'lie'che'fu	0
星穹铁道	xing'qiong'tie'dao	0
星神	xing'shen	0
星体差分机	xing'ti'cha'fen'ji	0
星星是冰冷的玩具	xing'xing'shi'bing'leng'de'wan'ju	0
星域界种指要	xing'yu'jie'zhong'zhi'yao	0
星域界种指要约特伍德体	xing'yu'jie'zhong'zhi'yao'yue'te'wu'de'ti	0
行政区	xing'zheng'qu	0
修复者	xiu'fu'zhe	0
虚构史学家	xu'gou'shi'xue'jia	0
虚幻铸铁	xu'huan'zhu'tie	0
虚空黑曜	xu'kong'hei'yao	0
虚粒子	xu'li'zi	0
序列扑满	xu'lie'pu'man	0
煦日节	xu'ri'jie	0
煦日节庆典	xu'ri'jie'qing'dian	0
序师执迟彝	xu'shi'zhi'chi'yi	0
虚数	xu'shu	0
虚数残叶	xu'shu'can'ye	0
虚数织叶者	xu'shu'zhi'ye'zhe	0
虚妄供品	xu'wang'gong'pin	0
虚无	xu'wu	0
虚无硬片	xu'wu'ying'pian	0
虚卒	xu'zu	0
漩涡止于中心	xuan'wo'zhi'yu'zhong'xin	0
雪国冒险奇谭	xue'guo'mao'xian'qi'tan	0
雪原寻踪	xue'yuan'xun'zong	0
巽风造物	xun'feng'zao'wu	0
巡猎	xun'lie	0
巡猎石	xun'lie'shi	0
巡星之礼	xun'xing'zhi'li	0
寻药溯源	xun'yao'su'yuan	0
亚服	ya'fu	0
亚共晶体	ya'gong'jing'ti	0
雅利洛	ya'li'luo	0
雅利洛六号	ya'li'luo'liu'hao	0
延彼遐龄	yan'bi'xia'ling	0
延长	yan'chang	0
延长记号	yan'chang'ji'hao	0
炎华造物	yan'hua'zao'wu	0
研究报告	yan'jiu'bao'gao	0
厌离邪秽苦	yan'li'xie'hui'ku	0
湮灭回归不等式	yan'mie'hui'gui'bu'deng'shi	0
湮灭烛剪	yan'mie'zhu'jian	0
彦卿	yan'qing	0
延寿	yan'shou	0
鼹鼠党	yan'shu'dang	0
鼹鼠党欢迎你	yan'shu'dang'huan'ying'ni	0
鼹鼠记贝洛伯格古诗集	yan'shu'ji'bei'luo'bo'ge'gu'shi'ji	0
鼹鼠行动	yan'shu'xing'dong	0
养成材料	yang'cheng'cai'liao	0
养心返魂丹	yang'xin'fan'hun'dan	0
摇滚	yao'gun	0
曜青	yao'qing	0
药师	yao'shi	0
药王秘传	yao'wang'mi'chuan	0
药王秘传炼形者	yao'wang'mi'chuan'lian'xing'zhe	0
野穗伴行的快枪手	ye'sui'ban'xing'de'kuai'qiang'shou	0
一场术后对话	yi'chang'shu'hou'dui'hua	0
溢出	yi'chu	0
一次性动力臂	yi'ci'xing'dong'li'bi	0
一次性动力炮	yi'ci'xing'dong'li'pao	0
一次性防护壁	yi'ci'xing'fang'hu'bi	0
一法界心	yi'fa'jie'xin	0
一封信	yi'feng'xin	0
已黑化	yi'hei'hua	0
一间好商铺世代摇钱树	yi'jian'hao'shang'pu'shi'dai'yao'qian'shu	0
异木果实	yi'mu'guo'shi	0
忆泡	yi'pao	0
遗器	yi'qi	0
遗器残骸	yi'qi'can'hai	0
遗器分解	yi'qi'fen'jie	0
一群旅人	yi'qun'lv'ren	0
医士	yi'shi	0
遗失光尘	yi'shi'guang'chen	0
以世界之名	yi'shi'jie'zhi'ming	0
遗失精粹	yi'shi'jing'cui	0
遗失晶块	yi'shi'jing'kuai	0
遗失碎金	yi'shi'sui'jin	0
已损失	yi'sun'shi	0
意义质询	yi'yi'zhi'xun	0
阴风阵阵	yin'feng'zhen'zhen	0
银河大乐透	yin'he'da'le'tou	0
银河忽悠	yin'he'hu'you	0
银河商人	yin'he'shang'ren	0
银河铁道之夜	yin'he'tie'dao'zhi'ye	0
银狼	yin'lang	0
因为我已触碰过天空	yin'wei'wo'yi'chu'peng'guo'tian'kong	0
隐形的宝藏	yin'xing'de'bao'zang	0
阴影从未离去	yin'ying'cong'wei'li'qu	0
饮月君	yin'yue'jun	0
银鬃近卫	yin'zong'jin'wei	0
银鬃炮手	yin'zong'pao'shou	0
银鬃射手	yin'zong'she'shou	0
银鬃铁卫	yin'zong'tie'wei	0
银鬃铁卫宣誓词	yin'zong'tie'wei'xuan'shi'ci	0
银鬃尉官	yin'zong'wei'guan	0
永不停嘴的羊皮卷	yong'bu'ting'zui'de'yang'pi'juan	0
永动	yong'dong	0
永冬碑石	yong'dong'bei'shi	0
永冬城之夜	yong'dong'cheng'zhi'ye	0
永冬岭	yong'dong'ling	0
永冬灾影	yong'dong'zai'ying	0
永恒河流	yong'heng'he'liu	0
永恒之花	yong'heng'zhi'hua	0
永寿荣枝	yong'shou'rong'zhi	0
永寿天华	yong'shou'tian'hua	0
永寿幼芽	yong'shou'you'ya	0
永坍缩体	yong'tan'suo'ti	0
有点蹊跷	you'dian'qi'qiao	0
有龙矫矫	you'long'jiao'jiao	0
有龙矫矫其渊渺渺	you'long'jiao'jiao'qi'yuan'miao'miao	0
游牧矿工	you'mu'kuang'gong	0
幽邃	you'sui	0
愈合喷剂	yu'he'pen'ji	0
玉角盘虬	yu'jiao'pan'qiu	0
驭空	yu'kong	0
愚人戏	yu'ren'xi	0
余生的第一天	yu'sheng'de'di'yi'tian	0
与行星相会	yu'xing'xing'xiang'hui	0
于夜色中	yu'ye'se'zhong	0
雨一直下	yu'yi'zhi'xia	0
预兆性景深	yu'zhao'xing'jing'shen	0
宇宙安宁片刻	yu'zhou'an'ning'pian'ke	0
宇宙市场趋势	yu'zhou'shi'chang'qu'shi	0
原初的苦衷	yuan'chu'de'ku'zhong	0
渊环	yuan'huan	0
原能量上限	yuan'neng'liang'shang'xian	0
原伤害	yuan'shang'hai	0
原生黑洞	yuan'sheng'hei'dong	0
愿印	yuan'yin	0
阅读物	yue'du'wu	0
跃迁	yue'qian	0
跃迁复眼	yue'qian'fu'yan	0
约特伍德水晶体	yue'te'wu'de'shui'jing'ti	0
约特伍德体是石头	yue'te'wu'de'ti'shi'shi'tou	0
云镝逐步离	yun'di'zhu'bu'li	0
云骑军	yun'qi'jun	0
云骑骁卫	yun'qi'xiao'wei	0
云骑巡防士卒	yun'qi'xun'fang'shi'zu	0
云树百丈蔽重楼	yun'shu'bai'zhang'bi'chong'lou	0
陨铁	yun'tie	0
云无留迹的过客	yun'wu'liu'ji'de'guo'ke	0
杂货小摊	za'huo'xiao'tan	0
再见黑塔	zai'jian'hei'ta	0
在蓝天下	zai'lan'tian'xia	0
灾难性共振	zai'nan'xing'gong'zhen	0
在屋外的黑暗中洗涤	zai'wu'wai'de'hei'an'zhong'xi'di	0
早餐的仪式感	zao'can'de'yi'shi'gan	0
造成	zao'cheng	0
战技	zhan'ji	0
战技点	zhan'ji'dian	0
战利品	zhan'li'pin	0
战犬	zhan'quan	0
战意	zhan'yi	0
障碍判别终端的攻击记录	zhang'ai'pan'bie'zhong'duan'de'gong'ji'ji'lu	0
掌门人	zhang'men'ren	0
折断的龙骨	zhe'duan'de'long'gu	0
柘弓危矢	zhe'gong'wei'shi	0
这就是我啦	zhe'jiu'shi'wo'la	0
这里的黎明	zhe'li'de'li'ming	0
征友启事	zheng'you'qi'shi	0
知觉迷墙	zhi'jue'mi'qiang	0
智库	zhi'ku	0
支离破碎的日记	zhi'li'po'sui'de'ri'ji	0
治疗	zhi'liao	0
治疗量	zhi'liao'liang	0
治疗目标	zhi'liao'mu'biao	0
致炉心基地全体	zhi'lu'xin'ji'di'quan'ti	0
致命伤害	zhi'ming'shang'hai	0
制胜的瞬间	zhi'sheng'de'shun'jian	0
智识	zhi'shi	0
智识树皮	zhi'shi'shu'pi	0
智识之钥	zhi'shi'zhi'yao	0
植物和菌类	zhi'wu'he'jun'lei	0
治愈星球	zhi'yu'xing'qiu	0
支援舱段	zhi'yuan'cang'duan	0
蜘蛛	zhi'zhu	0
制作手调咖啡	zhi'zuo'shou'tiao'ka'fei	0
中规中矩	zhong'gui'zhong'ju	0
终结技	zhong'jie'ji	0
众生安眠	zhong'sheng'an'mian	0
种子	zhong'zi	0
重子	zhong'zi	0
筑城者	zhu'cheng'zhe	0
筑城者的贝洛伯格	zhu'cheng'zhe'de'bei'luo'bo'ge	0
诸法无我	zhu'fa'wu'wo	0
祝福角色防御力	zhu'fu'jue'se'fang'yu'li	0
主控舱段	zhu'kong'cang'duan	0
珠露	zhu'lu	0
逐梦者的信件	zhu'meng'zhe'de'xin'jian	0
主目标	zhu'mu'biao	0
诸行无常	zhu'xing'wu'chang	0
逐星之矢	zhu'xing'zhi'shi	0
专注	zhuan'zhu	0
状态	zhuang'tai	0
追加攻击	zhui'jia'gong'ji	0
捉迷藏	zhuo'mi'cang	0
灼烧	zhuo'shao	0
自动机兵	zi'dong'ji'bing	0
自动口琴	zi'dong'kou'qin	0
自动口琴茫茫白夜	zi'dong'kou'qin'mang'mang'bai'ye	0
自灭者的火种	zi'mie'zhe'de'huo'zhong	0
自欺咖啡馆	zi'qi'ka'fei'guan	0
祖辈的钻头	zu'bei'de'zuan'tou	0
最后的大矿区铁道之夜	zui'hou'de'da'kuang'qu'tie'dao'zhi'ye	0
尊长	zun'zhang	0
作者序	zuo'zhe'xu	0
