阿本	a'ben	0
阿布	a'bu	0
爱恨纠葛	ai'hen'jiu'ge	0
艾力克斯	ai'li'ke'si	0
艾莉丝	ai'li'si	0
爱走到尽头该放手还是执着	ai'zou'dao'jin'tou'gai'fang'shou'hai'shi'zhi'zhuo	0
安钧璨	an'jun'can	0
八点档无奇不有什么都不奇怪	ba'dian'dang'wu'qi'bu'you'shen'me'dou'bu'qi'guai	0
把愤怒唱出来	ba'fen'nu'chang'chu'lai	0
芭乐	ba'le	0
叭噗	ba'pu	0
白目	bai'mu	0
拜托不要再逼我结婚了	bai'tuo'bu'yao'zai'bi'wo'jie'hun'le	0
拜托不要再问我这些问题	bai'tuo'bu'yao'zai'wen'wo'zhe'xie'wen'ti	0
班代	ban'dai	0
班导	ban'dao	0
班杰	ban'jie	0
爆红素人回娘家	bao'hong'su'ren'hui'niang'jia	0
爆红童星长大了	bao'hong'tong'xing'zhang'da'le	0
暴走王	bao'zou'wang	0
被当掉	bei'dang'diao	0
本土剧新血正妹	ben'tu'ju'xin'xue'zheng'mei	0
必杀技	bi'sha'ji	0
宾士	bin'shi	0
不羁的疯狂岁月	bu'ji'de'feng'kuang'sui'yue	0
不可不知	bu'ke'bu'zhi	0
不然我就告你	bu'ran'wo'jiu'gao'ni	0
不为人知的罗曼史	bu'wei'ren'zhi'de'luo'man'shi	0
不像纯种的汉人	bu'xiang'chun'zhong'de'han'ren	0
才不会忘记你呢林志玲	cai'bu'hui'wang'ji'ni'ne'lin'zhi'ling	0
蔡康永	cai'kang'yong	0
蔡小洁	cai'xiao'jie	0
才艺大赏	cai'yi'da'shang	0
餐饮业大解密	can'yin'ye'da'jie'mi	0
曹西平	cao'xi'ping	0
超级好妈妈	chao'ji'hao'ma'ma	0
超吸睛夏日比基尼	chao'xi'jing'xia'ri'bi'ji'ni	0
陈汉典	chen'han'dian	0
陈建州	chen'jian'zhou	0
陈思璇	chen'si'xuan	0
陈为民	chen'wei'min	0
陈文茜	chen'wen'qian	0
陈彦铭	chen'yan'ming	0
陈昭荣	chen'zhao'rong	0
丑陋恐惧症	chou'lou'kong'ju'zheng	0
出国变分手	chu'guo'bian'fen'shou	0
从从	cong'cong	0
剉冰	cuo'bing	0
剉冰天后	cuo'bing'tian'hou	0
大家都说我好像大明星	da'jia'dou'shuo'wo'hao'xiang'da'ming'xing	0
大麦克	da'mai'ke	0
大学部	da'xue'bu	0
代班主持	dai'ban'zhu'chi	0
单纯还是笨	dan'chun'hai'shi'ben	0
当红炸子鸡	dang'hong'zha'zi'ji	0
地雷景点	di'lei'jing'dian	0
电视购物什么都卖什么都不奇怪	dian'shi'gou'wu'shen'me'dou'mai'shen'me'dou'bu'qi'guai	0
电影院不为人知内幕	dian'ying'yuan'bu'wei'ren'zhi'nei'mu	0
范玮琪	fan'wei'qi	0
房东太机车还是房客难搞	fang'dong'tai'ji'che'hai'shi'fang'ke'nan'gao	0
放过我吧你	fang'guo'wo'ba'ni	0
凤梨	feng'li	0
封杀	feng'sha	0
封杀他	feng'sha'ta	0
冯媛甄	feng'yuan'zhen	0
赶快把自己找回来	gan'kuai'ba'zi'ji'zhao'hui'lai	0
肝心脾肺肾	gan'xin'pi'fei'shen	0
告别美食	gao'bie'mei'shi	0
高山峰	gao'shan'feng	0
给我住口	gei'wo'zhu'kou	0
公车	gong'che	0
工作惊魂记	gong'zuo'jing'hun'ji	0
狗腿王	gou'tui'wang	0
鬼话连篇	gui'hua'lian'pian	0
郭世伦	guo'shi'lun	0
郭彦甫	guo'yan'fu	0
郭彦均	guo'yan'jun	0
好值得哭	hao'zhi'de'ku	0
何嘉文	he'jia'wen	0
很做作	hen'zuo'zuo	0
洪百榕	hong'bai'rong	0
红地毯才是女明星的最大战场	hong'di'tan'cai'shi'nv'ming'xing'de'zui'da'zhan'chang	0
洪都拉斯	hong'du'la'si	0
蝴蝶姐姐	hu'die'jie'jie	0
胡天兰	hu'tian'lan	0
花椰菜	hua'ye'cai	0
怀孕才是抢钱的大好时机	huai'yun'cai'shi'qiang'qian'de'da'hao'shi'ji	0
黄镫辉	huang'deng'hui	0
黄国伦	huang'guo'lun	0
黄小琥	huang'xiao'hu	0
黄小柔	huang'xiao'rou	0
黄子佼	huang'zi'jiao	0
机场是女明星的时尚伸展台	ji'chang'shi'nv'ming'xing'de'shi'shang'shen'zhan'tai	0
机车	ji'che	0
加油小朋友	jia'you'xiao'peng'you	0
加油站员工的甘苦秘辛	jia'you'zhan'yuan'gong'de'gan'ku'mi'xin	0
减肥达人的瘦身奇迹	jian'fei'da'ren'de'shou'shen'qi'ji	0
脚踏车	jiao'ta'che	0
姐弟恋是悲剧还是美满结局	jie'di'lian'shi'bei'ju'hai'shi'mei'man'jie'ju	0
结婚是幸福起点还是终点	jie'hun'shi'xing'fu'qi'dian'hai'shi'zhong'dian	0
姐妹淘	jie'mei'tao	0
街上根本没帅哥	jie'shang'gen'ben'mei'shuai'ge	0
捷运	jie'yun	0
金城武	jin'cheng'wu	0
金马奖	jin'ma'jiang	0
金曲歌王	jin'qu'ge'wang	0
金钟奖	jin'zhong'jiang	0
经典毕业歌	jing'dian'bi'ye'ge	0
就是讲一些场面话	jiu'shi'jiang'yi'xie'chang'mian'hua	0
九头身美女	jiu'tou'shen'mei'nv	0
旧照大起底	jiu'zhao'da'qi'di	0
觉得自己是老妹那一刻	jue'de'zi'ji'shi'lao'mei'na'yi'ke	0
康熙愛情诊疗室	kang'xi'ai'qing'zhen'liao'shi	0
康熙出糗时刻	kang'xi'chu'qiu'shi'ke	0
康熙初体验	kang'xi'chu'ti'yan	0
康熙大声公让我们再咆哮一次	kang'xi'da'sheng'gong'rang'wo'men'zai'pao'xiao'yi'ci	0
康熙狗腿王	kang'xi'gou'tui'wang	0
康熙回忆录	kang'xi'hui'yi'lu	0
康熙来了	kang'xi'lai'le	0
康熙历届制作人大集合	kang'xi'li'jie'zhi'zuo'ren'da'ji'he	0
康熙两代流行语交流大会	kang'xi'liang'dai'liu'xing'yu'jiao'liu'da'hui	0
康熙明星梦境密码大解析	kang'xi'ming'xing'meng'jing'mi'ma'da'jie'xi	0
康熙十二年你还记得他们吗	kang'xi'shi'er'nian'ni'hai'ji'de'ta'men'ma	0
康熙外貌调查局	kang'xi'wai'mao'diao'cha'ju	0
康熙严选正妹	kang'xi'yan'xuan'zheng'mei	0
康熙再见	kang'xi'zai'jian	0
康熙职业万花筒	kang'xi'zhi'ye'wan'hua'tong	0
康熙最后一夜	kang'xi'zui'hou'yi'ye	0
靠脸吃饭	kao'lian'chi'fan	0
柯以柔	ke'yi'rou	0
寇乃馨	kou'nai'xin	0
跨时代妆容交换	kua'shi'dai'zhuang'rong'jiao'huan	0
快滚	kuai'gun	0
赖薇如	lai'wei'ru	0
老板劝回大会	lao'ban'quan'hui'da'hui	0
老店好滋味	lao'dian'hao'zi'wei	0
老外眼中的台湾婚礼好奇怪	lao'wai'yan'zhong'de'tai'wan'hun'li'hao'qi'guai	0
冷漠	leng'mo	0
李敖	li'ao	0
李彩桦	li'cai'hua	0
李国强	li'guo'qiang	0
李佳豫	li'jia'yu	0
历届制作人	li'jie'zhi'zuo'ren	0
联考	lian'kao	0
梁赫群	liang'he'qun	0
两性调查局	liang'xing'diao'cha'ju	0
寮国	liao'guo	0
林国基	lin'guo'ji	0
林炜	lin'wei	0
林育群	lin'yu'qun	0
林志玲	lin'zhi'ling	0
另类联谊	ling'lei'lian'yi	0
另类职业万花筒	ling'lei'zhi'ye'wan'hua'tong	0
柳丁	liu'ding	0
刘伊心	liu'yi'xin	0
刘雨柔	liu'yu'rou	0
刘真	liu'zhen	0
旅游惊魂记	lv'you'jing'hun'ji	0
马国贤	ma'guo'xian	0
马如龙	ma'ru'long	0
盲目联谊	mang'mu'lian'yi	0
每看必笑	mei'kan'bi'xiao	0
美丽的错误	mei'li'de'cuo'wu	0
美食大推荐	mei'shi'da'tui'jian	0
美食地图	mei'shi'di'tu	0
没有这回事	mei'you'zhe'hui'shi	0
孟广美	meng'guang'mei	0
米可白	mi'ke'bai	0
面相很差	mian'xiang'hen'cha	0
秒变潮男时尚大叔的魅力哲学	miao'bian'chao'nan'shi'shang'da'shu'de'mei'li'zhe'xue	0
明星不堪回首片段	ming'xing'bu'kan'hui'shou'pian'duan	0
明星匪夷所思的养生妙方	ming'xing'fei'yi'suo'si'de'yang'sheng'miao'fang	0
明星疯狂的副业	ming'xing'feng'kuang'de'fu'ye	0
明星工作很忙碌	ming'xing'gong'zuo'hen'mang'lu	0
明星旅游行李箱行头	ming'xing'lv'you'xing'li'xiang'xing'tou	0
明星人妻的解放时间	ming'xing'ren'qi'de'jie'fang'shi'jian	0
明星人妻换装史上最大挑战	ming'xing'ren'qi'huan'zhuang'shi'shang'zui'da'tiao'zhan	0
明星网络战争	ming'xing'wang'luo'zhan'zheng	0
明星也有被拒绝的惨痛过去	ming'xing'ye'you'bei'ju'jue'de'can'tong'guo'qu	0
明星异于常人行径大对决	ming'xing'yi'yu'chang'ren'xing'jing'da'dui'jue	0
男闺蜜	nan'gui'mi	0
男女交往真的有定律可言	nan'nv'jiao'wang'zhen'de'you'ding'lv'ke'yan	0
男人地雷女人千万不要踩	nan'ren'di'lei'nv'ren'qian'wan'bu'yao'cai	0
男人口总是心非	nan'ren'kou'zong'shi'xin'fei	0
男人送礼如何送到女人心坎里	nan'ren'song'li'ru'he'song'dao'nv'ren'xin'kan'li	0
男人真的越老越吃香	nan'ren'zhen'de'yue'lao'yue'chi'xiang	0
男谐星们勾心斗角拼长相	nan'xie'xing'men'gou'xin'dou'jiao'pin'zhang'xiang	0
难以抗拒的万恶宵夜	nan'yi'kang'ju'de'wan'e'xiao'ye	0
内心深处	nei'xin'shen'chu	0
倪安东	ni'an'dong	0
你倒是蛮会见风使舵的	ni'dao'shi'man'hui'jian'feng'shi'duo'de	0
你的人生一定要这样	ni'de'ren'sheng'yi'ding'yao'zhe'yang	0
你干嘛那么敏感	ni'gan'ma'na'me'min'gan	0
你还活着吗	ni'hai'huo'zhe'ma	0
你会不会觉得你活得有点辛苦	ni'hui'bu'hui'jue'de'ni'huo'de'you'dian'xin'ku	0
你可以正常做人吗	ni'ke'yi'zheng'chang'zuo'ren'ma	0
你们好冷漠	ni'men'hao'leng'mo	0
你们讲话都好伤人	ni'men'jiang'hua'dou'hao'shang'ren	0
你们以为自己是谁	ni'men'yi'wei'zi'ji'shi'shui	0
你是对社会很失望吗	ni'shi'dui'she'hui'hen'shi'wang'ma	0
你听听你自己有多荒谬	ni'ting'ting'ni'zi'ji'you'duo'huang'miu	0
你戏也演够了吧	ni'xi'ye'yan'gou'le'ba	0
你笑起来就是傻	ni'xiao'qi'lai'jiu'shi'sha	0
逆转人生	ni'zhuan'ren'sheng	0
钮承泽	niu'cheng'ze	0
女神与姐妹淘	nv'shen'yu'jie'mei'tao	0
欧巴桑	ou'ba'sang	0
欧汉声	ou'han'sheng	0
偶像包袱	ou'xiang'bao'fu	0
潘若迪	pan'ruo'di	0
胖这个字我不会写	pang'zhe'ge'zi'wo'bu'hui'xie	0
佩甄	pei'zhen	0
婆媳育儿交流大会	po'xi'yu'er'jiao'liu'da'hui	0
其实我的志愿不是当明星	qi'shi'wo'de'zhi'yuan'bu'shi'dang'ming'xing	0
奇异果	qi'yi'guo	0
潜艇堡	qian'ting'bao	0
亲爱的请不要再控制我了	qin'ai'de'qing'bu'yao'zai'kong'zhi'wo'le	0
亲爱的我好想再见你一面	qin'ai'de'wo'hao'xiang'zai'jian'ni'yi'mian	0
亲爱的我一直没给你讲这样	qin'ai'de'wo'yi'zhi'mei'gei'ni'jiang'zhe'yang	0
青赤黄白黑	qing'chi'huang'bai'hei	0
青春纪念册	qing'chun'ji'nian'ce	0
青年疯创业赚钱还是赔大钱	qing'nian'feng'chuang'ye'zhuan'qian'hai'shi'pei'da'qian	0
青少年网路男神	qing'shao'nian'wang'lu'nan'shen	0
曲家瑞	qu'jia'rui	0
任爸	ren'ba	0
人间百态沧海桑田	ren'jian'bai'tai'cang'hai'sang'tian	0
人生就是一直在犯错	ren'sheng'jiu'shi'yi'zhi'zai'fan'cuo	0
人生胜利组	ren'sheng'sheng'li'zu	0
人生完整了	ren'sheng'wan'zheng'le	0
人生要完蛋了	ren'sheng'yao'wan'dan'le	0
入侵行为大揭秘	ru'qin'xing'wei'da'jie'mi	0
弱鸡变猛男	ruo'ji'bian'meng'nan	0
丧心病狂的变美癖	sang'xin'bing'kuang'de'bian'mei'pi	0
色魔	se'mo	0
沈玉琳	shen'yu'lin	0
生命的意义在于尊重	sheng'ming'de'yi'yi'zai'yu'zun'zhong	0
史丹利	shi'dan'li	0
十二年终于等到你	shi'er'nian'zhong'yu'deng'dao'ni	0
世界好奥妙	shi'jie'hao'ao'miao	0
失眠大作战	shi'mian'da'zuo'zhan	0
十年后谁能在演艺圈屹立不摇	shi'nian'hou'shui'neng'zai'yan'yi'quan'yi'li'bu'yao	0
时尚伸展台	shi'shang'shen'zhan'tai	0
瘦身大作战	shou'shen'da'zuo'zhan	0
帅到发痛	shuai'dao'fa'tong	0
甩肉大作战	shuai'rou'da'zuo'zhan	0
衰神大集合	shuai'shen'da'ji'he	0
说对话能让你从地狱到天堂	shuo'dui'hua'neng'rang'ni'cong'di'yu'dao'tian'tang	0
宋玉麒	song'yu'qi	0
苏丽文	su'li'wen	0
素人	su'ren	0
速食面	su'shi'mian	0
她好像疯子一样	ta'hao'xiang'feng'zi'yi'yang	0
他们的爱情不怕见光死	ta'men'de'ai'qing'bu'pa'jian'guang'si	0
他们的表演扬名国际	ta'men'de'biao'yan'yang'ming'guo'ji	0
他们的胆子比天还大	ta'men'de'dan'zi'bi'tian'hai'da	0
他们的局部比女明星还撩人	ta'men'de'ju'bu'bi'nv'ming'xing'hai'liao'ren	0
她们都曾为爱牺牲所有	ta'men'dou'ceng'wei'ai'xi'sheng'suo'you	0
他们都曾为康熙写下精彩一页	ta'men'dou'ceng'wei'kang'xi'xie'xia'jing'cai'yi'ye	0
他们都是爱情里的福尔摩斯	ta'men'dou'shi'ai'qing'li'de'fu'er'mo'si	0
她们都是男性背影杀手	ta'men'dou'shi'nan'xing'bei'ying'sha'shou	0
她们都是女人的眼中钉	ta'men'dou'shi'nv'ren'de'yan'zhong'ding	0
他们都是意想不到的歌手	ta'men'dou'shi'yi'xiang'bu'dao'de'ge'shou	0
他们感情好到绝对不会翻脸	ta'men'gan'qing'hao'dao'jue'dui'bu'hui'fan'lian	0
他们跟照片竟是同一个人	ta'men'gen'zhao'pian'jing'shi'tong'yi'ge'ren	0
他们减掉了一个小学生	ta'men'jian'diao'le'yi'ge'xiao'xue'sheng	0
他们竟然没上过康熙	ta'men'jing'ran'mei'shang'guo'kang'xi	0
他们距离初恋有多远	ta'men'ju'li'chu'lian'you'duo'yuan	0
他们靠一个角色红	ta'men'kao'yi'ge'jue'se'hong	0
他们陪伴康熙走过十二年	ta'men'pei'ban'kang'xi'zou'guo'shi'er'nian	0
他们是好友还是猪队友	ta'men'shi'hao'you'hai'shi'zhu'dui'you	0
她哪有羞耻心	ta'na'you'xiu'chi'xin	0
他人生只能放手	ta'ren'sheng'zhi'neng'fang'shou	0
太龟毛	tai'gui'mao	0
台湾特产	tai'wan'te'chan	0
邰志源	tai'zhi'yuan	0
邰智源	tai'zhi'yuan	0
天啊那一刻我差点恢复单身	tian'a'na'yi'ke'wo'cha'dian'hui'fu'dan'shen	0
天杀的大帅哥	tian'sha'de'da'shuai'ge	0
天生整形脸	tian'sheng'zheng'xing'lian	0
贴标签爆料大会	tie'biao'qian'bao'liao'da'hui	0
铁汉柔情汪小菲	tie'han'rou'qing'wang'xiao'fei	0
通告王	tong'gao'wang	0
外表很重要	wai'biao'hen'zhong'yao	0
网络爆红人物	wang'luo'bao'hong'ren'wu	0
王若琳	wang'ruo'lin	0
王思佳	wang'si'jia	0
王伟忠	wang'wei'zhong	0
为何分手理由都瞎到爆	wei'he'fen'shou'li'you'dou'xia'dao'bao	0
卫斯理	wei'si'li	0
危言耸听	wei'yan'song'ting	0
我不是故意得罪你	wo'bu'shi'gu'yi'de'zui'ni	0
我不想听	wo'bu'xiang'ting	0
我差点就翻桌	wo'cha'dian'jiu'fan'zhuo	0
我的枪拿来	wo'de'qiang'na'lai	0
我好难过	wo'hao'nan'guo	0
我很高调好不好	wo'hen'gao'diao'hao'bu'hao	0
我很惊讶	wo'hen'jing'ya	0
我今天就是说重话	wo'jin'tian'jiu'shi'shuo'zhong'hua	0
我就贪图一个逛街的伴	wo'jiu'tan'tu'yi'ge'guang'jie'de'ban	0
我们都是磨戏都磨成了戏精	wo'men'dou'shi'mo'xi'dou'mo'cheng'le'xi'jing	0
我们一家都是大明星	wo'men'yi'jia'dou'shi'da'ming'xing	0
我们一起追的偶像	wo'men'yi'qi'zhui'de'ou'xiang	0
我世面见很多	wo'shi'mian'jian'hen'duo	0
我是仙	wo'shi'xian	0
我想红为何你不写我	wo'xiang'hong'wei'he'ni'bu'xie'wo	0
我想说天地良心	wo'xiang'shuo'tian'di'liang'xin	0
我笑你没办法	wo'xiao'ni'mei'ban'fa	0
喔咿喔咿	wo'yi'wo'yi	0
我与死神擦身而过的日子	wo'yu'si'shen'ca'shen'er'guo'de'ri'zi	0
我真的瞧不起你	wo'zhen'de'qiao'bu'qi'ni	0
无辜	wu'gu	0
无论如何我都要再上一次康熙	wu'lun'ru'he'wo'dou'yao'zai'shang'yi'ci'kang'xi	0
无名美女禁得起岁月的摧残吗	wu'ming'mei'nv'jin'de'qi'sui'yue'de'cui'can'ma	0
吴佩慈	wu'pei'ci	0
无奇不有的特殊职业	wu'qi'bu'you'de'te'shu'zhi'ye	0
无所求	wu'suo'qiu	0
吴亚馨	wu'ya'xin	0
吴怡霈	wu'yi'pei	0
吴宗宪	wu'zong'xian	0
牺牲小我	xi'sheng'xiao'wo	0
希望社会更和谐	xi'wang'she'hui'geng'he'xie	0
夏克立	xia'ke'li	0
夏语心	xia'yu'xin	0
仙草	xian'cao	0
想当年我们也曾经瘦过	xiang'dang'nian'wo'men'ye'ceng'jing'shou'guo	0
萧煌奇	xiao'huang'qi	0
小禄	xiao'lu	0
小马	xiao'ma	0
小确幸	xiao'que'xing	0
萧淑慎	xiao'shu'shen	0
小甜甜	xiao'tian'tian	0
小甜心	xiao'tian'xin	0
小祯	xiao'zhen	0
谢谢你们的奉献	xie'xie'ni'men'de'feng'xian	0
新手爸妈日记	xin'shou'ba'ma'ri'ji	0
新一代网络爆红人物	xin'yi'dai'wang'luo'bao'hong'ren'wu	0
新一代最美大学校花	xin'yi'dai'zui'mei'da'xue'xiao'hua	0
性感跟恶心是一线之间	xing'gan'gen'e'xin'shi'yi'xian'zhi'jian	0
修杰楷	xiu'jie'kai	0
许纯美	xu'chun'mei	0
许维恩	xu'wei'en	0
徐熙娣	xu'xi'di	0
徐熙娴	xu'xi'xian	0
徐小可	xu'xiao'ke	0
选秀节目到底选出什么好声音	xuan'xiu'jie'mu'dao'di'xuan'chu'shen'me'hao'sheng'yin	0
血泪进化史	xue'lei'jin'hua'shi	0
雪梨	xue'li	0
学生时代千奇百怪的记过理由	xue'sheng'shi'dai'qian'qi'bai'guai'de'ji'guo'li'you	0
演得烂透了	yan'de'lan'tou'le	0
研究所	yan'jiu'suo	0
严立婷	yan'li'ting	0
杨淑君	yang'shu'jun	0
洋芋片	yang'yu'pian	0
瑶瑶	yao'yao	0
一副小人得志的表情	yi'fu'xiao'ren'de'zhi'de'biao'qing	0
异能界	yi'neng'jie	0
艺人认证	yi'ren'ren'zheng	0
意外人生	yi'wai'ren'sheng	0
意想不到的欧巴桑行径	yi'xiang'bu'dao'de'ou'ba'sang'xing'jing	0
殷琦	yin'qi	0
因为爱	yin'wei'ai	0
因为他将要尸变	yin'wei'ta'jiang'yao'shi'bian	0
茵茵	yin'yin	0
应该都是在爱我	ying'gai'dou'shi'zai'ai'wo	0
樱花妹	ying'hua'mei	0
影印	ying'yin	0
勇闯康熙	yong'chuang'kang'xi	0
幼齿	you'chi	0
幼齿爸爸	you'chi'ba'ba	0
有多远走多远	you'duo'yuan'zou'duo'yuan	0
优酪乳	you'lao'ru	0
有人敢跟你顶嘴	you'ren'gan'gen'ni'ding'zui	0
友台	you'tai	0
幼稚园	you'zhi'yuan	0
遇到神棍	yu'dao'shen'gun	0
育儿崩溃实录	yu'er'beng'kui'shi'lu	0
娱乐百分百	yu'le'bai'fen'bai	0
冤家路窄	yuan'jia'lu'zhai	0
原来他们以前竟然长这样	yuan'lai'ta'men'yi'qian'jing'ran'chang'zhe'yang	0
袁惟仁	yuan'wei'ren	0
在康熙干过的荒唐事	zai'kang'xi'gan'guo'de'huang'tang'shi	0
曾少宗	zeng'shao'zong	0
曾之乔	zeng'zhi'qiao	0
诈骗集团	zha'pian'ji'tuan	0
眨眼放电忙不停	zha'yan'fang'dian'mang'bu'ting	0
詹仁雄	zhan'ren'xiong	0
詹惟中	zhan'wei'zhong	0
张克帆	zhang'ke'fan	0
张晓龙	zhang'xiao'long	0
赵靖宇	zhao'jing'yu	0
赵又廷	zhao'you'ting	0
赵正平	zhao'zheng'ping	0
这年头老师不是那么好当的	zhe'nian'tou'lao'shi'bu'shi'na'me'hao'dang'de	0
这些东西竟也有人团购	zhe'xie'dong'xi'jing'ye'you'ren'tuan'gou	0
真爱降临铁汉变柔情	zhen'ai'jiang'lin'tie'han'bian'rou'qing	0
震撼教育	zhen'han'jiao'yu	0
真心话大冒险	zhen'xin'hua'da'mao'xian	0
整形脸	zheng'xing'lian	0
只要有心人人都能有粉丝	zhi'yao'you'xin'ren'ren'dou'neng'you'fen'si	0
中国电视史同学会	zhong'guo'dian'shi'shi'tong'xue'hui	0
终极通告王	zhong'ji'tong'gao'wang	0
中年大叔的爱情恐慌症	zhong'nian'da'shu'de'ai'qing'kong'huang'zheng	0
中天	zhong'tian	0
忠孝东路	zhong'xiao'dong'lu	0
钟欣凌	zhong'xin'ling	0
周杰伦	zhou'jie'lun	0
猪哥亮	zhu'ge'liang	0
朱古力	zhu'gu'li	0
朱木炎	zhu'mu'yan	0
拽个屁	zhuai'ge'pi	0
状元糕	zhuang'yuan'gao	0
资深艺人	zi'shen'yi'ren	0
资深艺人的康熙回忆录	zi'shen'yi'ren'de'kang'xi'hui'yi'lu	0
最称职的绿叶	zui'chen'zhi'de'lv'ye	0
最强放电机	zui'qiang'fang'dian'ji	0
最强照骗美女	zui'qiang'zhao'pian'mei'nv	0
最伤人十大毒言	zui'shang'ren'shi'da'du'yan	0
最熟悉的陌生人	zui'shu'xi'de'mo'sheng'ren	0
