成神	cheng'shen	0
重塑级	chong'su'ji	0
二十四大天灵	er'shi'si'da'tian'ling	0
固元级	gu'yuan'ji	0
护灵级	hu'ling'ji	0
化仙级	hua'xian'ji	0
幻形级	huan'xing'ji	0
火系一脉	huo'xi'yi'mai	0
聚灵级	ju'ling'ji	0
林雨纷	lin'yu'fen	0
莫佑雎	mo'you'ju	0
莫则城	mo'ze'cheng	0
凝灵级	ning'ling'ji	0
凝形级	ning'xing'ji	0
破空级	po'kong'ji	0
破形级	po'xing'ji	0
清灵级	qing'ling'ji	0
润灵级	run'ling'ji	0
神丹	shen'dan	0
圣灵级	sheng'ling'ji	0
水系一脉	shui'xi'yi'mai	0
天灵级	tian'ling'ji	0
天形级	tian'xing'ji	0
仙丹	xian'dan	0
药系一脉	yao'xi'yi'mai	0
玉灵级	yu'ling'ji	0
源力一脉	yuan'li'yi'mai	0
月夕柔	yue'xi'rou	0
重劫级	zhong'jie'ji	0
