阿部阳一	a'bu'yang'yi	0
阿部陽一	a'bu'yang'yi	0
阿刀田高	a'dao'tian'gao	0
阿井涉介	a'jing'she'jie	0
阿井渉介	a'jing'she'jie	0
阿久悠	a'jiu'you	0
愛川晶	ai'chuan'jing	0
爱川晶	ai'chuan'jing	0
奥泉光	ao'quan'guang	0
奥田英朗	ao'tian'ying'lang	0
奥田哲也	ao'tian'zhe'ye	0
白川道	bai'chuan'dao	0
坂本光一	ban'ben'guang'yi	0
半村良	ban'cun'liang	0
坂口安吾	ban'kou'an'wu	0
坂木司	ban'mu'si	0
伴野朗	ban'ye'lang	0
濱尾四郎	bang'wei'si'lang	0
北村薫	bei'cun'xun	0
北方謙三	bei'fang'qian'san	0
北方谦三	bei'fang'qian'san	0
北森鴻	bei'sen'hong	0
北森鸿	bei'sen'hong	0
北山猛邦	bei'shan'meng'bang	0
北上次郎	bei'shang'ci'lang	0
北洋	bei'yang	0
本多孝好	ben'duo'xiao'hao	0
本間田麻誉	ben'jian'tian'ma'yu	0
本间田麻誉	ben'jian'tian'ma'yu	0
本田緒生	ben'tian'xu'sheng	0
本田绪生	ben'tian'xu'sheng	0
滨尾四郎	bin'wei'si'lang	0
冰川珑	bing'chuan'long	0
氷川瓏	bing'chuan'long	0
冰川透	bing'chuan'tou	0
氷川透	bing'chuan'tou	0
柄刀一	bing'dao'yi	0
不知火京介	bu'zhi'huo'jing'jie	0
彩胡	cai'hu	0
仓阪鬼一郎	cang'ban'gui'yi'lang	0
倉阪鬼一郎	cang'ban'gui'yi'lang	0
苍井雄	cang'jing'xiong	0
蒼井雄	cang'jing'xiong	0
仓知淳	cang'zhi'chun	0
倉知淳	cang'zhi'chun	0
草野唯雄	cao'ye'wei'xiong	0
曽根圭介	ceng'gen'gui'jie	0
曾根圭介	ceng'gen'gui'jie	0
柴田錬三郎	chai'tian'jian'san'lang	0
柴田炼三郎	chai'tian'lian'san'lang	0
柴田哲孝	chai'tian'zhe'xiao	0
長坂秀佳	chang'ban'xiu'jia	0
长坂秀佳	chang'ban'xiu'jia	0
長岡弘樹	chang'gang'hong'shu	0
长冈弘树	chang'gang'hong'shu	0
長谷部史親	chang'gu'bu'shi'qin	0
长谷部史亲	chang'gu'bu'shi'qin	0
長井彬	chang'jing'bin	0
长井彬	chang'jing'bin	0
朝三蜻一	chao'san'qing'yi	0
朝山蜻一	chao'shan'qing'yi	0
陈舜臣	chen'shun'chen	0
陳舜臣	chen'shun'chen	0
城昌幸	cheng'chang'xing	0
城户礼	cheng'hu'li	0
城戸禮	cheng'hu'li	0
城平京	cheng'ping'jing	0
赤川次郎	chi'chuan'ci'lang	0
赤江瀑	chi'jiang'pu	0
池井户润	chi'jing'hu'run	0
池井戸潤	chi'jing'hu'run	0
赤井三寻	chi'jing'san'xun	0
赤井三尋	chi'jing'san'xun	0
馳星周	chi'xing'zhou	0
驰星周	chi'xing'zhou	0
初野晴	chu'ye'qing	0
船户与一	chuan'hu'yu'yi	0
船戸与一	chuan'hu'yu'yi	0
川田弥一郎	chuan'tian'mi'yi'lang	0
嵯峨岛昭	cuo'e'dao'zhao	0
嵯峨島昭	cuo'e'dao'zhao	0
大阪圭吉	da'ban'gui'ji	0
大仓崇裕	da'cang'chong'yu	0
大倉崇裕	da'cang'chong'yu	0
大仓烨子	da'cang'ye'zi	0
大倉燁子	da'cang'ye'zi	0
大冈升平	da'gang'sheng'ping	0
大岡昇平	da'gang'sheng'ping	0
大谷羊太郎	da'gu'yang'tai'lang	0
大坪砂男	da'ping'sha'nan	0
大崎梢	da'qi'shao	0
大薮春彦	da'sou'chun'yan	0
大藪春彦	da'sou'chun'yan	0
大下宇陀儿	da'xia'yu'tuo'er	0
大下宇陀児	da'xia'yu'tuo'er	0
大沢在昌	da'ze'zai'chang	0
大泽在昌	da'ze'zai'chang	0
稲見一良	dao'jian'yi'liang	0
稻见一良	dao'jian'yi'liang	0
岛田一男	dao'tian'yi'nan	0
島田一男	dao'tian'yi'nan	0
岛田庄司	dao'tian'zhuang'si	0
道尾秀介	dao'wei'xiu'jie	0
徳冨蘆花	de'fu'lu'hua	0
德富芦花	de'fu'lu'hua	0
徳岡孝夫	de'gang'xiao'fu	0
德冈孝夫	de'gang'xiao'fu	0
登史草兵	deng'shi'cao'bing	0
鏑木蓮	di'mu'lian	0
镝木莲	di'mu'lian	0
荻原浩	di'yuan'hao	0
典厩五郎	dian'jiu'wu'lang	0
鳥羽亮	diao'yu'liang	0
东川笃哉	dong'chuan'du'zai	0
東川篤哉	dong'chuan'du'zai	0
东山彰良	dong'shan'zhang'liang	0
東山彰良	dong'shan'zhang'liang	0
东野圭吾	dong'ye'gui'wu	0
東野圭吾	dong'ye'gui'wu	0
东直己	dong'zhi'ji	0
東直己	dong'zhi'ji	0
都筑道夫	dou'zhu'dao'fu	0
渡边启助	du'bian'qi'zhu	0
渡辺啓助	du'bian'qi'zhu	0
渡边容子	du'bian'rong'zi	0
渡辺容子	du'bian'rong'zi	0
渡边温	du'bian'wen	0
渡辺温	du'bian'wen	0
多岛斗志之	duo'dao'dou'zhi'zhi	0
多島斗志之	duo'dao'dou'zhi'zhi	0
鐸木能光	duo'mu'neng'guang	0
铎木能光	duo'mu'neng'guang	0
多岐川恭	duo'qi'chuan'gong	0
多田茂治	duo'tian'mao'zhi	0
恩田陆	en'tian'lu	0
恩田陸	en'tian'lu	0
二阶堂黎人	er'jie'tang'li'ren	0
二階堂黎人	er'jie'tang'li'ren	0
法月綸太郎	fa'yue'guan'tai'lang	0
法月纶太郎	fa'yue'lun'tai'lang	0
飛鳥部勝則	fei'diao'bu'sheng'ze	0
飛鳥高	fei'diao'gao	0
飞鸟部胜则	fei'niao'bu'sheng'ze	0
飞鸟高	fei'niao'gao	0
逢坂刚	feng'ban'gang	0
逢坂剛	feng'ban'gang	0
風見潤	feng'jian'run	0
风见润	feng'jian'run	0
風間賢二	feng'jian'xian'er	0
风间贤二	feng'jian'xian'er	0
峰隆一郎	feng'long'yi'lang	0
豊田有恒	feng'tian'you'heng	0
丰田有恒	feng'tian'you'heng	0
服部真澄	fu'bu'zhen'cheng	0
福井晴敏	fu'jing'qing'min	0
冈本绮堂	gang'ben'qi'tang	0
岡本綺堂	gang'ben'qi'tang	0
冈嶋二人	gang'dao'er'ren	0
岡嶋二人	gang'dao'er'ren	0
高村薫	gao'cun'xun	0
高村薰	gao'cun'xun	0
高嶋哲夫	gao'dao'zhe'fu	0
高里椎奈	gao'li'zhui'nai	0
高柳芳夫	gao'liu'fang'fu	0
高木彬光	gao'mu'bin'guang	0
高桥克彦	gao'qiao'ke'yan	0
高橋克彦	gao'qiao'ke'yan	0
高田崇史	gao'tian'chong'shi	0
高野和明	gao'ye'he'ming	0
高原弘吉	gao'yuan'hong'ji	0
各务三郎	ge'wu'san'lang	0
各務三郎	ge'wu'san'lang	0
歌野晶午	ge'ye'jing'wu	0
宮部	gong'bu	0
宫部美幸	gong'bu'mei'xing	0
古処誠二	gu'chu'cheng'er	0
古处诚二	gu'chu'cheng'er	0
古川日出男	gu'chuan'ri'chu'nan	0
谷恒生	gu'heng'sheng	0
古泉迦十	gu'quan'jia'shi	0
古野	gu'ye	0
谷原秋桜子	gu'yuan'qiu'ying'zi	0
谷原秋樱子	gu'yuan'qiu'ying'zi	0
貫井徳郎	guan'jing'de'lang	0
贯井德郎	guan'jing'de'lang	0
广濑正	guang'lai'zheng	0
広瀬正	guang'lai'zheng	0
光原百合	guang'yuan'bai'he	0
桧山良昭	gui'shan'liang'zhao	0
檜山良昭	gui'shan'liang'zhao	0
貴志祐介	gui'zhi'you'jie	0
贵志祐介	gui'zhi'you'jie	0
国枝史郎	guo'zhi'shi'lang	0
海渡英祐	hai'du'ying'you	0
海堂尊	hai'tang'zun	0
海庭良和	hai'ting'liang'he	0
海野十三	hai'ye'shi'san	0
鶴見俊輔	he'jian'jun'fu	0
鹤见俊辅	he'jian'jun'fu	0
和久峻三	he'jiu'jun'san	0
河野典生	he'ye'dian'sheng	0
黑川博行	hei'chuan'bo'xing	0
黒川博行	hei'chuan'bo'xing	0
黒崎緑	hei'qi'lu	0
黑崎绿	hei'qi'lv	0
黑崎视音	hei'qi'shi'yin	0
黒崎視音	hei'qi'shi'yin	0
黑田研二	hei'tian'yan'er	0
黒田研二	hei'tian'yan'er	0
黑岩泪香	hei'yan'lei'xiang	0
黒岩涙香	hei'yan'lei'xiang	0
黑岩重吾	hei'yan'zhong'wu	0
黒岩重吾	hei'yan'zhong'wu	0
黑沼健	hei'zhao'jian	0
黒沼健	hei'zhao'jian	0
横沟正史	heng'gou'zheng'shi	0
横溝正史	heng'gou'zheng'shi	0
横山秀夫	heng'shan'xiu'fu	0
户板康二	hu'ban'kang'er	0
戸板康二	hu'ban'kang'er	0
户川昌子	hu'chuan'chang'zi	0
戸川昌子	hu'chuan'chang'zi	0
户松淳矩	hu'song'chun'ju	0
戸松淳矩	hu'song'chun'ju	0
胡桃沢耕史	hu'tao'ze'geng'shi	0
胡桃泽耕史	hu'tao'ze'geng'shi	0
户梶圭太	hu'wei'gui'tai	0
戸梶圭太	hu'wei'gui'tai	0
花村萬月	hua'cun'wan'yue	0
花村万月	hua'cun'wan'yue	0
荒卷义雄	huang'juan'yi'xiong	0
荒巻義雄	huang'juan'yi'xiong	0
結城昌治	ji'cheng'chang'zhi	0
吉村达也	ji'cun'da'ye	0
吉村達也	ji'cun'da'ye	0
几濑胜彬	ji'lai'sheng'bin	0
幾瀬勝彬	ji'lai'sheng'bin	0
积木镜介	ji'mu'jing'jie	0
積木鏡介	ji'mu'jing'jie	0
紀田順一郎	ji'tian'shun'yi'lang	0
纪田顺一郎	ji'tian'shun'yi'lang	0
吉野賛十	ji'ye'zan'shi	0
吉野赞十	ji'ye'zan'shi	0
吉原忠男	ji'yuan'zhong'nan	0
加賀美雅之	jia'he'mei'ya'zhi	0
加贺美雅之	jia'he'mei'ya'zhi	0
甲賀三郎	jia'he'san'lang	0
甲贺三郎	jia'he'san'lang	0
加納朋子	jia'na'peng'zi	0
加纳朋子	jia'na'peng'zi	0
加納一朗	jia'na'yi'lang	0
加纳一朗	jia'na'yi'lang	0
加田伶太郎	jia'tian'ling'tai'lang	0
菅浩江	jian'hao'jiang	0
江户川乱步	jiang'hu'chuan'luan'bu	0
江戸川乱歩	jiang'hu'chuan'luan'bu	0
江見水蔭	jiang'jian'shui'yin	0
江见水荫	jiang'jian'shui'yin	0
角田喜久雄	jiao'tian'xi'jiu'xiong	0
结城昌治	jie'cheng'chang'zhi	0
皆川博子	jie'chuan'bo'zi	0
金春智子	jin'chun'zhi'zi	0
今春智子	jin'chun'zhi'zi	0
津村秀介	jin'cun'xiu'jie	0
近藤史恵	jin'teng'shi'hui	0
近滕史惠	jin'teng'shi'hui	0
今野敏	jin'ye'min	0
今邑彩	jin'yi'cai	0
京极夏彦	jing'ji'xia'yan	0
京極夏彦	jing'ji'xia'yan	0
井家上隆幸	jing'jia'shang'long'xing	0
井上夢人	jing'shang'meng'ren	0
井上梦人	jing'shang'meng'ren	0
鯨統一郎	jing'tong'yi'lang	0
鲸统一郎	jing'tong'yi'lang	0
井沢元彦	jing'ze'yuan'yan	0
井泽元彦	jing'ze'yuan'yan	0
久保寺健彦	jiu'bao'si'jian'yan	0
久保田滋	jiu'bao'tian'zi	0
久生十蘭	jiu'sheng'shi'lan	0
久生十兰	jiu'sheng'shi'lan	0
鷲尾三郎	jiu'wei'san'lang	0
鹫尾三郎	jiu'wei'san'lang	0
久远惠	jiu'yuan'hui	0
久遠恵	jiu'yuan'hui	0
菊村到	ju'cun'dao	0
橘外男	ju'wai'nan	0
濑下耽	lai'xia'dan	0
瀬下耽	lai'xia'dan	0
栗本薫	li'ben'xun	0
栗本薰	li'ben'xun	0
笠井洁	li'jing'jie	0
笠井潔	li'jing'jie	0
连城三纪彦	lian'cheng'san'ji'yan	0
連城三紀彦	lian'cheng'san'ji'yan	0
鈴木輝一郎	ling'mu'hui'yi'lang	0
铃木辉一郎	ling'mu'hui'yi'lang	0
綾辻行人	ling'shi'xing'ren	0
绫辻行人	ling'shi'xing'ren	0
柳原慧	liu'yuan'hui	0
竜騎士	long'ji'shi	0
龙骑士	long'qi'shi	0
芦边拓	lu'bian'tuo	0
芦辺拓	lu'bian'tuo	0
芦原	lu'yuan	0
麻耶雄嵩	ma'ye'xiong'song	0
妹尾韶夫	mei'wei'shao'fu	0
梅原克文	mei'yuan'ke'wen	0
夢野久作	meng'ye'jiu'zuo	0
梦野久作	meng'ye'jiu'zuo	0
米山公启	mi'shan'gong'qi	0
米山公啓	mi'shan'gong'qi	0
米澤穂信	mi'shi'sui'xin	0
米泽穗信	mi'ze'sui'xin	0
鳴海章	ming'hai'zhang	0
鸣海章	ming'hai'zhang	0
明野照葉	ming'ye'zhao'ye	0
明野照叶	ming'ye'zhao'ye	0
末浦广海	mo'pu'guang'hai	0
末浦広海	mo'pu'guang'hai	0
木村譲二	mu'cun'rang'er	0
木村让二	mu'cun'rang'er	0
木高太郎	mu'gao'tai'lang	0
木谷恭介	mu'gu'gong'jie	0
木木高太郎	mu'mu'gao'tai'lang	0
雫井脩介	na'jing'xiu'jie	0
雫井修介	na'jing'xiu'jie	0
乃南	nai'nan	0
乃南朝	nai'nan'chao	0
南里征典	nan'li'zheng'dian	0
南条范夫	nan'tiao'fan'fu	0
南條範夫	nan'tiao'fan'fu	0
南沢十七	nan'ze'shi'qi	0
南泽十七	nan'ze'shi'qi	0
内田干树	nei'tian'gan'shu	0
内田幹樹	nei'tian'gan'shu	0
内田康夫	nei'tian'kang'fu	0
鮎川哲也	nian'chuan'zhe'ye	0
鲇川哲也	nian'chuan'zhe'ye	0
鸟羽亮	niao'yu'liang	0
泡坂妻夫	pao'ban'qi'fu	0
片冈义男	pian'gang'yi'nan	0
片岡義男	pian'gang'yi'nan	0
平林初之輔	ping'lin'chu'zhi'fu	0
平林初之辅	ping'lin'chu'zhi'fu	0
平山夢明	ping'shan'meng'ming	0
平山梦明	ping'shan'meng'ming	0
平石貴樹	ping'shi'gui'shu	0
平石贵树	ping'shi'gui'shu	0
浦賀和宏	pu'he'he'hong	0
浦贺和宏	pu'he'he'hong	0
浅仓卓弥	qian'cang'zhuo'mi	0
浅倉卓弥	qian'cang'zhuo'mi	0
千街晶之	qian'jie'jing'zhi	0
浅暮三文	qian'mu'san'wen	0
桥本五郎	qiao'ben'wu'lang	0
橋本五郎	qiao'ben'wu'lang	0
秦建日子	qin'jian'ri'zi	0
秦新二	qin'xin'er	0
青井夏海	qing'jing'xia'hai	0
清凉院流水	qing'liang'yuan'liu'shui	0
清涼院流水	qing'liang'yuan'liu'shui	0
青木雨彦	qing'mu'yu'yan	0
清水义范	qing'shui'yi'fan	0
清水義範	qing'shui'yi'fan	0
清水一行	qing'shui'yi'xing	0
丘美丈二郎	qiu'mei'zhang'er'lang	0
秋月达郎	qiu'yue'da'lang	0
秋月達郎	qiu'yue'da'lang	0
秋月凉介	qiu'yue'liang'jie	0
秋月涼介	qiu'yue'liang'jie	0
权田万治	quan'tian'wan'zhi	0
権田萬治	quan'tian'wan'zhi	0
仁木悦子	ren'mu'yue'zi	0
日高恒太朗	ri'gao'heng'tai'lang	0
日明恩	ri'ming'en	0
日下圭介	ri'xia'gui'jie	0
日向旦	ri'xiang'dan	0
日影丈吉	ri'ying'zhang'ji	0
若山三郎	ruo'shan'san'lang	0
若竹七海	ruo'zhu'qi'hai	0
箬竹七海	ruo'zhu'qi'hai	0
三津田信三	san'jin'tian'xin'san	0
三浦明博	san'pu'ming'bo	0
三雲岳斗	san'yun'yue'dou	0
三云岳斗	san'yun'yue'dou	0
森博嗣	sen'bo'si	0
森村誠一	sen'cun'cheng'yi	0
森村诚一	sen'cun'cheng'yi	0
森谷明子	sen'gu'ming'zi	0
森雅裕	sen'ya'yu	0
森英俊	sen'ying'jun	0
山本周五郎	shan'ben'zhou'wu'lang	0
山村美紗	shan'cun'mei'sha	0
山村美纱	shan'cun'mei'sha	0
山村正夫	shan'cun'zheng'fu	0
山口雅也	shan'kou'ya'ye	0
山浦弘靖	shan'pu'hong'jing	0
山崎洋子	shan'qi'yang'zi	0
山前譲	shan'qian'rang	0
山前让	shan'qian'rang	0
山田風太郎	shan'tian'feng'tai'lang	0
山田风太郎	shan'tian'feng'tai'lang	0
山田真哉	shan'tian'zhen'zai	0
山田正紀	shan'tian'zheng'ji	0
山田正纪	shan'tian'zheng'ji	0
山田宗树	shan'tian'zong'shu	0
山田宗樹	shan'tian'zong'shu	0
山沢晴雄	shan'ze'qing'xiong	0
山泽晴雄	shan'ze'qing'xiong	0
上远野浩平	shang'yuan'ye'hao'ping	0
上遠野浩平	shang'yuan'ye'hao'ping	0
深町秋生	shen'ding'qiu'sheng	0
深谷忠記	shen'gu'zhong'ji	0
深谷忠记	shen'gu'zhong'ji	0
神山裕右	shen'shan'yu'you	0
生岛治郎	sheng'dao'zhi'lang	0
生島治郎	sheng'dao'zhi'lang	0
生垣真太郎	sheng'yuan'zhen'tai'lang	0
石持浅海	shi'chi'qian'hai	0
石川喬司	shi'chuan'jiao'si	0
石川乔司	shi'chuan'qiao'si	0
石川真介	shi'chuan'zhen'jie	0
矢岛诚	shi'dao'cheng	0
矢島誠	shi'dao'cheng	0
式貴士	shi'gui'shi	0
式贵士	shi'gui'shi	0
石井敏弘	shi'jing'min'hong	0
石崎幸二	shi'qi'xing'er	0
石田衣良	shi'tian'yi'liang	0
石原慎太郎	shi'yuan'shen'tai'lang	0
辻真先	shi'zhen'xian	0
矢作俊彦	shi'zuo'jun'yan	0
狩久	shou'jiu	0
首藤瓜於	shou'teng'gua'yu	0
殊能将之	shu'neng'jiang'zhi	0
水谷准	shui'gu'zhun	0
水谷準	shui'gu'zhun	0
水上吕理	shui'shang'lv'li	0
水上呂理	shui'shang'lv'li	0
水上勉	shui'shang'mian	0
水原秀策	shui'yuan'xiu'ce	0
水原佐保	shui'yuan'zuo'bao	0
松本恵子	song'ben'hui'zi	0
松本惠子	song'ben'hui'zi	0
松本清张	song'ben'qing'zhang	0
松本清張	song'ben'qing'zhang	0
松本泰	song'ben'tai	0
松村喜雄	song'cun'xi'xiong	0
松山严	song'shan'yan	0
松山巖	song'shan'yan	0
松田美智子	song'tian'mei'zhi'zi	0
松尾由美	song'wei'you'mei	0
苏部健一	su'bu'jian'yi	0
蘇部健一	su'bu'jian'yi	0
太田蘭三	tai'tian'lan'san	0
太田兰三	tai'tian'lan'san	0
太田忠司	tai'tian'zhong'si	0
藤本泉	teng'ben'quan	0
藤村正太	teng'cun'zheng'tai	0
藤冈真	teng'gang'zhen	0
藤岡真	teng'gang'zhen	0
藤田宜永	teng'tian'yi'yong	0
藤原审尔	teng'yuan'shen'er	0
藤原審爾	teng'yuan'shen'er	0
藤原伊織	teng'yuan'yi'zhi	0
藤原伊织	teng'yuan'yi'zhi	0
藤原宰太郎	teng'yuan'zai'tai'lang	0
天城一	tian'cheng'yi	0
天树征丸	tian'shu'zheng'wan	0
天樹征丸	tian'shu'zheng'wan	0
天藤真	tian'teng'zhen	0
天童荒太	tian'tong'huang'tai	0
田中光二	tian'zhong'guang'er	0
畠中恵	tian'zhong'hui	0
畠中惠	tian'zhong'hui	0
田中启文	tian'zhong'qi'wen	0
田中啓文	tian'zhong'qi'wen	0
筒井康隆	tong'jing'kang'long	0
樋口有介	tong'kou'you'jie	0
桐野夏生	tong'ye'xia'sheng	0
土屋隆夫	tu'wu'long'fu	0
梶龍雄	wei'long'xiong	0
梶龙雄	wei'long'xiong	0
梶山季之	wei'shan'ji'zhi	0
我孙子武丸	wo'sun'zi'wu'wan	0
我孫子武丸	wo'sun'zi'wu'wan	0
舞城王太郎	wu'cheng'wang'tai'lang	0
雾舍巧	wu'she'qiao	0
霧舎巧	wu'she'qiao	0
五十岚贵久	wu'shi'lan'gui'jiu	0
五十嵐貴久	wu'shi'lan'gui'jiu	0
五条瑛	wu'tiao'ying	0
五條瑛	wu'tiao'ying	0
西村京太郎	xi'cun'jing'tai'lang	0
西村寿行	xi'cun'shou'xing	0
西东登	xi'dong'deng	0
西東登	xi'dong'deng	0
西木正明	xi'mu'zheng'ming	0
西澤保彦	xi'shi'bao'yan	0
西尾維新	xi'wei'wei'xin	0
西尾维新	xi'wei'wei'xin	0
西尾正	xi'wei'zheng	0
西泽保彦	xi'ze'bao'yan	0
谺健二	xia'jian'er	0
霞流一	xia'liu'yi	0
夏緑	xia'lu	0
夏绿	xia'lv	0
夏树静子	xia'shu'jing'zi	0
夏樹静子	xia'shu'jing'zi	0
香納諒一	xiang'na'liang'yi	0
香纳谅一	xiang'na'liang'yi	0
香山滋	xiang'shan'zi	0
翔田宽	xiang'tian'kuan	0
翔田寛	xiang'tian'kuan	0
郷原宏	xiang'yuan'hong	0
乡原宏	xiang'yuan'hong	0
小池真理子	xiao'chi'zhen'li'zi	0
小峰元	xiao'feng'yuan	0
小酒井不木	xiao'jiu'jing'bu'mu	0
小栗虫太郎	xiao'li'chong'tai'lang	0
小笠原慧	xiao'li'yuan'hui	0
小林久三	xiao'lin'jiu'san	0
小泉喜美子	xiao'quan'xi'mei'zi	0
小森健太朗	xiao'sen'jian'tai'lang	0
小杉健治	xiao'shan'jian'zhi	0
小松左京	xiao'song'zuo'jing	0
篠田节子	xiao'tian'jie'zi	0
篠田節子	xiao'tian'jie'zi	0
篠田真由美	xiao'tian'zhen'you'mei	0
小野不由美	xiao'ye'bu'you'mei	0
小鷹信光	xiao'ying'xin'guang	0
小鹰信光	xiao'ying'xin'guang	0
新保博久	xin'bao'bo'jiu	0
新本格派作家	xin'ben'ge'pai'zuo'jia	0
新宫正春	xin'gong'zheng'chun	0
新宮正春	xin'gong'zheng'chun	0
新堂冬树	xin'tang'dong'shu	0
新堂冬樹	xin'tang'dong'shu	0
新野刚志	xin'ye'gang'zhi	0
新野剛志	xin'ye'gang'zhi	0
新章文子	xin'zhang'wen'zi	0
星田三平	xing'tian'san'ping	0
星新一	xing'xin'yi	0
巽昌章	xun'chang'zhang	0
雅孝司	ya'xiao'si	0
药丸岳	yao'wan'yue	0
薬丸岳	yao'wan'yue	0
野村胡堂	ye'cun'hu'tang	0
野崎六助	ye'qi'liu'zhu	0
野沢尚	ye'ze'shang	0
野泽尚	ye'ze'shang	0
伊坂幸太郎	yi'ban'xing'tai'lang	0
伊藤秀雄	yi'teng'xiu'xiong	0
乙一	yi'yi	0
鷹見緋沙子	ying'jian'fei'sha'zi	0
鹰见绯沙子	ying'jian'fei'sha'zi	0
桜庭一樹	ying'ting'yi'shu	0
樱庭一树	ying'ting'yi'shu	0
永井	yong'jing	0
永濑三吾	yong'lai'san'wu	0
永瀬三吾	yong'lai'san'wu	0
由良三郎	you'liang'san'lang	0
有馬頼義	you'ma'lai'yi	0
有马赖义	you'ma'lai'yi	0
有栖川有栖	you'qi'chuan'you'qi	0
楡周平	yu'zhou'ping	0
榆周平	yu'zhou'ping	0
垣根凉介	yuan'gen'liang'jie	0
垣根涼介	yuan'gen'liang'jie	0
原尞	yuan'liao	0
早濑乱	zao'lai'luan	0
早瀬乱	zao'lai'luan	0
斋藤纯	zhai'teng'chun	0
斎藤純	zhai'teng'chun	0
斋藤荣	zhai'teng'rong	0
斎藤栄	zhai'teng'rong	0
折原一	zhe'yuan'yi	0
真保裕一	zhen'bao'yu'yi	0
阵出达朗	zhen'chu'da'lang	0
陣出達朗	zhen'chu'da'lang	0
植草甚一	zhi'cao'shen'yi	0
直井明	zhi'jing'ming	0
志茂田景树	zhi'mao'tian'jing'shu	0
志茂田景樹	zhi'mao'tian'jing'shu	0
芝山仓平	zhi'shan'cang'ping	0
芝山倉平	zhi'shan'cang'ping	0
志水辰夫	zhi'shui'chen'fu	0
中川裕朗	zhong'chuan'yu'lang	0
种村直树	zhong'cun'zhi'shu	0
種村直樹	zhong'cun'zhi'shu	0
中岛	zhong'dao	0
中島	zhong'dao	0
中嶋博行	zhong'dao'bo'xing	0
中津文彦	zhong'jin'wen'yan	0
中井英夫	zhong'jing'ying'fu	0
中西智明	zhong'xi'zhi'ming	0
中薗英助	zhong'yuan'ying'zhu	0
帚木蓬生	zhou'mu'peng'sheng	0
竹本健治	zhu'ben'jian'zhi	0
竹内薫	zhu'nei'xun	0
竹内薰	zhu'nei'xun	0
竹中劳	zhu'zhong'lao	0
竹中労	zhu'zhong'lao	0
梓林太郎	zi'lin'tai'lang	0
姉小路祐	zi'xiao'lu'you	0
最相葉月	zui'xiang'ye'yue	0
最相叶月	zui'xiang'ye'yue	0
佐飛通俊	zuo'fei'tong'jun	0
佐飞通俊	zuo'fei'tong'jun	0
佐賀潜	zuo'he'qian	0
佐贺潜	zuo'he'qian	0
佐濑稔	zuo'lai'ren	0
佐瀬稔	zuo'lai'ren	0
佐木俊介	zuo'mu'jun'jie	0
佐木譲	zuo'mu'rang	0
佐木丸美	zuo'mu'wan'mei	0
佐藤友哉	zuo'teng'you'zai	0
左頭弦馬	zuo'tou'xian'ma	0
左头弦马	zuo'tou'xian'ma	0
佐野洋	zuo'ye'yang	0
佐佐木俊介	zuo'zuo'mu'jun'jie	0
佐佐木让	zuo'zuo'mu'rang	0
佐佐木丸美	zuo'zuo'mu'wan'mei	0
