爱岛琴美	ai'dao'qin'mei	0
苍井翔太	cang'jing'xiang'tai	0
春歌	chun'ge	0
达子	da'zi	0
代永翼	dai'yong'yi	0
凤瑛一	feng'ying'yi	0
歌殿	ge'dian	0
歌之王子殿下	ge'zhi'wang'zi'dian'xia	0
宫野真守	gong'ye'zhen'shou	0
谷山纪章	gu'shan'ji'zhang	0
黑崎	hei'qi	0
黑崎兰丸	hei'qi'lan'wan	0
皇绮罗	huang'qi'luo	0
今井由香	jin'jing'you'xiang	0
劲歌贵公子	jing'ge'gui'gong'zi	0
卡缪	ka'miu	0
库普鲁	ku'pu'lu	0
来栖翔	lai'qi'xiang	0
来栖薰	lai'qi'xun	0
兰兰	lan'lan	0
蓝蓝	lan'lan	0
铃村健一	ling'cun'jian'yi	0
铃木达央	ling'mu'da'yang	0
绿川光	lv'chuan'guang	0
美风蓝	mei'feng'lan	0
魔鬼董事长	mo'gui'dong'shi'zhang	0
鸟海浩辅	niao'hai'hao'fu	0
偶像课程	ou'xiang'ke'cheng	0
七海春歌	qi'hai'chun'ge	0
前野智昭	qian'ye'zhi'zhao	0
亲父	qin'fu	0
日向龙也	ri'xiang'long'ye	0
如月爱音	ru'yue'ai'yin	0
若本规夫	ruo'ben'gui'fu	0
森久保祥太郎	sen'jiu'bao'xiang'tai'lang	0
砂月	sha'yue	0
杉田智和	shan'tian'zhi'he	0
涉谷友千香	she'gu'you'qian'xiang	0
神宫寺	shen'gong'si	0
神宫寺财团	shen'gong'si'cai'tuan	0
神宫寺雷	shen'gong'si'lei	0
圣川财团	sheng'chuan'cai'tuan	0
圣川真臣	sheng'chuan'zhen'chen	0
圣川真斗	sheng'chuan'zhen'dou	0
圣川真衣	sheng'chuan'zhen'yi	0
寿岭二	shou'ling'er	0
寺岛拓笃	si'dao'tuo'du	0
四之宫那月	si'zhi'gong'na'yue	0
天使之音	tian'shi'zhi'yin	0
梶裕贵	wei'yu'gui	0
下野紘	xia'ye'hong	0
小鸡仔	xiao'ji'zai	0
小翔	xiao'xiang	0
小野大辅	xiao'ye'da'fu	0
亚古那帕雷斯	ya'gu'na'pa'lei'si	0
一十木音也	yi'shi'mu'yin'ye	0
一之濑时也	yi'zhi'lai'shi'ye	0
音乐之神	yin'yue'zhi'shen	0
游佐浩二	you'zuo'hao'er	0
月宫林檎	yue'gong'lin'qin	0
早乙女	zao'yi'nv	0
早乙女光男	zao'yi'nv'guang'nan	0
早乙女学园	zao'yi'nv'xue'yuan	0
泽城美雪	ze'cheng'mei'xue	0
中村悠一	zhong'cun'you'yi	0
诹访部顺一	zou'fang'bu'shun'yi	0
诹少	zou'shao	0
