阿尔卡娜	a'er'ka'na	0
阿卡杜斯	a'ka'du'si	0
艾登	ai'deng	0
艾莉莎	ai'li'sha	0
艾斯希德	ai'si'xi'de	0
艾因拉赫	ai'yin'la'he	0
巴罗尔	ba'luo'er	0
败走废墟	bai'zou'fei'xu	0
暴君的挑衅	bao'jun'de'tiao'xin	0
被冰冻的大地	bei'bing'dong'de'da'di	0
贝尔卑	bei'er'bei	0
贝尔卑都市中心	bei'er'bei'dou'shi'zhong'xin	0
被践踏的草原	bei'jian'ta'de'cao'yuan	0
背叛	bei'pan	0
悲伤之地	bei'shang'zhi'di	0
鞭子	bian'zi	0
冰冷的手术室	bing'leng'de'shou'shu'shi	0
布拉哈	bu'la'ha	0
不一样的东西	bu'yi'yang'de'dong'xi	0
草药生长的地方	cao'yao'sheng'zhang'de'di'fang	0
赤红废墟	chi'hong'fei'xu	0
船之坟墓	chuan'zhi'fen'mu	0
锤盾	chui'dun	0
大海的香气	da'hai'de'xiang'qi	0
大剑	da'jian	0
呆梨	dai'li	0
黛莉雅	dai'li'ya	0
单手锤	dan'shou'chui	0
单手剑	dan'shou'jian	0
刀拉	dao'la	0
岛内遗迹	dao'nei'yi'ji	0
地板琳	di'ban'lin	0
地下水路暗室	di'xia'shui'lu'an'shi	0
地狱之厨房	di'yu'zhi'chu'fang	0
地震术士扎卡隆	di'zhen'shu'shi'zha'ka'long	0
调查	diao'cha	0
斗争之塔	dou'zheng'zhi'ta	0
盾娘	dun'niang	0
盾牌	dun'pai	0
法杖	fa'zhang	0
梵赛诺	fan'sai'nuo	0
梵赛诺半山腰	fan'sai'nuo'ban'shan'yao	0
梵赛诺顶峰	fan'sai'nuo'ding'feng	0
梵赛诺入口	fan'sai'nuo'ru'kou	0
梵赛诺山脚	fan'sai'nuo'shan'jiao	0
菲欧娜	fei'ou'na	0
废墟上的噩梦	fei'xu'shang'de'e'meng	0
辅佐官萨米尔	fu'zuo'guan'sa'mi'er	0
敢死队	gan'si'dui	0
钢铁姆斯佩	gang'tie'mu'si'pei	0
高级骑士贝努坎	gao'ji'qi'shi'bei'nu'kan	0
格雷	ge'lei	0
弓凯	gong'kai	0
古代格里斯贝恩	gu'dai'ge'li'si'bei'en	0
光耀者	guang'yao'zhe	0
哈胖	ha'pang	0
哈维登特	ha'wei'deng'te	0
海公公	hai'gong'gong	0
海基	hai'ji	0
侯爵马尔基奥	hou'jue'ma'er'ji'ao	0
猴子	hou'zi	0
花伞	hua'san	0
唤醒的恐怖	huan'xing'de'kong'bu	0
毁灭之爪	hui'mie'zhi'zhao	0
回忆的开端	hui'yi'de'kai'duan	0
霍克	huo'ke	0
火烧库汉	huo'shao'ku'han	0
寂寞之刃	ji'mo'zhi'ren	0
剑盾	jian'dun	0
结果实的树	jie'guo'shi'de'shu	0
解救	jie'jiu	0
经过漫长的黑暗	jing'guo'man'chang'de'hei'an	0
救援邀请	jiu'yuan'yao'qing	0
巨盾	ju'dun	0
巨剑	ju'jian	0
巨角雪人	ju'jiao'xue'ren	0
巨型食人魔	ju'xing'shi'ren'mo	0
抉择的瞬间	jue'ze'de'shun'jian	0
卡里图斯	ka'li'tu'si	0
卡鲁	ka'lu	0
凯伊	kai'yi	0
凯子	kai'zi	0
克里特指挥官	ke'li'te'zhi'hui'guan	0
渴望女王	ke'wang'nv'wang	0
库汉	ku'han	0
哭泣的花园	ku'qi'de'hua'yuan	0
哭泣的灵魂	ku'qi'de'ling'hun	0
狂乱	kuang'luan	0
傀儡阿格兰	kui'lei'a'ge'lan	0
雷吉纳	lei'ji'na	0
利斯塔	li'si'ta	0
镰刀	lian'dao	0
镰刀娘	lian'dao'niang	0
链刃	lian'ren	0
链子	lian'zi	0
烈士塔	lie'shi'ta	0
烈士躺	lie'shi'tang	0
灵魂的缺失	ling'hun'de'que'shi	0
另一个仓库	ling'yi'ge'cang'ku	0
流逝的记忆	liu'shi'de'ji'yi	0
龙刃	long'ren	0
鲁拉巴达	lu'la'ba'da	0
鲁帕奇图斯	lu'pa'qi'tu'si	0
罗霍兰平原	luo'huo'lan'ping'yuan	0
罗切斯特	luo'qie'si'te	0
玛赫	ma'he	0
芈璃	mi'li	0
秘密调查	mi'mi'diao'cha	0
秘密房间	mi'mi'fang'jian	0
秘密通道	mi'mi'tong'dao	0
迷失精灵	mi'shi'jing'ling	0
迷雾峰	mi'wu'feng	0
缪尔	miu'er	0
魔鞭	mo'bian	0
莫勒班	mo'le'ban	0
魔能左轮	mo'neng'zuo'lun	0
魔刃	mo'ren	0
魔族头领	mo'zu'tou'ling	0
木木天下第一	mu'mu'tian'xia'di'yi	0
内文	nei'wen	0
逆刃剑	ni'ren'jian	0
扭曲的真实	niu'qu'de'zhen'shi	0
女大剑	nv'da'jian	0
女君主莫纳尔卡	nv'jun'zhu'mo'na'er'ka	0
女族长克耶鲁	nv'zu'zhang'ke'ye'lu	0
炮鲁	pao'lu	0
破败的莫勒班	po'bai'de'mo'le'ban	0
破坏的化身	po'huai'de'hua'shen	0
枪戟	qiang'ji	0
枪剑	qiang'jian	0
枪凯	qiang'kai	0
枪琳	qiang'lin	0
拳鲁	quan'lu	0
拳炮	quan'pao	0
拳刃	quan'ren	0
萨尔丹	sa'er'dan	0
伞琳	san'lin	0
森林遗址	sen'lin'yi'zhi	0
沙漠公主	sha'mo'gong'zhu	0
审判官巴库郎	shen'pan'guan'ba'ku'lang	0
肾虚男	shen'xu'nan	0
深渊栖息者	shen'yuan'qi'xi'zhe	0
失败与代价	shi'bai'yu'dai'jia	0
时光的沙漠	shi'guang'de'sha'mo	0
时间守护者	shi'jian'shou'hu'zhe	0
逝者的遗物	shi'zhe'de'yi'wu	0
十字枪	shi'zi'qiang	0
首领的逃亡	shou'ling'de'tao'wang	0
受诅咒的船长	shou'zu'zhou'de'chuan'zhang	0
双剑	shuang'jian	0
双枪	shuang'qiang	0
双枪老太婆	shuang'qiang'lao'tai'po	0
死神	si'shen	0
碎片傀儡	sui'pian'kui'lei	0
痛苦与绝望	tong'ku'yu'jue'wang	0
图拉汗	tu'la'han	0
屠戮之月	tu'lu'zhi'yue	0
图内加	tu'nei'jia	0
外面的世界太危险	wai'mian'de'shi'jie'tai'wei'xian	0
王木木	wang'mu'mu	0
维拉	wei'la	0
乌鲁库	wu'lu'ku	0
想要相信什么	xiang'yao'xiang'xin'shen'me	0
小姨子	xiao'yi'zi	0
邪念之害	xie'nian'zhi'hai	0
新月岛	xin'yue'dao	0
雪人首领	xue'ren'shou'ling	0
寻求支援	xun'qiu'zhi'yuan	0
亚凡狂欢	ya'fan'kuang'huan	0
野生植物栽培地	ye'sheng'zhi'wu'zai'pei'di	0
一定要赢的战役	yi'ding'yao'ying'de'zhan'yi	0
伊菲	yi'fei	0
已经开始的命运	yi'jing'kai'shi'de'ming'yun	0
伊克利恩	yi'ke'li'en	0
阴凉森林	yin'liang'sen'lin	0
幽灵短剑	you'ling'duan'jian	0
援助之手	yuan'zhu'zhi'shou	0
约哈德	yue'ha'de	0
月下神殿	yue'xia'shen'dian	0
战镰	zhan'lian	0
战柱	zhan'zhu	0
杖娘	zhang'niang	0
掌玺	zhang'xi	0
找不到的路	zhao'bu'dao'de'lu	0
真实下的黑暗	zhen'shi'xia'de'hei'an	0
只有一次的人生	zhi'you'yi'ci'de'ren'sheng	0
中央庭院	zhong'yang'ting'yuan	0
柱鲁	zhu'lu	0
最后的碎片	zui'hou'de'sui'pian	0
