按法以传	an'fa'yi'chuan	0
安国保祚	an'guo'bao'zuo	0
安国长存	an'guo'chang'cun	0
安国存种民	an'guo'cun'zhong'min	0
安国宁家	an'guo'ning'jia	0
安国祚而方隆	an'guo'zuo'er'fang'long	0
安宁神器	an'ning'shen'qi	0
安神镇灵	an'shen'zhen'ling	0
安镇存国	an'zhen'cun'guo	0
安镇五灵	an'zhen'wu'ling	0
八海大神	ba'hai'da'shen	0
八节之日	ba'jie'zhi'ri	0
拔领太虚	ba'ling'tai'xu	0
八念家中大小	ba'nian'jia'zhong'da'xiao	0
八威七传	ba'wei'qi'chuan	0
八为治民	ba'wei'zhi'min	0
八者其德如神人	ba'zhe'qi'de'ru'shen'ren	0
八者羣乌翔舞	ba'zhe'qun'wu'xiang'wu	0
八者所在住止	ba'zhe'suo'zai'zhu'zhi	0
八者五帝所举	ba'zhe'wu'di'suo'ju	0
八者与天地结亲	ba'zhe'yu'tian'di'jie'qin	0
八者紫云吐晖	ba'zhe'zi'yun'tu'hui	0
白帝鬼魔远舍六万里	bai'di'gui'mo'yuan'she'liu'wan'li	0
白帝七门	bai'di'qi'men	0
白帝受此文以镇西岳	bai'di'shou'ci'wen'yi'zhen'xi'yue	0
白帝行佩此文	bai'di'xing'pei'ci'wen	0
白帝用事	bai'di'yong'shi	0
白帝真人下世	bai'di'zhen'ren'xia'shi	0
百官受会	bai'guan'shou'hui	0
百官收炁	bai'guan'shou'qi	0
白鹄	bai'hu	0
白虎游庭	bai'hu'you'ting	0
百六乘九	bai'liu'cheng'jiu	0
白龙衔芝草而启腾	bai'long'xian'zhi'cao'er'qi'teng	0
白鸾飞呜	bai'luan'fei'wu	0
白炁否	bai'qi'fou	0
白炁食	bai'qi'shi	0
百千万亿亿亿万万	bai'qian'wan'yi'yi'yi'wan'wan	0
百千万种	bai'qian'wan'zhong	0
百千万重道气	bai'qian'wan'zhong'dao'qi	0
白日升天	bai'ri'sheng'tian	0
白石峨峨	bai'shi'e'e	0
白书赤缯	bai'shu'chi'zeng	0
白书黑缯佩身	bai'shu'hei'zeng'pei'shen	0
白书黄缯三寸佩身	bai'shu'huang'zeng'san'cun'pei'shen	0
宝北方黑帝治九九大运交	bao'bei'fang'hei'di'zhi'jiu'jiu'da'yun'jiao	0
保地于元根	bao'di'yu'yuan'gen	0
宝东方青帝治九九八十一周	bao'dong'fang'qing'di'zhi'jiu'jiu'ba'shi'yi'zhou	0
抱而卧	bao'er'wo	0
保固元祚	bao'gu'yuan'zuo	0
保国宁家	bao'guo'ning'jia	0
保和始生于九玄之阿	bao'he'shi'sheng'yu'jiu'xuan'zhi'a	0
保劫运于天机	bao'jie'yun'yu'tian'ji	0
保命度	bao'ming'du	0
宝南方赤帝治九天运周	bao'nan'fang'chi'di'zhi'jiu'tian'yun'zhou	0
保羣命以永安	bao'qun'ming'yi'yong'an	0
保天长生	bao'tian'chang'sheng	0
保天地以长存	bao'tian'di'yi'chang'cun	0
宝西方白帝	bao'xi'fang'bai'di	0
宝中央黄帝治九九运终	bao'zhong'yang'huang'di'zhi'jiu'jiu'yun'zhong	0
北部刺奸	bei'bu'ci'jian	0
北辰辅肾	bei'chen'fu'shen	0
北方洞阴朔单郁绝	bei'fang'dong'yin'shuo'dan'yu'jue	0
北方洞阴朔单郁绝五灵玄老	bei'fang'dong'yin'shuo'dan'yu'jue'wu'ling'xuan'lao	0
北方黑帝灵宝赤书玉篇	bei'fang'hei'di'ling'bao'chi'shu'yu'pian	0
北方五黑玄天	bei'fang'wu'hei'xuan'tian	0
北方五炁玄天	bei'fang'wu'qi'xuan'tian	0
北方凶勃恶兽毒螫皆不生害心	bei'fang'xiong'bo'e'shou'du'shi'jie'bu'sheng'hai'xin	0
北方玄天	bei'fang'xuan'tian	0
北方自宾	bei'fang'zi'bin	0
北酆	bei'feng	0
北酆三官	bei'feng'san'guan	0
北酆所部	bei'feng'suo'bu	0
北极真公	bei'ji'zhen'gong	0
北山神咒	bei'shan'shen'zhou	0
北上玉山阴元台	bei'shang'yu'shan'yin'yuan'tai	0
北摄酆山	bei'she'feng'shan	0
备守八门	bei'shou'ba'men	0
本命某辰	ben'ming'mou'chen	0
奔蛇击剑	ben'she'ji'jian	0
碧霞郁垒	bi'xia'yu'lei	0
璧总七星	bi'zong'qi'xing	0
边域不争	bian'yu'bu'zheng	0
表裹明鲜	biao'guo'ming'xian	0
表见玄虚	biao'jian'xuan'xu	0
表明灵文	biao'ming'ling'wen	0
并本命日朱书	bing'ben'ming'ri'zhu'shu	0
兵病并行	bing'bing'bing'xing	0
兵不兴	bing'bu'xing	0
并乘五色琼轮	bing'cheng'wu'se'qiong'lun	0
并得道人名	bing'de'dao'ren'ming	0
兵火息止	bing'huo'xi'zhi	0
并起成人	bing'qi'cheng'ren	0
禀液于五英之关	bing'ye'yu'wu'ying'zhi'guan	0
并依五方色书之	bing'yi'wu'fang'se'shu'zhi	0
兵灾荡民	bing'zai'dang'min	0
兵灾流行	bing'zai'liu'xing	0
兵灾驱除	bing'zai'qu'chu	0
不得便传	bu'de'bian'chuan	0
不得怠纵	bu'de'dai'zong	0
不得窥闻	bu'de'kui'wen	0
不得轻泄	bu'de'qing'xie	0
不犯禁忌	bu'fan'jin'ji	0
不犯经戒	bu'fan'jing'jie	0
不犯科禁	bu'fan'ke'jin	0
不犯科律	bu'fan'ke'lv	0
不教自行	bu'jiao'zi'xing	0
不可寻详	bu'ke'xun'xiang	0
簿录年命筭籍	bu'lu'nian'ming'suan'ji	0
不免三涂五苦之中	bu'mian'san'tu'wu'ku'zhi'zhong	0
不审灵宝五篇玉文	bu'shen'ling'bao'wu'pian'yu'wen	0
不生害心	bu'sheng'hai'xin	0
不受众横	bu'shou'zhong'heng	0
不暑不冰	bu'shu'bu'bing	0
不死之药	bu'si'zhi'yao	0
不行凡庶	bu'xing'fan'shu	0
不欲离身形须臾尔	bu'yu'li'shen'xing'xu'yu'er	0
采流霞于上宫	cai'liu'xia'yu'shang'gong	0
参总斗魁	can'zong'dou'kui	0
苍龙来翔	cang'long'lai'xiang	0
察校学士兆民功过轻重	cha'xiao'xue'shi'zhao'min'gong'guo'qing'zhong	0
长保家国	chang'bao'jia'guo	0
常驾白龙	chang'jia'bai'long	0
常驾苍龙	chang'jia'cang'long	0
常驾丹龙	chang'jia'dan'long	0
常驾黑龙	chang'jia'hei'long	0
常驾黄龙	chang'jia'huang'long	0
长生司马	chang'sheng'si'ma	0
长为真人	chang'wei'zhen'ren	0
长为种民	chang'wei'zhong'min	0
长为罪民	chang'wei'zui'min	0
常以春分之日	chang'yi'chun'fen'zhi'ri	0
常以冬至之日	chang'yi'dong'zhi'zhi'ri	0
常以庚申日	chang'yi'geng'shen'ri	0
常以甲子日	chang'yi'jia'zi'ri	0
常以立春之日	chang'yi'li'chun'zhi'ri	0
常以立冬之日	chang'yi'li'dong'zhi'ri	0
常以立秋之日	chang'yi'li'qiu'zhi'ri	0
常以立夏之日	chang'yi'li'xia'zhi'ri	0
常以秋分之日	chang'yi'qiu'fen'zhi'ri	0
常以随身	chang'yi'sui'shen	0
常以夏至之日	chang'yi'xia'zhi'zhi'ri	0
常以月八日	chang'yi'yue'ba'ri	0
常以月二十八日	chang'yi'yue'er'shi'ba'ri	0
常以月二十九日	chang'yi'yue'er'shi'jiu'ri	0
常以月二十三日	chang'yi'yue'er'shi'san'ri	0
常以月二十四日	chang'yi'yue'er'shi'si'ri	0
常以月三十日	chang'yi'yue'san'shi'ri	0
常以月十八日	chang'yi'yue'shi'ba'ri	0
常以月十四日	chang'yi'yue'shi'si'ri	0
常以月十五日	chang'yi'yue'shi'wu'ri	0
常以月一日	chang'yi'yue'yi'ri	0
常与神明相当	chang'yu'shen'ming'xiang'dang	0
长斋百日	chang'zhai'bai'ri	0
长斋修行二十四年	chang'zhai'xiu'xing'er'shi'si'nian	0
朝礼天文	chao'li'tian'wen	0
朝礼玉庭	chao'li'yu'ting	0
朝庆天真	chao'qing'tian'zhen	0
超羣萃而凌盻	chao'qun'cui'er'ling'pan	0
朝卫灵文于玉山之中	chao'wei'ling'wen'yu'yu'shan'zhi'zhong	0
臣过承未天之先	chen'guo'cheng'wei'tian'zhi'xian	0
晨鸡启旦	chen'ji'qi'dan	0
沉尸飞魂	chen'shi'fei'hun	0
辰戌丑未之年	chen'xu'chou'wei'zhi'nian	0
乘白龙	cheng'bai'long	0
乘崩山之坠虎	cheng'beng'shan'zhi'zhui'hu	0
乘地轴之辇	cheng'di'zhou'zhi'nian	0
乘黄龙	cheng'huang'long	0
乘机应会	cheng'ji'ying'hui	0
承炁捕非	cheng'qi'bu'fei	0
澄清高虚	cheng'qing'gao'xu	0
乘青龙	cheng'qing'long	0
成生五行	cheng'sheng'wu'xing	0
承师某帝某甲元始之章	cheng'shi'mou'di'mou'jia'yuan'shi'zhi'zhang	0
成天广覆	cheng'tian'guang'fu	0
成天立地	cheng'tian'li'di	0
称为真人	cheng'wei'zhen'ren	0
乘玄龙	cheng'xuan'long	0
骋云辇于虚无	cheng'yun'nian'yu'xu'wu	0
乘云虬以启真	cheng'yun'qiu'yi'qi'zhen	0
赤帝鬼魔远舍八万里	chi'di'gui'mo'yuan'she'ba'wan'li	0
勑地祇营护	chi'di'qi'ying'hu	0
赤帝神人乘朱凤	chi'di'shen'ren'cheng'zhu'feng	0
赤帝受此文以镇南岳	chi'di'shou'ci'wen'yi'zhen'nan'yue	0
赤帝行佩此文度其灾	chi'di'xing'pei'ci'wen'du'qi'zai	0
赤帝用事	chi'di'yong'shi	0
赤帝玉堂	chi'di'yu'tang	0
赤帝真人下世	chi'di'zhen'ren'xia'shi	0
持戒朝礼	chi'jie'chao'li	0
赤炁否	chi'qi'fou	0
赤炁食	chi'qi'shi	0
敕摄北帝	chi'she'bei'di	0
赤书符命	chi'shu'fu'ming	0
赤书黑缯	chi'shu'hei'zeng	0
赤书黄缯上佩身	chi'shu'huang'zeng'shang'pei'shen	0
赤书所告	chi'shu'suo'gao	0
赤书玉字	chi'shu'yu'zi	0
赤文命灵	chi'wen'ming'ling	0
赤文玉书	chi'wen'yu'shu	0
勑下地官营卫佑护	chi'xia'di'guan'ying'wei'you'hu	0
勑下三界神灵侍卫	chi'xia'san'jie'shen'ling'shi'wei	0
鯈欻之间	chou'chua'zhi'jian	0
出白帝真文篇	chu'bai'di'zhen'wen'pian	0
出赤帝下元符命	chu'chi'di'xia'yuan'fu'ming	0
出赤帝真文篇	chu'chi'di'zhen'wen'pian	0
出此文玄都宫	chu'ci'wen'xuan'du'gong	0
出此文以度学者人身	chu'ci'wen'yi'du'xue'zhe'ren'shen	0
出此文以固天炁	chu'ci'wen'yi'gu'tian'qi	0
出此下元符	chu'ci'xia'yuan'fu	0
出黑帝真文篇	chu'hei'di'zhen'wen'pian	0
出黄帝真文篇	chu'huang'di'zhen'wen'pian	0
出灵宝白帝上元符命	chu'ling'bao'bai'di'shang'yuan'fu'ming	0
出灵宝白帝下元符命	chu'ling'bao'bai'di'xia'yuan'fu'ming	0
出灵宝白帝中元符命	chu'ling'bao'bai'di'zhong'yuan'fu'ming	0
出灵宝赤帝上元符命	chu'ling'bao'chi'di'shang'yuan'fu'ming	0
出灵宝赤帝下元符命	chu'ling'bao'chi'di'xia'yuan'fu'ming	0
出灵宝赤帝中元符命	chu'ling'bao'chi'di'zhong'yuan'fu'ming	0
出灵宝黑帝上元符命	chu'ling'bao'hei'di'shang'yuan'fu'ming	0
出灵宝黑帝下元符命	chu'ling'bao'hei'di'xia'yuan'fu'ming	0
出灵宝黑帝中元符命	chu'ling'bao'hei'di'zhong'yuan'fu'ming	0
出灵宝黄帝上元符命	chu'ling'bao'huang'di'shang'yuan'fu'ming	0
出灵宝黄帝下元符命	chu'ling'bao'huang'di'xia'yuan'fu'ming	0
出灵宝黄帝中元符命	chu'ling'bao'huang'di'zhong'yuan'fu'ming	0
出灵宝青帝上元符命	chu'ling'bao'qing'di'shang'yuan'fu'ming	0
出灵宝青帝下元符命	chu'ling'bao'qing'di'xia'yuan'fu'ming	0
出灵宝青帝中元符命	chu'ling'bao'qing'di'zhong'yuan'fu'ming	0
出青帝真文篇	chu'qing'di'zhen'wen'pian	0
出入民问	chu'ru'min'wen	0
出入行来	chu'ru'xing'lai	0
出入游行	chu'ru'you'xing	0
出下元符命	chu'xia'yuan'fu'ming	0
出玄都紫微宫上元格中	chu'xuan'du'zi'wei'gong'shang'yuan'ge'zhong	0
出玄都紫微宫下元格中	chu'xuan'du'zi'wei'gong'xia'yuan'ge'zhong	0
出玄都紫微官中元格中	chu'xuan'du'zi'wei'guan'zhong'yuan'ge'zhong	0
出郁单无量玄元紫微台北轩之书	chu'yu'dan'wu'liang'xuan'yuan'zi'wei'tai'bei'xuan'zhi'shu	0
出于空洞自然之中	chu'yu'kong'dong'zi'ran'zhi'zhong	0
处于上天之中	chu'yu'shang'tian'zhi'zhong	0
出元始赤书玉篇真文灵宝上经	chu'yuan'shi'chi'shu'yu'pian'zhen'wen'ling'bao'shang'jing	0
出元始青明上光气后赤书四劫	chu'yuan'shi'qing'ming'shang'guang'qi'hou'chi'shu'si'jie	0
出元始通景玄光气后赤书五劫	chu'yuan'shi'tong'jing'xuan'guang'qi'hou'chi'shu'wu'jie	0
垂覆八方	chui'fu'ba'fang	0
垂荫福流	chui'yin'fu'liu	0
垂荫弥覆十天	chui'yin'mi'fu'shi'tian	0
此白帝大阳九	ci'bai'di'da'yang'jiu	0
此赤帝大阳九	ci'chi'di'da'yang'jiu	0
此大宗之业	ci'da'zong'zhi'ye	0
此二符	ci'er'fu	0
此法运讫	ci'fa'yun'qi	0
此符一名化形券	ci'fu'yi'ming'hua'xing'quan	0
此黑帝大阳九	ci'hei'di'da'yang'jiu	0
此黄帝大阳九	ci'huang'di'da'yang'jiu	0
此是赤精受天炁后	ci'shi'chi'jing'shou'tian'qi'hou	0
此十二报	ci'shi'er'bao	0
此天炁勃于火宫	ci'tian'qi'bo'yu'huo'gong	0
此天炁激于金宫	ci'tian'qi'ji'yu'jin'gong	0
此文固天三元之炁	ci'wen'gu'tian'san'yuan'zhi'qi	0
此文皆书北单郁绝元之台	ci'wen'jie'shu'bei'dan'yu'jue'yuan'zhi'tai	0
此文皆题九天金阙三图之绾	ci'wen'jie'ti'jiu'tian'jin'que'san'tu'zhi'wan	0
此文皆题玄都之台四壁也	ci'wen'jie'ti'xuan'du'zhi'tai'si'bi'ye	0
此文以度学者人身	ci'wen'yi'du'xue'zhe'ren'shen	0
此一十二念	ci'yi'shi'er'nian	0
此元始之玄根	ci'yuan'shi'zhi'xuan'gen	0
此则白帝小阳九	ci'ze'bai'di'xiao'yang'jiu	0
此则赤帝小阳九	ci'ze'chi'di'xiao'yang'jiu	0
此则黑帝小阳九	ci'ze'hei'di'xiao'yang'jiu	0
此则黄帝小阳九	ci'ze'huang'di'xiao'yang'jiu	0
此至真之文	ci'zhi'zhen'zhi'wen	0
从六丙六丁	cong'liu'bing'liu'ding	0
从神丙丁官将三十万人	cong'shen'bing'ding'guan'jiang'san'shi'wan'ren	0
从神庚辛官将七十万人	cong'shen'geng'xin'guan'jiang'qi'shi'wan'ren	0
从神甲乙官将九十万人	cong'shen'jia'yi'guan'jiang'jiu'shi'wan'ren	0
从神壬癸官将五十万人	cong'shen'ren'gui'guan'jiang'wu'shi'wan'ren	0
从神戊己官将十二万人	cong'shen'wu'ji'guan'jiang'shi'er'wan'ren	0
从五帝神仙	cong'wu'di'shen'xian	0
催运上炁	cui'yun'shang'qi	0
存之者不终	cun'zhi'zhe'bu'zhong	0
存浊炁于口	cun'zhuo'qi'yu'kou	0
大百六	da'bai'liu	0
大百六丑未	da'bai'liu'chou'wei	0
大百六卯	da'bai'liu'mao	0
大百六午	da'bai'liu'wu	0
大百六酉	da'bai'liu'you	0
大百六子	da'bai'liu'zi	0
大慈之德	da'ci'zhi'de	0
大劫辰戌	da'jie'chen'xu	0
大劫洪灾	da'jie'hong'zai	0
大劫洪灾之数	da'jie'hong'zai'zhi'shu	0
大劫交周	da'jie'jiao'zhou	0
大劫午运周	da'jie'wu'yun'zhou	0
大劫酉	da'jie'you	0
大劫之交	da'jie'zhi'jiao	0
大劫终	da'jie'zhong	0
大劫子	da'jie'zi	0
大神等	da'shen'deng	0
大小百六	da'xiao'bai'liu	0
大小百六天地运度	da'xiao'bai'liu'tian'di'yun'du	0
大小劫会之灾	da'xiao'jie'hui'zhi'zai	0
大阳九辰戌	da'yang'jiu'chen'xu	0
大阳九大百六	da'yang'jiu'da'bai'liu	0
大阳九亥	da'yang'jiu'hai	0
大阳九申	da'yang'jiu'shen	0
大阳九巳	da'yang'jiu'si	0
大阳九寅	da'yang'jiu'yin	0
大有之文	da'you'zhi'wen	0
大运交	da'yun'jiao	0
大运交会	da'yun'jiao'hui	0
大哉灵宝	da'zai'ling'bao	0
大灾涌水	da'zai'yong'shui	0
丹笔书文	dan'bi'shu'wen	0
但精心躬奉	dan'jing'xin'gong'feng	0
丹灵南极真人	dan'ling'nan'ji'zhen'ren	0
但佩此文	dan'pei'ci'wen	0
丹书白素	dan'shu'bai'su	0
丹台老子	dan'tai'lao'zi	0
当白笔书	dang'bai'bi'shu	0
当赤书青石上	dang'chi'shu'qing'shi'shang	0
当此日	dang'ci'ri	0
当此之时	dang'ci'zhi'shi	0
当此之月	dang'ci'zhi'yue	0
荡荡大化	dang'dang'da'hua	0
荡荡无碍	dang'dang'wu'ai	0
当灵宝大斋之日	dang'ling'bao'da'zhai'zhi'ri	0
当录于上馆	dang'lu'yu'shang'guan	0
当其斋日	dang'qi'zhai'ri	0
当有三万六千种道	dang'you'san'wan'liu'qian'zhong'dao	0
当朱笔书文	dang'zhu'bi'shu'wen	0
当朱书白石上	dang'zhu'shu'bai'shi'shang	0
当朱书赤石上	dang'zhu'shu'chi'shi'shang	0
当朱书黑石上	dang'zhu'shu'hei'shi'shang	0
当朱书黄石上	dang'zhu'shu'huang'shi'shang	0
道报自然	dao'bao'zi'ran	0
道成德满	dao'cheng'de'man	0
道德日隆	dao'de'ri'long	0
道德丈人	dao'de'zhang'ren	0
道乃行焉	dao'nai'xing'yan	0
道气丈人	dao'qi'zhang'ren	0
道士命属北岳	dao'shi'ming'shu'bei'yue	0
道士命属东岳	dao'shi'ming'shu'dong'yue	0
道士命属南岳	dao'shi'ming'shu'nan'yue	0
道士命属西岳	dao'shi'ming'shu'xi'yue	0
道士命属中岳	dao'shi'ming'shu'zhong'yue	0
道士书文置北方	dao'shi'shu'wen'zhi'bei'fang	0
道士书文置南方	dao'shi'shu'wen'zhi'nan'fang	0
道士书文置西方	dao'shi'shu'wen'zhi'xi'fang	0
道士书文置中央	dao'shi'shu'wen'zhi'zhong'yang	0
道士所以偏得佩此文者	dao'shi'suo'yi'pian'de'pei'ci'wen'zhe	0
道士吞之	dao'shi'tun'zhi	0
道士隐学	dao'shi'yin'xue	0
道士欲尸解者	dao'shi'yu'shi'jie'zhe	0
叨受开明之司	dao'shou'kai'ming'zhi'si	0
导五气以育民	dao'wu'qi'yi'yu'min	0
悼运流迁	dao'yun'liu'qian	0
道在则尊	dao'zai'ze'zun	0
道中之道	dao'zhong'zhi'dao	0
德报自然	de'bao'zi'ran	0
德感天真	de'gan'tian'zhen	0
德冠诸天	de'guan'zhu'tian	0
得过太阳九	de'guo'tai'yang'jiu	0
得见太平	de'jian'tai'ping	0
得见真君	de'jian'zhen'jun	0
得佩此符	de'pei'ci'fu	0
得佩此文	de'pei'ci'wen	0
得为真人	de'wei'zhen'ren	0
得为种民	de'wei'zhong'min	0
登命五老上真	deng'ming'wu'lao'shang'zhen	0
地保山岳于句芒	di'bao'shan'yue'yu'gou'mang	0
地发二十四应	di'fa'er'shi'si'ying	0
氐房心尾	di'fang'xin'wei	0
地号之宝	di'hao'zhi'bao	0
地灵神鬼之事	di'ling'shen'gui'zhi'shi	0
地秘之以致安	di'mi'zhi'yi'zhi'an	0
地祇侍卫	di'qi'shi'wei	0
地祇所仰	di'qi'suo'yang	0
地上地下	di'shang'di'xia	0
地上莫不振肃	di'shang'mo'bu'zhen'su	0
地上神祇	di'shang'shen'qi	0
地上神祇莫不振肃	di'shang'shen'qi'mo'bu'zhen'su	0
地神奉迎	di'shen'feng'ying	0
地神营护	di'shen'ying'hu	0
地神直卫	di'shen'zhi'wei	0
地司奏人善功	di'si'zou'ren'shan'gong	0
帝图刻简	di'tu'ke'jian	0
地无五文	di'wu'wu'wen	0
地藏发泄	di'zang'fa'xie	0
典录玄图	dian'lu'xuan'tu	0
洞达无穷	dong'da'wu'qiong	0
东方安宝华林	dong'fang'an'bao'hua'lin	0
东方安宝华林青灵始老	dong'fang'an'bao'hua'lin'qing'ling'shi'lao	0
东方安宝华林青灵始老君符命	dong'fang'an'bao'hua'lin'qing'ling'shi'lao'jun'fu'ming	0
东方九气	dong'fang'jiu'qi	0
东方九炁青天	dong'fang'jiu'qi'qing'tian	0
东方青帝灵宝赤书玉篇	dong'fang'qing'di'ling'bao'chi'shu'yu'pian	0
东极老人	dong'ji'lao'ren	0
东山神咒	dong'shan'shen'zhou	0
东王公	dong'wang'gong	0
冬夏生华	dong'xia'sheng'hua	0
洞玄弟子某岳先生女人	dong'xuan'di'zi'mou'yue'xian'sheng'nv'ren	0
洞阳气赤	dong'yang'qi'chi	0
洞阳太灵君	dong'yang'tai'ling'jun	0
洞映上清	dong'ying'shang'qing	0
斗牛卫扉	dou'niu'wei'fei	0
度得道之人	du'de'dao'zhi'ren	0
度洪流大水之灾	du'hong'liu'da'shui'zhi'zai	0
度洪灾	du'hong'zai	0
度会亦如之	du'hui'yi'ru'zhi	0
度甲申大水洪灾	du'jia'shen'da'shui'hong'zai	0
度九人以补仙官	du'jiu'ren'yi'bu'xian'guan	0
度七人以补仙官	du'qi'ren'yi'bu'xian'guan	0
度三人以补仙官	du'san'ren'yi'bu'xian'guan	0
度十二人以补仙官	du'shi'er'ren'yi'bu'xian'guan	0
度五人以补仙官	du'wu'ren'yi'bu'xian'guan	0
度凶厄于穷年	du'xiong'e'yu'qiong'nian	0
度学者身	du'xue'zhe'shen	0
度学者之身	du'xue'zhe'zhi'shen	0
度阳九百六之会	du'yang'jiu'bai'liu'zhi'hui	0
覩阳于冥感之魂	du'yang'yu'ming'gan'zhi'hun	0
遏塞鬼门	e'sai'gui'men	0
厄中得免	e'zhong'de'mian	0
恩润覆护	en'run'fu'hu	0
二符	er'fu	0
尔乃凤舞景汉	er'nai'feng'wu'jing'han	0
尔乃虹步八域	er'nai'hong'bu'ba'yu	0
尔乃龙眄空洞	er'nai'long'mian'kong'dong	0
尔乃鹏举九遐	er'nai'peng'ju'jiu'xia	0
二念道尊德贵	er'nian'dao'zun'de'gui	0
二篇德福二十八条	er'pian'de'fu'er'shi'ba'tiao	0
二篇施恩置功二十六条	er'pian'shi'en'zhi'gong'er'shi'liu'tiao	0
二篇施念获报二十四条	er'pian'shi'nian'huo'bao'er'shi'si'tiao	0
而其文保固天根	er'qi'wen'bao'gu'tian'gen	0
二十二者天震地裂	er'shi'er'zhe'tian'zhen'di'lie	0
二十三者地生莲华	er'shi'san'zhe'di'sheng'lian'hua	0
二十四神人君	er'shi'si'shen'ren'jun	0
二十四神人丈人	er'shi'si'shen'ren'zhang'ren	0
二十四者五岳洞开	er'shi'si'zhe'wu'yue'dong'kai	0
二十一者地藏发泄	er'shi'yi'zhe'di'zang'fa'xie	0
二十者妇女怀妊	er'shi'zhe'fu'nv'huai'ren	0
二为子孙	er'wei'zi'sun	0
二仪待之以分	er'yi'dai'zhi'yi'fen	0
而有一十二报	er'you'yi'shi'er'bao	0
二者名声远着	er'zhe'ming'sheng'yuan'zhe	0
二者其德如虚元	er'zhe'qi'de'ru'xu'yuan	0
二者三万六千日月	er'zhe'san'wan'liu'qian'ri'yue	0
二者是时二象分仪	er'zhe'shi'shi'er'xiang'fen'yi	0
二者万魔降伏	er'zhe'wan'mo'xiang'fu	0
二者致福却祸	er'zhe'zhi'fu'que'huo	0
发乎始青之天而色无定方	fa'hu'shi'qing'zhi'tian'er'se'wu'ding'fang	0
法化高大	fa'hua'gao'da	0
法教威严	fa'jiao'wei'yan	0
发自然天心	fa'zi'ran'tian'xin	0
犯恶为非	fan'e'wei'fei	0
反光华于万春	fan'guang'hua'yu'wan'chun	0
反枯朽而婴孩	fan'ku'xiu'er'ying'hai	0
反善仁人	fan'shan'ren'ren	0
凡是修斋持戒	fan'shi'xiu'zhai'chi'jie	0
反童稚而方升	fan'tong'zhi'er'fang'sheng	0
凡为学者	fan'wei'xue'zhe	0
反朝霞之始萌	fan'zhao'xia'zhi'shi'meng	0
返真仙于太微	fan'zhen'xian'yu'tai'wei	0
方五寸	fang'wu'cun	0
防阳九	fang'yang'jiu	0
方圆三千六百里中	fang'yuan'san'qian'liu'bai'li'zhong	0
非鬼神所闻	fei'gui'shen'suo'wen	0
飞空步虚	fei'kong'bu'xu	0
飞龙毒兽	fei'long'du'shou	0
非所如何	fei'suo'ru'he	0
飞呜邕邕	fei'wu'yong'yong	0
飞掀天端	fei'xian'tian'duan	0
飞香八凑	fei'xiang'ba'cou	0
奉此法	feng'ci'fa	0
凤凰来游	feng'huang'lai'you	0
风火无间	feng'huo'wu'jian	0
风火驿传	feng'huo'yi'chuan	0
奉戒持斋	feng'jie'chi'zhai	0
风洒兰林	feng'sa'lan'lin	0
封山呼云	feng'shan'hu'yun	0
奉修灵文	feng'xiu'ling'wen	0
封一通九灵洞室	feng'yi'tong'jiu'ling'dong'shi	0
封一通南霍之阿	feng'yi'tong'nan'huo'zhi'a	0
封一通于金穴九掖洞中	feng'yi'tong'yu'jin'xue'jiu'ye'dong'zhong	0
封一通于玄阴洞室	feng'yi'tong'yu'xuan'yin'dong'shi	0
奉斋朝天文	feng'zhai'chao'tian'wen	0
奉斋朝天真	feng'zhai'chao'tian'zhen	0
福报如之	fu'bao'ru'zhi	0
敷弘天元	fu'hong'tian'yuan	0
符即出	fu'ji'chu	0
符既出而死也	fu'ji'chu'er'si'ye	0
抚几高抗	fu'ji'gao'kang	0
覆校诸司廉察万民善恶	fu'jiao'zhu'si'lian'cha'wan'min'shan'e	0
符经并出	fu'jing'bing'chu	0
福禄光亨	fu'lu'guang'heng	0
抚念羣生	fu'nian'qun'sheng	0
福庆日隆	fu'qing'ri'long	0
福庆日升	fu'qing'ri'sheng	0
福庆日臻	fu'qing'ri'zhen	0
福庆无穷	fu'qing'wu'qiong	0
符水上龙	fu'shui'shang'long	0
符图经文	fu'tu'jing'wen	0
辅卫上真	fu'wei'shang'zhen	0
符檄所讨	fu'xi'suo'tao	0
敷演玄教	fu'yan'xuan'jiao	0
敷演玄义	fu'yan'xuan'yi	0
浮游五岳	fu'you'wu'yue	0
服云林之翠罗	fu'yun'lin'zhi'cui'luo	0
敢有干试	gan'you'gan'shi	0
敢有稽延	gan'you'ji'yan	0
高步长津	gao'bu'chang'jin	0
高上大圣众	gao'shang'da'sheng'zhong	0
高上玉帝	gao'shang'yu'di	0
告下三官神灵侍卫	gao'xia'san'guan'shen'ling'shi'wei	0
告下天神地祇侍卫营护	gao'xia'tian'shen'di'qi'shi'wei'ying'hu	0
各付一文安镇五岳	ge'fu'yi'wen'an'zhen'wu'yue	0
各遣天真威神	ge'qian'tian'zhen'wei'shen	0
革休灭而方清	ge'xiu'mie'er'fang'qing	0
各有所属	ge'you'suo'shu	0
给黄素玉女十二人	gei'huang'su'yu'nv'shi'er'ren	0
给青腰玉女九人	gei'qing'yao'yu'nv'jiu'ren	0
给太素玉女六人	gei'tai'su'yu'nv'liu'ren	0
给太玄玉女五人	gei'tai'xuan'yu'nv'wu'ren	0
给朱陵玉女八人	gei'zhu'ling'yu'nv'ba'ren	0
庚子之年	geng'zi'zhi'nian	0
功德未备	gong'de'wei'bei	0
功过轻重大小	gong'guo'qing'zhong'da'xiao	0
共集考校三官	gong'ji'kao'jiao'san'guan	0
功记三官五帝	gong'ji'san'guan'wu'di	0
共集推校日月星辰分度	gong'ji'tui'xiao'ri'yue'xing'chen'fen'du	0
共集校等人民禄命长短	gong'ji'xiao'deng'ren'min'lu'ming'chang'duan	0
共集校定	gong'ji'xiao'ding	0
功懋诸天	gong'mao'zhu'tian	0
功业轻重	gong'ye'qing'zhong	0
固地炁	gu'di'qi	0
故号赤书	gu'hao'chi'shu	0
固三景于玄根	gu'san'jing'yu'xuan'gen	0
故三元之炁	gu'san'yuan'zhi'qi	0
固天炁	gu'tian'qi	0
骨血分离	gu'xue'fen'li	0
故阳数之九谓之阳九	gu'yang'shu'zhi'jiu'wei'zhi'yang'jiu	0
鼓洋渊泽	gu'yang'yuan'ze	0
故曰灵宝	gu'yue'ling'bao	0
鼓云池而郁勃	gu'yun'chi'er'yu'bo	0
故斋戒存其检行	gu'zhai'jie'cun'qi'jian'xing	0
官号日太帝	guan'hao'ri'tai'di	0
观洪波于天际也	guan'hong'bo'yu'tian'ji'ye	0
官商相和	guan'shang'xiang'he	0
广度一切	guang'du'yi'qie	0
广覆无边	guang'fu'wu'bian	0
光颜灿然而还初	guang'yan'can'ran'er'hai'chu	0
光映于形外	guang'ying'yu'xing'wai	0
光暎于形外	guang'ying'yu'xing'wai	0
贵行标于高称	gui'hang'biao'yu'gao'cheng	0
鬼神随功进秩	gui'shen'sui'gong'jin'zhi	0
鬼神所畏	gui'shen'suo'wei	0
鬼神天人责役轻重之事	gui'shen'tian'ren'ze'yi'qing'zhong'zhi'shi	0
国安民盛	guo'an'min'sheng	0
国丰民富	guo'feng'min'fu	0
国富民丰	guo'fu'min'feng	0
过蒙玄师之宗	guo'meng'xuan'shi'zhi'zong	0
国宁民休	guo'ning'min'xiu	0
过水火之难	guo'shui'huo'zhi'nan	0
国土安	guo'tu'an	0
国土北方及冬三月有灾	guo'tu'bei'fang'ji'dong'san'yue'you'zai	0
国土东方及春三月有灾	guo'tu'dong'fang'ji'chun'san'yue'you'zai	0
国土南方及夏三月有灾	guo'tu'nan'fang'ji'xia'san'yue'you'zai	0
国土太平	guo'tu'tai'ping	0
国土西方及秋三月有灾	guo'tu'xi'fang'ji'qiu'san'yue'you'zai	0
国祚安宁	guo'zuo'an'ning	0
国祚享之以太平	guo'zuo'xiang'zhi'yi'tai'ping	0
海成血川	hai'cheng'xue'chuan	0
海底生尘	hai'di'sheng'chen	0
海底扬尘	hai'di'yang'chen	0
还冥夜于东陵	hai'ming'ye'yu'dong'ling	0
还乃更诣元始天尊	hai'nai'geng'yi'yuan'shi'tian'zun	0
还于上元之炁	hai'yu'shang'yuan'zhi'qi	0
亥子之年	hai'zi'zhi'nian	0
含淳和而弗华	han'chun'he'er'fu'hua	0
含而吞之	han'er'tun'zhi	0
寒条仰希华阳之繁	han'tiao'yang'xi'hua'yang'zhi'fan	0
号日苍帝	hao'ri'cang'di	0
号日赤帝	hao'ri'chi'di	0
号日黄帝	hao'ri'huang'di	0
好生君	hao'sheng'jun	0
号曰白帝	hao'yue'bai'di	0
号曰宝劫洞清九天灵书	hao'yue'bao'jie'dong'qing'jiu'tian'ling'shu	0
号曰赤皇	hao'yue'chi'huang	0
号曰黑帝	hao'yue'hei'di	0
号曰金真宝明洞微篇	hao'yue'jin'zhen'bao'ming'dong'wei'pian	0
号曰空浑赤书景皇真文	hao'yue'kong'hun'chi'shu'jing'huang'zhen'wen	0
号曰南云通天宝灵衿	hao'yue'nan'yun'tong'tian'bao'ling'jin	0
号曰生神宝真洞玄章	hao'yue'sheng'shen'bao'zhen'dong'xuan'zhang	0
号曰元神生真宝明文	hao'yue'yuan'shen'sheng'zhen'bao'ming'wen	0
禾不种自生	he'bu'zhong'zi'sheng	0
合封为策	he'feng'wei'ce	0
河海神灵	he'hai'shen'ling	0
禾稼摧折	he'jia'cui'zhe	0
禾稼丰熟	he'jia'feng'shu	0
禾稼伤死	he'jia'shang'si	0
何虑何忧	he'lv'he'you	0
合一百二十字	he'yi'bai'er'shi'zi	0
合一百三十六字	he'yi'bai'san'shi'liu'zi	0
合一百四十四字	he'yi'bai'si'shi'si'zi	0
合一百五十二字	he'yi'bai'wu'shi'er'zi	0
诃役三皇	he'yi'san'huang	0
黑帝鬼魔远舍五万里	hei'di'gui'mo'yuan'she'wu'wan'li	0
黑帝受此文以镇北岳	hei'di'shou'ci'wen'yi'zhen'bei'yue	0
黑帝行佩此文	hei'di'xing'pei'ci'wen	0
黑帝用事	hei'di'yong'shi	0
黑帝真人下世	hei'di'zhen'ren'xia'shi	0
黑炁否	hei'qi'fou	0
黑炁激	hei'qi'ji	0
黑炁食	hei'qi'shi	0
黑书黄缯	hei'shu'huang'zeng	0
黑书黄缯上	hei'shu'huang'zeng'shang	0
黑书木刀剑	hei'shu'mu'dao'jian	0
黑书青缯	hei'shu'qing'zeng	0
横尸填于江海	heng'shi'tian'yu'jiang'hai	0
鸿保天神诸君丈人	hong'bao'tian'shen'zhu'jun'zhang'ren	0
洪流滔天	hong'liu'tao'tian	0
洪水飞灾	hong'shui'fei'zai	0
洪水流天	hong'shui'liu'tian	0
洪水四出	hong'shui'si'chu	0
洪灾三会	hong'zai'san'hui	0
洪灾扫天	hong'zai'sao'tian	0
洪灾涌溢之数	hong'zai'yong'yi'zhi'shu	0
洪灾至天	hong'zai'zhi'tian	0
后世子孙	hou'shi'zi'sun	0
虎豹	hu'bao	0
护二仪而不倾	hu'er'yi'er'bu'qing	0
护阴阳以永昌	hu'yin'yang'yi'yong'chang	0
忽纵心而豁朗	hu'zong'xin'er'huo'lang	0
华精灌日	hua'jing'guan'ri	0
华容伟貌	hua'rong'wei'mao	0
化生少阳九炁青天主小劫亥	hua'sheng'shao'yang'jiu'qi'qing'tian'zhu'xiao'jie'hai	0
化生少阴七炁素天	hua'sheng'shao'yin'qi'qi'su'tian	0
化生太阳三气丹天	hua'sheng'tai'yang'san'qi'dan'tian	0
化生太阴五炁玄天	hua'sheng'tai'yin'wu'qi'xuan'tian	0
化生中元	hua'sheng'zhong'yuan	0
化为女子	hua'wei'nv'zi	0
怀胎含孕	huai'tai'han'yun	0
雚行毕甫	huan'xing'bi'fu	0
黄笔书之	huang'bi'shu'zhi	0
皇道既畅	huang'dao'ji'chang	0
皇道咸畅	huang'dao'xian'chang	0
黄帝鬼魔远舍十二万里	huang'di'gui'mo'yuan'she'shi'er'wan'li	0
黄帝受此文	huang'di'shou'ci'wen	0
黄帝行佩此文	huang'di'xing'pei'ci'wen	0
黄帝用事	huang'di'yong'shi	0
黄帝真人下世	huang'di'zhen'ren'xia'shi	0
黄帝中岳则阙此一文	huang'di'zhong'yue'ze'que'ci'yi'wen	0
黄房灵庭	huang'fang'ling'ting	0
皇老大神	huang'lao'da'shen	0
黄老君	huang'lao'jun	0
黄老丈人	huang'lao'zhang'ren	0
黄炁否	huang'qi'fou	0
黄炁食	huang'qi'shi	0
皇上老君	huang'shang'lao'jun	0
黄上天元	huang'shang'tian'yuan	0
皇上丈人	huang'shang'zhang'ren	0
黄神老君	huang'shen'lao'jun	0
黄神丈人	huang'shen'zhang'ren	0
黄书绛缯三寸佩身	huang'shu'jiang'zeng'san'cun'pei'shen	0
黄书青缯	huang'shu'qing'zeng	0
皇天太上帝	huang'tian'tai'shang'di	0
黄庭长生	huang'ting'zhang'sheng	0
皇真丈人	huang'zhen'zhang'ren	0
讳昌开	hui'chang'kai	0
回度北元	hui'du'bei'yuan	0
讳极炎	hui'ji'yan	0
讳开明	hui'kai'ming	0
会灵宝尊神	hui'ling'bao'zun'shen	0
讳灵会	hui'ling'hui	0
会论仙官玉女	hui'lun'xian'guan'yu'nv	0
会于东海青童	hui'yu'dong'hai'qing'tong	0
会于司命上宫	hui'yu'si'ming'shang'gong	0
讳元氏	hui'yuan'shi	0
毁之不灭	hui'zhi'bu'mie	0
秽之愈清	hui'zhi'yu'qing	0
会诸仙官	hui'zhu'xian'guan	0
会诸仙官于昆仑瑶台	hui'zhu'xian'guan'yu'kun'lun'yao'tai	0
会诸仙人于紫微宫	hui'zhu'xian'ren'yu'zi'wei'gong	0
会诸尊大圣仙人于	hui'zhu'zun'da'sheng'xian'ren'yu	0
回转灵宝玄都玉山中关	hui'zhuan'ling'bao'xuan'du'yu'shan'zhong'guan	0
回转天常	hui'zhuan'tian'chang	0
混沌无形虚无自然太上	hun'dun'wu'xing'xu'wu'zi'ran'tai'shang	0
混之不浊	hun'zhi'bu'zhuo	0
或乘白虎	huo'cheng'bai'hu	0
火精绝灭	huo'jing'jue'mie	0
豁落四开	huo'luo'si'kai	0
即得尸解	ji'de'shi'jie	0
及得喘息有生气者	ji'dei'chuan'xi'you'sheng'qi'zhe	0
赍符命恒山制天炁	ji'fu'ming'heng'shan'zhi'tian'qi	0
赍符命华山制天炁	ji'fu'ming'hua'shan'zhi'tian'qi	0
赍符命霍山制天炁	ji'fu'ming'huo'shan'zhi'tian'qi	0
赍符命太山制天炁	ji'fu'ming'tai'shan'zhi'tian'qi	0
赍符命中岳制天炁	ji'fu'ming'zhong'yue'zhi'tian'qi	0
即记名左契	ji'ji'ming'zuo'qi	0
及见世之罪	ji'jian'shi'zhi'zui	0
激朗云宫	ji'lang'yun'gong	0
即勒录九天	ji'le'lu'jiu'tian	0
记名仙籍	ji'ming'xian'ji	0
即能无穷	ji'neng'wu'qiong	0
极三光而告暮	ji'san'guang'er'gao'mu	0
集算天下兆民罪录	ji'suan'tian'xia'zhao'min'zui'lu	0
集筭天元	ji'suan'tian'yuan	0
集筭校大劫	ji'suan'xiao'da'jie	0
即为代人形而死矣	ji'wei'dai'ren'xing'er'si'yi	0
记为种民	ji'wei'zhong'min	0
吉无不利	ji'wu'bu'li	0
集校人民簿录	ji'xiao'ren'min'bu'lu	0
汲玄炁于天湖	ji'xuan'qi'yu'tian'hu	0
激阳起雷	ji'yang'qi'lei	0
箕主七辰	ji'zhu'qi'chen	0
驾乘云龙	jia'cheng'yun'long	0
家国安宁	jia'guo'an'ning	0
驾鹿辇于天河	jia'lu'nian'yu'tian'he	0
驾三角之麟	jia'san'jiao'zhi'lin	0
家致兴隆	jia'zhi'xing'long	0
见鯈欻而龙腾	jian'chou'chua'er'long'teng	0
剪除不祥	jian'chu'bu'xiang	0
建鹑旗	jian'chun'qi	0
检定图录	jian'ding'tu'lu	0
检鬼精	jian'gui'jing	0
建国祚以应图	jian'guo'zuo'yi'ying'tu	0
建黄旗	jian'huang'qi	0
检校神祇	jian'jiao'shen'qi	0
检校天下神图灵药	jian'jiao'tian'xia'shen'tu'ling'yao	0
检录天度	jian'lu'tian'du	0
见日宫之阳	jian'ri'gong'zhi'yang	0
建素旗	jian'su'qi	0
减筭缩年	jian'suan'suo'nian	0
见太平	jian'tai'ping	0
建天宝羽服	jian'tian'bao'yu'fu	0
奸祆杂俗	jian'xian'za'su	0
见于三天北元玉关之上	jian'yu'san'tian'bei'yuan'yu'guan'zhi'shang	0
见于玄都玉京上馆	jian'yu'xuan'du'yu'jing'shang'guan	0
煎玉饴于龙鼎	jian'yu'yi'yu'long'ding	0
见月之上馆	jian'yue'zhi'shang'guan	0
建皂旗	jian'zao'qi	0
奸诈魍魉	jian'zha'wang'liang	0
见众真修斋奉戒	jian'zhong'zhen'xiu'zhai'feng'jie	0
建朱旗	jian'zhu'qi	0
江海竭干	jiang'hai'jie'gan	0
江海开张	jiang'hai'kai'zhang	0
江河淮济水帝九部刺奸	jiang'he'huai'ji'shui'di'jiu'bu'ci'jian	0
江河枯竭	jiang'he'ku'jie	0
将招大福于自然	jiang'zhao'da'fu'yu'zi'ran	0
教导天人	jiao'dao'tian'ren	0
教化恒山	jiao'hua'heng'shan	0
教化华山	jiao'hua'hua'shan	0
教化霍山	jiao'hua'huo'shan	0
教化嵩高山	jiao'hua'song'gao'shan	0
教化太山	jiao'hua'tai'shan	0
角亢镇真	jiao'kang'zhen'zhen	0
蛟龙负身	jiao'long'fu'shen	0
蛟龙通道	jiao'long'tong'dao	0
教始学之人	jiao'shi'xue'zhi'ren	0
皆白日升天	jie'bai'ri'sheng'tian	0
皆不生害心	jie'bu'sheng'hai'xin	0
皆惨然俱会天关之门	jie'can'ran'ju'hui'tian'guan'zhi'men	0
皆乘碧霞九灵流景飞云玉舆	jie'cheng'bi'xia'jiu'ling'liu'jing'fei'yun'yu'yu	0
皆成洞章	jie'cheng'dong'zhang	0
皆得见此文	jie'de'jian'ci'wen	0
皆得康强	jie'de'kang'qiang	0
皆得生育	jie'de'sheng'yu	0
皆会玄都玉京之台	jie'hui'xuan'du'yu'jing'zhi'tai	0
皆精行所致	jie'jing'xing'suo'zhi	0
皆空洞自然之书	jie'kong'dong'zi'ran'zhi'shu	0
皆上运元始青阳之炁	jie'shang'yun'yuan'shi'qing'yang'zhi'qi	0
结实繁茂	jie'shi'fan'mao	0
解脱三涂	jie'tuo'san'tu	0
皆为五帝所举	jie'wei'wu'di'suo'ju	0
截邪斩根	jie'xie'zhan'gen	0
截以金关	jie'yi'jin'guan	0
皆以三元斋之	jie'yi'san'yuan'zhai'zhi	0
皆以五龙迎之	jie'yi'wu'long'ying'zhi	0
皆应天分	jie'ying'tian'fen	0
皆元始自然之书也	jie'yuan'shi'zi'ran'zhi'shu'ye	0
今封北单广灵洞室石碽之中	jin'feng'bei'dan'guang'ling'dong'shi'shi'gong'zhi'zhong	0
金灵皓映	jin'ling'hao'ying	0
金马驿传	jin'ma'yi'chuan	0
今且可相付	jin'qie'ke'xiang'fu	0
金阙后圣帝君	jin'que'hou'sheng'di'jun	0
金阙后圣上相帝君	jin'que'hou'sheng'shang'xiang'di'jun	0
金阙上相至真大神	jin'que'shang'xiang'zhi'zhen'da'shen	0
金雀衔符	jin'que'xian'fu	0
今三天整运	jin'san'tian'zheng'yun	0
金石自消	jin'shi'zi'xiao	0
今所以书于旧经者	jin'suo'yi'shu'yu'jiu'jing'zhe	0
金童扬烟	jin'tong'yang'yan	0
今万物之永存	jin'wan'wu'zhi'yong'cun	0
金玉化消	jin'yu'hua'xiao	0
禁于漏泄	jin'yu'lou'xie	0
金玉露形	jin'yu'lu'xing	0
谨于某气天中	jin'yu'mou'qi'tian'zhong	0
金玉山海	jin'yu'shan'hai	0
金玉自然	jin'yu'zi'ran	0
精彩光明	jing'cai'guang'ming	0
井鬼守房	jing'gui'shou'fang	0
精魅杂法之术	jing'mei'za'fa'zhi'shu	0
净如金刚	jing'ru'jin'gang	0
精思灵宝尊神	jing'si'ling'bao'zun'shen	0
精思灵宝尊神则天真下降	jing'si'ling'bao'zun'shen'ze'tian'zhen'xia'jiang	0
径烝九天	jing'zheng'jiu'tian	0
旧本封于玄都紫微宫	jiu'ben'feng'yu'xuan'du'zi'wei'gong	0
纠察功过	jiu'cha'gong'guo	0
糺察功过轻重	jiu'cha'gong'guo'qing'zhong	0
糺察兆民	jiu'cha'zhao'min	0
九府	jiu'fu	0
九河倾讫	jiu'he'qing'qi	0
九河之口	jiu'he'zhi'kou	0
九老仙都君	jiu'lao'xian'du'jun	0
九老丈人	jiu'lao'zhang'ren	0
九灵君	jiu'ling'jun	0
九灵丈人	jiu'ling'zhang'ren	0
九年皆生青精宝华九重	jiu'nian'jie'sheng'qing'jing'bao'hua'jiu'chong	0
九念普为一切人民	jiu'nian'pu'wei'yi'qie'ren'min	0
九气君	jiu'qi'jun	0
九气丈人	jiu'qi'zhang'ren	0
九气丈人等	jiu'qi'zhang'ren'deng	0
九千九百度	jiu'qian'jiu'bai'du	0
九千九百度白气激	jiu'qian'jiu'bai'du'bai'qi'ji	0
九千九百度赤炁激	jiu'qian'jiu'bai'du'chi'qi'ji	0
九千九百度黄炁激	jiu'qian'jiu'bai'du'huang'qi'ji	0
九千年一出	jiu'qian'nian'yi'chu	0
九千万人	jiu'qian'wan'ren	0
九色玄龙	jiu'se'xuan'long	0
九水河源	jiu'shui'he'yuan	0
九天符命	jiu'tian'fu'ming	0
九天炁交	jiu'tian'qi'jiao	0
九天上书	jiu'tian'shang'shu	0
九天始生之玄札	jiu'tian'shi'sheng'zhi'xuan'zha	0
九天所秘	jiu'tian'suo'mi	0
九天太素阳生符	jiu'tian'tai'su'yang'sheng'fu	0
九天玉真长安神飞符	jiu'tian'yu'zhen'chang'an'shen'fei'fu	0
九天正文	jiu'tian'zheng'wen	0
九土崩陷	jiu'tu'beng'xian	0
九为众生	jiu'wei'zhong'sheng	0
旧文今秘于玄都紫微宫	jiu'wen'jin'mi'yu'xuan'du'zi'wei'gong	0
九亿九万九千九百九十九度	jiu'yi'jiu'wan'jiu'qian'jiu'bai'jiu'shi'jiu'du	0
旧仪系灵宝中元篇目	jiu'yi'xi'ling'bao'zhong'yuan'pian'mu	0
九元运关	jiu'yuan'yun'guan	0
九月	jiu'yue	0
九者尘垢普消	jiu'zhe'chen'gou'pu'xiao	0
九者春秋冬夏	jiu'zhe'chun'qiu'dong'xia	0
九者蛟龙踊跃	jiu'zhe'jiao'long'yong'yue	0
九者交游上道	jiu'zhe'jiao'you'shang'dao	0
九者交友真人	jiu'zhe'jiao'you'zhen'ren	0
九者其德如太玄	jiu'zhe'qi'de'ru'tai'xuan	0
具出灵宝中金紫格	ju'chu'ling'bao'zhong'jin'zi'ge	0
举盟五岳而受文	ju'meng'wu'yue'er'shou'wen	0
居危获安	ju'wei'huo'an	0
举响从心	ju'xiang'cong'xin	0
举向所欲	ju'xiang'suo'yu	0
居于太阳三山之上	ju'yu'tai'yang'san'shan'zhi'shang	0
攫天镇威	jue'tian'zhen'wei	0
君自可诣灵都紫微上宫	jun'zi'ke'yi'ling'dou'zi'wei'shang'gong	0
开除水径	kai'chu'shui'jing	0
慨尔叹日微乎深哉	kai'er'tan'ri'wei'hu'shen'zai	0
开化神明	kai'hua'shen'ming	0
开明元化	kai'ming'yuan'hua	0
开明之后	kai'ming'zhi'hou	0
开三图以通真	kai'san'tu'yi'tong'zhen	0
开元首之妙门	kai'yuan'shou'zhi'miao'men	0
开张广纳	kai'zhang'guang'na	0
开张厚载	kai'zhang'hou'zai	0
开张万真	kai'zhang'wan'zhen	0
抗志八圆之中	kang'zhi'ba'yuan'zhi'zhong	0
考罚尔身	kao'fa'er'shen	0
可得见授	ke'de'jian'shou	0
可得暂披于灵蕴乎	ke'de'zan'pi'yu'ling'yun'hu	0
克获上仙	ke'huo'shang'xian	0
刻书金札以佩身	ke'shu'jin'zha'yi'pei'shen	0
刻书玉篇	ke'shu'yu'pian	0
可谓停灵运于元祚	ke'wei'ting'ling'yun'yu'yuan'zuo	0
克致神仙	ke'zhi'shen'xian	0
空洞结真	kong'dong'jie'zhen	0
空洞之灵章	kong'dong'zhi'ling'zhang	0
空洞之中	kong'dong'zhi'zhong	0
空洞自然之文	kong'dong'zi'ran'zhi'wen	0
空上一节	kong'shang'yi'jie	0
空生十方	kong'sheng'shi'fang	0
空生自然	kong'sheng'zi'ran	0
空下一节	kong'xia'yi'jie	0
叩天池而呜鼓	kou'tian'chi'er'wu'gu	0
口咏灵章	kou'yong'ling'zhang	0
枯骨更生	ku'gu'geng'sheng	0
枯木并荣	ku'mu'bing'rong	0
枯朽皆生	ku'xiu'jie'sheng	0
匡御运度	kuang'yu'yun'du	0
奎娄守魂	kui'lou'shou'hun	0
魁勺主非	kui'shao'zhu'fei	0
朗啸清虚	lang'xiao'qing'xu	0
朗秀三会	lang'xiu'san'hui	0
琅舆碧辇	lang'yu'bi'nian	0
累经劫运	lei'jing'jie'yun	0
吏兵卫身	li'bing'wei'shen	0
量难可胜	liang'nan'ke'sheng	0
料别善恶	liao'bie'shan'e	0
列名上天	lie'ming'shang'tian	0
列名玄都	lie'ming'xuan'du	0
列为善民	lie'wei'shan'min	0
列言丹台	lie'yan'dan'tai	0
列言帝君	lie'yan'di'jun	0
列言金堂	lie'yan'jin'tang	0
列言灵宝洞灵丹台	lie'yan'ling'bao'dong'ling'dan'tai	0
列言灵宝玄都上宫	lie'yan'ling'bao'xuan'du'shang'gong	0
列言青宫	lie'yan'qing'gong	0
列言善功	lie'yan'shan'gong	0
列言上宫	lie'yan'shang'gong	0
列言上天	lie'yan'shang'tian	0
列言玄都	lie'yan'xuan'du	0
列言朱宫	lie'yan'zhu'gong	0
列奏灵宝玄都上宫	lie'zou'ling'bao'xuan'du'shang'gong	0
林木禾稼	lin'mu'he'jia	0
麟舞凤唱	lin'wu'feng'chang	0
灵宝赤帝某君	ling'bao'chi'di'mou'jun	0
灵宝九仙君等	ling'bao'jiu'xian'jun'deng	0
灵宝君	ling'bao'jun	0
灵宝妙行真人	ling'bao'miao'xing'zhen'ren	0
灵宝五篇真文	ling'bao'wu'pian'zhen'wen	0
灵宝玄都玉山	ling'bao'xuan'du'yu'shan	0
灵宝玄妙	ling'bao'xuan'miao	0
灵宝丈人	ling'bao'zhang'ren	0
灵宝真文	ling'bao'zhen'wen	0
令长七尺	ling'chang'qi'chi	0
令得升玄矣	ling'de'sheng'xuan'yi	0
令得与元始同没同生也	ling'de'yu'yuan'shi'tong'mei'tong'sheng'ye	0
领地上鬼普神王者	ling'di'shang'gui'pu'shen'wang'zhe	0
灵都宫元阳紫微之台	ling'dou'gong'yuan'yang'zi'wei'zhi'tai	0
灵妃散华	ling'fei'san'hua	0
灵关廓开	ling'guan'kuo'kai	0
灵炁镇肺	ling'qi'zhen'fei	0
灵气镇肝	ling'qi'zhen'gan	0
灵气镇脾	ling'qi'zhen'pi	0
灵气镇肾	ling'qi'zhen'shen	0
灵气镇心	ling'qi'zhen'xin	0
灵兽飞轩	ling'shou'fei'xuan	0
灵童玉女	ling'tong'yu'nv	0
灵图革运	ling'tu'ge'yun	0
灵图既焕	ling'tu'ji'huan	0
灵文既振	ling'wen'ji'zhen	0
灵文妙重	ling'wen'miao'zhong	0
灵文晻蔼	ling'wen'yan'ai	0
灵文郁秀	ling'wen'yu'xiu	0
灵真降素醴而沾濡	ling'zhen'jiang'su'li'er'zhan'ru	0
灵尊妙贵	ling'zun'miao'gui	0
流电扬烽	liu'dian'yang'feng	0
流景冥华之都	liu'jing'ming'hua'zhi'du	0
流炼神宫	liu'lian'shen'gong	0
流铃焕落	liu'ling'huan'luo	0
六年克得拜谒太上	liu'nian'ke'de'bai'ye'tai'shang	0
六念愿得飞行	liu'nian'yuan'de'fei'xing	0
流盻太无	liu'pan'tai'wu	0
流洒诸天	liu'sa'zhu'tian	0
六天道行	liu'tian'dao'heng	0
六天炁返	liu'tian'qi'fan	0
六天气消	liu'tian'qi'xiao	0
六为求仙	liu'wei'qiu'xian	0
柳星张翼	liu'xing'zhang'yi	0
六者福延先亡	liu'zhe'fu'yan'xian'wang	0
六者灵风百咏	liu'zhe'ling'feng'bai'yong	0
六者其德如三光五曜	liu'zhe'qi'de'ru'san'guang'wu'yao	0
六者琼龙衔玺	liu'zhe'qiong'long'xian'xi	0
六者天灾宾伏	liu'zhe'tian'zai'bin'fu	0
六者制伏天地一切鬼神	liu'zhe'zhi'fu'tian'di'yi'qie'gui'shen	0
龙麟	long'lin	0
龙文凤衣	long'wen'feng'yi	0
鸾翔云端	luan'xiang'yun'duan	0
论定阴阳	lun'ding'yin'yang	0
论解曲逮	lun'jie'qu'dai	0
履大阳九	lv'da'yang'jiu	0
履小阳九	lv'xiao'yang'jiu	0
盲聋跛痾	mang'long'bo'ke	0
每事尊法	mei'shi'zun'fa	0
每以尽节	mei'yi'jin'jie	0
门户昌炽	men'hu'chang'chi	0
门户整肃	men'hu'zheng'su	0
弥天扫秽	mi'tian'sao'hui	0
秘于九天灵都之宫	mi'yu'jiu'tian'ling'dou'zhi'gong	0
秘于九天灵都紫微宫七宝玄台	mi'yu'jiu'tian'ling'dou'zi'wei'gong'qi'bao'xuan'tai	0
秘掌天真	mi'zhang'tian'zhen	0
免度厄世	mian'du'e'shi	0
免离徒责	mian'li'tu'ze	0
妙行真人	miao'xing'zhen'ren	0
妙行真人常以正月	miao'xing'zhen'ren'chang'yi'zheng'yue	0
妙行真人所见爱敬	miao'xing'zhen'ren'suo'jian'ai'jing	0
妙应自然	miao'ying'zi'ran	0
妙哉灵宝	miao'zai'ling'bao	0
灭之极明	mie'zhi'ji'ming	0
民无立踵	min'wu'li'zhong	0
明道动辉	ming'dao'dong'hui	0
明度数	ming'du'shu	0
明度天关	ming'du'tian'guan	0
溟海水神	ming'hai'shui'shen	0
明见众真奉斋	ming'jian'zhong'zhen'feng'zhai	0
明列罪原	ming'lie'zui'yuan	0
命灵策以制魔	ming'ling'ce'yi'zhi'mo	0
名山送云	ming'shan'song'yun	0
明石长生	ming'shi'chang'sheng	0
明太空之灵象	ming'tai'kong'zhi'ling'xiang	0
命召五帝	ming'zhao'wu'di	0
莫不惨然俱下	mo'bu'can'ran'ju'xia	0
莫不飞仙	mo'bu'fei'xian	0
莫不开容	mo'bu'kai'rong	0
莫不利贞	mo'bu'li'zhen	0
莫不稽首遥唱玉音	mo'bu'qi'shou'yao'chang'yu'yin	0
莫不上会灵宝玄都	mo'bu'shang'hui'ling'bao'xuan'du	0
莫不束带肃然持斋	mo'bu'shu'dai'su'ran'chi'zhai	0
莫不欣欣	mo'bu'xin'xin	0
莫不由焉	mo'bu'you'yan	0
莫能致之	mo'neng'zhi'zhi	0
莫有不从	mo'you'bu'cong	0
莫有当前	mo'you'dang'qian	0
某年某月某日	mou'nian'mou'yue'mou'ri	0
某岳道士某甲	mou'yue'dao'shi'mou'jia	0
某月生	mou'yue'sheng	0
某州郡县乡里	mou'zhou'jun'xian'xiang'li	0
乃闭阂于求真之路	nai'bi'he'yu'qiu'zhen'zhi'lu	0
乃传太上大道君	nai'chuan'tai'shang'da'dao'jun	0
乃可即得更生始分之中	nai'ke'ji'de'geng'sheng'shi'fen'zhi'zhong	0
乃天地之玄根	nai'tian'di'zhi'xuan'gen	0
乃知天真贵重	nai'zhi'tian'zhen'gui'zhong	0
南方赤帝灵宝赤书玉篇	nan'fang'chi'di'ling'bao'chi'shu'yu'pian	0
南方丹天	nan'fang'dan'tian	0
南方梵宝昌	nan'fang'fan'bao'chang	0
南方梵宝昌阳丹灵真老	nan'fang'fan'bao'chang'yang'dan'ling'zhen'lao	0
南方梵宝昌阳丹灵真老君符命	nan'fang'fan'bao'chang'yang'dan'ling'zhen'lao'jun'fu'ming	0
南方焚宝昌阳丹灵真老	nan'fang'fen'bao'chang'yang'dan'ling'zhen'lao	0
南方三炁丹天	nan'fang'san'qi'dan'tian	0
南河水帝	nan'he'shui'di	0
南极度世君	nan'ji'du'shi'jun	0
南极老君	nan'ji'lao'jun	0
南极元真君	nan'ji'yuan'zhen'jun	0
南极丈人	nan'ji'zhang'ren	0
难可称焉	nan'ke'cheng'yan	0
难可即闻	nan'ke'ji'wen	0
男人吞此符后	nan'ren'tun'ci'fu'hou	0
南山神咒	nan'shan'shen'zhou	0
内神杖次白帝下节中	nei'shen'zhang'ci'bai'di'xia'jie'zhong	0
内神杖次赤帝下节中	nei'shen'zhang'ci'chi'di'xia'jie'zhong	0
内神杖次黄帝下节中	nei'shen'zhang'ci'huang'di'xia'jie'zhong	0
内神杖次青帝下节中	nei'shen'zhang'ci'qing'di'xia'jie'zhong	0
内神杖上节中	nei'shen'zhang'shang'jie'zhong	0
内有玄膺九窗之关	nei'you'xuan'ying'jiu'chuang'zhi'guan	0
能设斋烧香	neng'she'zhai'shao'xiang	0
能修斋奉戒	neng'xiu'zhai'feng'jie	0
年若干岁	nian'ruo'gan'sui	0
年月功过及鬼神之事	nian'yue'gong'guo'ji'gui'shen'zhi'shi	0
鸟母群飞	niao'mu'qun'fei	0
女吞此符后	nv'tun'ci'fu'hou	0
女虚危室	nv'xu'wei'shi	0
徘徊云路	pai'huai'yun'lu	0
佩此文	pei'ci'wen	0
佩此文度天灾见太平君	pei'ci'wen'du'tian'zai'jian'tai'ping'jun	0
佩此文度灾横	pei'ci'wen'du'zai'heng	0
佩此文则免洪流万疠之中	pei'ci'wen'ze'mian'hong'liu'wan'li'zhi'zhong	0
佩此文则与运推移	pei'ci'wen'ze'yu'yun'tui'yi	0
佩身	pei'shen	0
佩之得免大灾	pei'zhi'de'mian'da'zai	0
佩之即得化生始分之中	pei'zhi'ji'de'hua'sheng'shi'fen'zhi'zhong	0
佩之皆即得化生始分之中	pei'zhi'jie'ji'de'hua'sheng'shi'fen'zhi'zhong	0
佩之千毒不加身	pei'zhi'qian'du'bu'jia'shen	0
佩之千害不加	pei'zhi'qian'hai'bu'jia	0
披九光八色之蕴云锦之囊	pi'jiu'guang'ba'se'zhi'yun'yun'jin'zhi'nang	0
飘尸洪流	piao'shi'hong'liu	0
票正玄斗	piao'zheng'xuan'dou	0
普告万神	pu'gao'wan'shen	0
普归帝君	pu'gui'di'jun	0
普加无穷	pu'jia'wu'qiong	0
普教十方	pu'jiao'shi'fang	0
普教无穷	pu'jiao'wu'qiong	0
普皆延年	pu'jie'yan'nian	0
普离众恶	pu'li'zhong'e	0
普蒙惠泽	pu'meng'hui'ze	0
普扫不祥	pu'sao'bu'xiang	0
普受光明	pu'shou'guang'ming	0
普受其荫润	pu'shou'qi'yin'run	0
普受自然	pu'shou'zi'ran	0
普天安宁	pu'tian'an'ning	0
普天生男	pu'tian'sheng'nan	0
普天兴隆	pu'tian'xing'long	0
普照普察	pu'zhao'pu'cha	0
七宝之树	qi'bao'zhi'shu	0
岂不远乎	qi'bu'yuan'hu	0
炁充然而流盈	qi'chong'ran'er'liu'ying	0
其德洪矣	qi'de'hong'yi	0
其德如之巍巍高范	qi'de'ru'zhi'wei'wei'gao'fan	0
其二十四应	qi'er'shi'si'ying	0
其方其年	qi'fang'qi'nian	0
其方其年丰熟	qi'fang'qi'nian'feng'shu	0
气甘和而淡妙	qi'gan'he'er'dan'miao	0
其光如飞景之罗朝日	qi'guang'ru'fei'jing'zhi'luo'zhao'ri	0
其光如晖日之初降	qi'guang'ru'hui'ri'zhi'chu'jiang	0
其光如流星之堕于洪波	qi'guang'ru'liu'xing'zhi'duo'yu'hong'bo	0
其光如玄玉之瑛渊	qi'guang'ru'xuan'yu'zhi'ying'yuan	0
其光如幽夜之覩于明珠	qi'guang'ru'you'ye'zhi'du'yu'ming'zhu	0
弃秽来真	qi'hui'lai'zhen	0
其精始生	qi'jing'shi'sheng	0
其理甚明	qi'li'shen'ming	0
其量莫测	qi'liang'mo'ce	0
麒麟来归	qi'lin'lai'gui	0
气流下凝	qi'liu'xia'ning	0
其明如朗月之照幽域	qi'ming'ru'lang'yue'zhi'zhao'you'yu	0
其乃士天之灵泽	qi'nai'shi'tian'zhi'ling'ze	0
七年除民	qi'nian'chu'min	0
其年大灾驱除	qi'nian'da'zai'qu'chu	0
七年而解	qi'nian'er'jie	0
其年洪水四出	qi'nian'hong'shui'si'chu	0
其年火精消灭	qi'nian'huo'jing'xiao'mie	0
七年皆生白精宝华七重	qi'nian'jie'sheng'bai'jing'bao'hua'qi'chong	0
其年金石自消	qi'nian'jin'shi'zi'xiao	0
其年金玉化消	qi'nian'jin'yu'hua'xiao	0
其年山冈丘垄	qi'nian'shan'gang'qiu'long	0
其年天地枯旱	qi'nian'tian'di'ku'han	0
其年天灾激	qi'nian'tian'zai'ji	0
其年土下出雾	qi'nian'tu'xia'chu'wu	0
其年土中生火	qi'nian'tu'zhong'sheng'huo	0
七念为亿曾万祖	qi'nian'wei'yi'ceng'wan'zu	0
其年中国大丰	qi'nian'zhong'guo'da'feng	0
其炁如春草之始萌	qi'qi'ru'chun'cao'zhi'shi'meng	0
其气如降云之包日	qi'qi'ru'jiang'yun'zhi'bao'ri	0
其气如明月之落于景云	qi'qi'ru'ming'yue'zhi'luo'yu'jing'yun	0
其气如飕风之激于炎林	qi'qi'ru'sou'feng'zhi'ji'yu'yan'lin	0
七气氤氲	qi'qi'yin'yun	0
气清高澄	qi'qing'gao'cheng	0
其日勑北辰	qi'ri'chi'bei'chen	0
其日勑北斗	qi'ri'chi'bei'dou	0
其日勑太乙八神使者	qi'ri'chi'tai'yi'ba'shen'shi'zhe	0
其日勑太乙使者	qi'ri'chi'tai'yi'shi'zhe	0
其日勑天一	qi'ri'chi'tian'yi	0
其日犯恶为非	qi'ri'fan'e'wei'fei	0
其日劫北斗司杀鬼	qi'ri'jie'bei'dou'si'sha'gui	0
其日遣上太一下	qi'ri'qian'shang'tai'yi'xia	0
其日遣中太乙	qi'ri'qian'zhong'tai'yi	0
其日太一下历	qi'ri'tai'yi'xia'li	0
其日天帝自下	qi'ri'tian'di'zi'xia	0
其日修斋奉戒	qi'ri'xiu'zhai'feng'jie	0
其日有奉修斋直	qi'ri'you'feng'xiu'zhai'zhi	0
其日有修奉灵宝真经	qi'ri'you'xiu'feng'ling'bao'zhen'jing	0
其日月星宿	qi'ri'yue'xing'xiu	0
其日诸天大圣尊神	qi'ri'zhu'tian'da'sheng'zun'shen	0
其日诸天星宿	qi'ri'zhu'tian'xing'xiu	0
其时当有白帝神人	qi'shi'dang'you'bai'di'shen'ren	0
其时当有大鸟东南而飞	qi'shi'dang'you'da'niao'dong'nan'er'fei	0
其时当有黑帝神人	qi'shi'dang'you'hei'di'shen'ren	0
其时当有黄帝神人	qi'shi'dang'you'huang'di'shen'ren	0
其时当有青帝神人	qi'shi'dang'you'qing'di'shen'ren	0
其十二灵瑞	qi'shi'er'ling'rui	0
七为众官	qi'wei'zhong'guan	0
其文今封南霍石碽	qi'wen'jin'feng'nan'huo'shi'gong	0
其文九千年一出	qi'wen'jiu'qian'nian'yi'chu	0
其文九千年一出北岳	qi'wen'jiu'qian'nian'yi'chu'bei'yue	0
其文九千年一出东岳	qi'wen'jiu'qian'nian'yi'chu'dong'yue	0
其文九千年一出南岳	qi'wen'jiu'qian'nian'yi'chu'nan'yue	0
其文九千年一出西岳	qi'wen'jiu'qian'nian'yi'chu'xi'yue	0
其文九千年一出中岳	qi'wen'jiu'qian'nian'yi'chu'zhong'yue	0
其文明于南丹洞灵橭林之下	qi'wen'ming'yu'nan'dan'dong'ling'gu'lin'zhi'xia	0
其文在赤书后二劫	qi'wen'zai'chi'shu'hou'er'jie	0
其文在赤书后劫	qi'wen'zai'chi'shu'hou'jie	0
其下二十四字	qi'xia'er'shi'si'zi	0
其下三十二字	qi'xia'san'shi'er'zi	0
其下十六字	qi'xia'shi'liu'zi	0
其下四十八字	qi'xia'si'shi'ba'zi	0
其下四十字	qi'xia'si'shi'zi	0
其下四十字者	qi'xia'si'shi'zi'zhe	0
其行时则宴鸿毛而高翔	qi'xing'shi'ze'yan'hong'mao'er'gao'xiang	0
其烟如云	qi'yan'ru'yun	0
其仪典格式	qi'yi'dian'ge'shi	0
其一十二恩	qi'yi'shi'er'en	0
七月	qi'yue	0
七者见世兴隆	qi'zhe'jian'shi'xing'long	0
七者鸾啸凤唱	qi'zhe'luan'xiao'feng'chang	0
七者门族端伟	qi'zhe'men'zu'duan'wei	0
七者其德如高真	qi'zhe'qi'de'ru'gao'zhen	0
七者驱驰六甲	qi'zhe'qu'chi'liu'jia	0
七者璇玑停关	qi'zhe'xuan'ji'ting'guan	0
炁真如弦	qi'zhen'ru'xian	0
其中诸天星辰日月	qi'zhong'zhu'tian'xing'chen'ri'yue	0
七祖皆升福堂	qi'zu'jie'sheng'fu'tang	0
千百万种一时同作	qian'bai'wan'zhong'yi'shi'tong'zuo	0
遣大一中台大使者下	qian'da'yi'zhong'tai'da'shi'zhe'xia	0
千道万通	qian'dao'wan'tong	0
千二百官君	qian'er'bai'guan'jun	0
千二百官丈人	qian'er'bai'guan'zhang'ren	0
千二百君	qian'er'bai'jun	0
千精万邪	qian'jing'wan'xie	0
迁赏道功	qian'shang'dao'gong	0
千妖万奸	qian'yao'wan'jian	0
千灾不干	qian'zai'bu'gan	0
勤行其法	qin'xing'qi'fa	0
青笔书文	qing'bi'shu'wen	0
青帝鬼魔远舍九万里	qing'di'gui'mo'yuan'she'jiu'wan'li	0
青帝受此文以镇东岳	qing'di'shou'ci'wen'yi'zhen'dong'yue	0
青帝行佩此文	qing'di'xing'pei'ci'wen	0
青帝用事	qing'di'yong'shi	0
青帝真人下世	qing'di'zhen'ren'xia'shi	0
青和玉女	qing'he'yu'nv	0
青华大神	qing'hua'da'shen	0
清开广置为神仙之都	qing'kai'guang'zhi'wei'shen'xian'zhi'du	0
青灵上真天帝君	qing'ling'shang'zhen'tian'di'jun	0
青灵始老帝君	qing'ling'shi'lao'di'jun	0
青炁否	qing'qi'fou	0
青炁激	qing'qi'ji	0
青炁食	qing'qi'shi	0
青裙羽	qing'qun'yu	0
请受元始灵宝赤书玉篇真文	qing'shou'yuan'shi'ling'bao'chi'shu'yu'pian'zhen'wen	0
青书白缯	qing'shu'bai'zeng	0
青书绛缯佩身	qing'shu'jiang'zeng'pei'shen	0
请太上灵宝八威策文三牒文	qing'tai'shang'ling'bao'ba'wei'ce'wen'san'die'wen	0
庆霄四会	qing'xiao'si'hui	0
清虚简素	qing'xu'jian'su	0
青牙长存	qing'ya'chang'cun	0
青腰玉女九人侍卫	qing'yao'yu'nv'jiu'ren'shi'wei	0
庆载永安	qing'zai'yong'an	0
清斋百日	qing'zhai'bai'ri	0
清斋持戒	qing'zhai'chi'jie	0
轻重列言	qing'zhong'lie'yan	0
轻重上言	qing'zhong'shang'yan	0
取北岳神仙芝草不死之药	qu'bei'yue'shen'xian'zhi'cao'bu'si'zhi'yao	0
区别善恶	qu'bie'shan'e	0
驱策天仙	qu'ce'tian'xian	0
驱除兆民	qu'chu'zhao'min	0
取东岳神仙芝草	qu'dong'yue'shen'xian'zhi'cao	0
取俯仰于神王也	qu'fu'yang'yu'shen'wang'ye	0
取南岳神仙芝草不死之药	qu'nan'yue'shen'xian'zhi'cao'bu'si'zhi'yao	0
驱散杂俗鬼精	qu'san'za'su'gui'jing	0
取西岳神仙芝草不死之药	qu'xi'yue'shen'xian'zhi'cao'bu'si'zhi'yao	0
躯形安宁	qu'xing'an'ning	0
取中岳神仙芝草不死之药	qu'zhong'yue'shen'xian'zhi'cao'bu'si'zhi'yao	0
却衰枯而绝烟	que'shuai'ku'er'jue'yan	0
却衰朽而童蒙	que'shuai'xiu'er'tong'meng	0
却素发而玄黑	que'su'fa'er'xuan'hei	0
却灾扫秽	que'zai'sao'hui	0
却诸祸殃	que'zhu'huo'yang	0
群妖灭爽	qun'yao'mie'shuang	0
然后当使得备天文	ran'hou'dang'shi'de'bei'tian'wen	0
然后以佩身	ran'hou'yi'pei'shen	0
禳此灾	rang'ci'zai	0
禳秋霜之落叶	rang'qiu'shuang'zhi'luo'ye	0
禳凶却秽	rang'xiong'que'hui	0
人鬼有犯	ren'gui'you'fan	0
人民安	ren'min'an	0
人民燋死	ren'min'jiao'si	0
人民流散	ren'min'liu'san	0
人民鸟兽	ren'min'niao'shou	0
人民飘尸	ren'min'piao'shi	0
人民盛	ren'min'sheng	0
人民水居	ren'min'shui'ju	0
人民乌兽	ren'min'wu'shou	0
人民乌兽焦死无遗	ren'min'wu'shou'jiao'si'wu'yi	0
人民相啖	ren'min'xiang'dan	0
人神受之而无穷	ren'shen'shou'zhi'er'wu'qiong	0
人兽得过	ren'shou'de'guo	0
人兽灭种	ren'shou'mie'zhong	0
人兽疫死	ren'shou'yi'si	0
人漱唇齿以不零	ren'shu'chun'chi'yi'bu'ling	0
人无五文	ren'wu'wu'wen	0
人养五脏于唇锋	ren'yang'wu'zang'yu'chun'feng	0
人亦同之	ren'yi'tong'zhi	0
仁者见之谓之仁	ren'zhe'jian'zhi'wei'zhi'ren	0
日君	ri'jun	0
日月未光	ri'yue'wei'guang	0
日月星宿	ri'yue'xing'xiu	0
日月星宿所惠	ri'yue'xing'xiu'suo'hui	0
日月璇玑	ri'yue'xuan'ji	0
日月之精	ri'yue'zhi'jing	0
入室思日精	ru'shi'si'ri'jing	0
入室思月精含而吞之	ru'shi'si'yue'jing'han'er'tun'zhi	0
润流无穷	run'liu'wu'qiong	0
若有不祥	ruo'you'bu'xiang	0
三百三十度	san'bai'san'shi'du	0
三部三官考召	san'bu'san'guan'kao'zhao	0
三晨吐芳	san'chen'tu'fang	0
三恶之道	san'e'zhi'dao	0
三分遗一	san'fen'yi'yi	0
三官除罪	san'guan'chu'zui	0
三官记识	san'guan'ji'shi	0
三官考召	san'guan'kao'zhao	0
三官所糺	san'guan'suo'jiu	0
三官削除罪名	san'guan'xue'chu'zui'ming	0
三光不明	san'guang'bu'ming	0
三光乘之以高明	san'guang'cheng'zhi'yi'gao'ming	0
三光从之以开明	san'guang'cong'zhi'yi'kai'ming	0
三界地祇	san'jie'di'qi	0
三界司迎	san'jie'si'ying	0
三界通津	san'jie'tong'jin	0
三景得之而发光	san'jing'de'zhi'er'fa'guang	0
三景合明	san'jing'he'ming	0
三龙之后	san'long'zhi'hou	0
散满道路	san'man'dao'lu	0
三念悔谢众罪	san'nian'hui'xie'zhong'zui	0
三年皆生赤精宝华三重	san'nian'jie'sheng'chi'jing'bao'hua'san'chong	0
三炁勃光	san'qi'bo'guang	0
三千三百度白炁勃	san'qian'san'bai'du'bai'qi'bo	0
三千三百度赤炁勃	san'qian'san'bai'du'chi'qi'bo	0
三千三百度黑炁勃	san'qian'san'bai'du'hei'qi'bo	0
三千三百度黄炁勃	san'qian'san'bai'du'huang'qi'bo	0
三千三百度青炁勃	san'qian'san'bai'du'qing'qi'bo	0
三十六真丈人	san'shi'liu'zhen'zhang'ren	0
三素流云诸天大圣	san'su'liu'yun'zhu'tian'da'sheng	0
三天记上仙录	san'tian'ji'shang'xian'lu	0
三天太玄阴生符	san'tian'tai'xuan'yin'sheng'fu	0
三天真生神符	san'tian'zhen'sheng'shen'fu	0
三为居世	san'wei'ju'shi	0
三元开张	san'yuan'kai'zhang	0
三月	san'yue	0
三灾九厄	san'zai'jiu'e	0
三者来生却死	san'zhe'lai'sheng'que'si	0
三者其德如大道	san'zhe'qi'de'ru'da'dao	0
三者青鸟	san'zhe'qing'niao	0
三者上圣玄监	san'zhe'shang'sheng'xuan'jian	0
三者是时三万六千日月一时同明	san'zhe'shi'shi'san'wan'liu'qian'ri'yue'yi'shi'tong'ming	0
三者为诸天大圣尊神	san'zhe'wei'zhu'tian'da'sheng'zun'shen	0
桑林千真	sang'lin'qian'zhen	0
扫除灾群	sao'chu'zai'qun	0
扫秽除氛	sao'hui'chu'fen	0
扫诸不祥	sao'zhu'bu'xiang	0
善恶悉分	shan'e'xi'fen	0
山河得之而不沦	shan'he'de'zhi'er'bu'lun	0
善念日生	shan'nian'ri'sheng	0
善瑞日昌	shan'rui'ri'chang	0
善瑞日生	shan'rui'ri'sheng	0
善瑞显明	shan'rui'xian'ming	0
善瑞自至	shan'rui'zi'zhi	0
善祥自集	shan'xiang'zi'ji	0
上补真人	shang'bu'zhen'ren	0
上朝玄都上宫	shang'chao'xuan'du'shang'gong	0
上出黄气	shang'chu'huang'qi	0
上导洪精于士天	shang'dao'hong'jing'yu'shi'tian	0
上导九天之和气	shang'dao'jiu'tian'zhi'he'qi	0
上导泰清玄元之灵化	shang'dao'tai'qing'xuan'yuan'zhi'ling'hua	0
上导五帝之流炁	shang'dao'wu'di'zhi'liu'qi	0
上登福堂	shang'deng'fu'tang	0
上登上清灵阙太微之馆	shang'deng'shang'qing'ling'que'tai'wei'zhi'guan	0
上登玄洞	shang'deng'xuan'dong	0
上等自然之和	shang'deng'zi'ran'zhi'he	0
上帝赤文	shang'di'chi'wen	0
上帝即除为监天	shang'di'ji'chu'wei'jian'tian	0
上帝所贵	shang'di'suo'gui	0
上帝所举	shang'di'suo'ju	0
上帝之所	shang'di'zhi'suo	0
上对帝君	shang'dui'di'jun	0
上二十四字	shang'er'shi'si'zi	0
上宫记名	shang'gong'ji'ming	0
上古天师君	shang'gu'tian'shi'jun	0
上号东方青牙九炁之天	shang'hao'dong'fang'qing'ya'jiu'qi'zhi'tian	0
上号明石七炁之天	shang'hao'ming'shi'qi'qi'zhi'tian	0
上号南方朱丹三炁之天	shang'hao'nan'fang'zhu'dan'san'qi'zhi'tian	0
上号玄滋五炁之天	shang'hao'xuan'zi'wu'qi'zhi'tian	0
上号中央元洞太帝之天	shang'hao'zhong'yang'yuan'dong'tai'di'zhi'tian	0
上会高皇天	shang'hui'gao'huang'tian	0
上会灵宝太玄都	shang'hui'ling'bao'tai'xuan'dou	0
上会灵宝太玄都玉京朱宫	shang'hui'ling'bao'tai'xuan'dou'yu'jing'zhu'gong	0
上会灵宝玄都	shang'hui'ling'bao'xuan'du	0
上会玄都	shang'hui'xuan'du	0
上精在天为五星	shang'jing'zai'tian'wei'wu'xing	0
赏箓于上三天玄都紫微上宫	shang'lu'yu'shang'san'tian'xuan'du'zi'wei'shang'gong	0
上名三天	shang'ming'san'tian	0
上启十二灵瑞	shang'qi'shi'er'ling'rui	0
上庆九天之灵奥	shang'qing'jiu'tian'zhi'ling'ao	0
上庆神真	shang'qing'shen'zhen	0
上清自然之灵书	shang'qing'zi'ran'zhi'ling'shu	0
上三十二字	shang'san'shi'er'zi	0
上上太乙君	shang'shang'tai'yi'jun	0
上升道堂	shang'sheng'dao'tang	0
上圣奉之以致真	shang'sheng'feng'zhi'yi'zhi'zhen	0
上升福堂	shang'sheng'fu'tang	0
上升天堂	shang'sheng'tian'tang	0
上圣五老	shang'sheng'wu'lao	0
上升云路	shang'sheng'yun'lu	0
上圣诸君丈人为友	shang'sheng'zhu'jun'zhang'ren'wei'you	0
上世父母	shang'shi'fu'mu	0
上四十八字	shang'si'shi'ba'zi	0
上四十字	shang'si'shi'zi	0
上太一自下	shang'tai'yi'zi'xia	0
上天言人之罪	shang'tian'yan'ren'zhi'zui	0
上天右别	shang'tian'you'bie	0
上为真人	shang'wei'zhen'ren	0
上谓之灵	shang'wei'zhi'ling	0
上下通直	shang'xia'tong'zhi	0
上下中央	shang'xia'zhong'yang	0
上相司马青童	shang'xiang'si'ma'qing'tong	0
上玄老	shang'xuan'lao	0
上言东华	shang'yan'dong'hua	0
上炎流烟	shang'yan'liu'yan	0
上延七祖	shang'yan'qi'zu	0
上诣方诸束华青宫	shang'yi'fang'zhu'shu'hua'qing'gong	0
上诣中黄老君于	shang'yi'zhong'huang'lao'jun'yu	0
上应列星	shang'ying'lie'xing	0
上有长生之朱宫	shang'you'chang'sheng'zhi'zhu'gong	0
上有流英之宫	shang'you'liu'ying'zhi'gong	0
上有流英之楼	shang'you'liu'ying'zhi'lou	0
上有始生	shang'you'shi'sheng	0
上元大劫之交	shang'yuan'da'jie'zhi'jiao	0
上元大劫之灾	shang'yuan'da'jie'zhi'zai	0
上元大劫之周	shang'yuan'da'jie'zhi'zhou	0
上赞元始之灵图	shang'zan'yuan'shi'zhi'ling'tu	0
上赞元始自然之章	shang'zan'yuan'shi'zi'ran'zhi'zhang	0
上真之琼腴	shang'zhen'zhi'qiong'yu	0
上制天机	shang'zhi'tian'ji	0
上奏帝君	shang'zou'di'jun	0
少年不老	shao'nian'bu'lao	0
烧香念道	shao'xiang'nian'dao	0
烧香散华	shao'xiang'san'hua	0
烧香行道	shao'xiang'xing'dao	0
摄地束灵	she'di'shu'ling	0
摄炁监真	she'qi'jian'zhen	0
摄气举仙	she'qi'ju'xian	0
摄送火宫	she'song'huo'gong	0
摄召九天	she'zhao'jiu'tian	0
摄召万气	she'zhao'wan'qi	0
神宝君	shen'bao'jun	0
神宝丈人	shen'bao'zhang'ren	0
神表五方	shen'biao'wu'fang	0
身得神仙	shen'de'shen'xian	0
身覩太平	shen'du'tai'ping	0
神风既鼓	shen'feng'ji'gu	0
神风遐着	shen'feng'xia'zhe	0
身过万疠之中	shen'guo'wan'li'zhi'zhong	0
神虎仰号	shen'hu'yang'hao	0
身即死	shen'ji'si	0
身康气强	shen'kang'qi'qiang	0
神灵佑护	shen'ling'you'hu	0
神明交通	shen'ming'jiao'tong	0
神明交游	shen'ming'jiao'you	0
神明君	shen'ming'jun	0
神明卫护	shen'ming'wei'hu	0
神奇堂堂	shen'qi'tang'tang	0
慎轻服御	shen'qing'fu'yu	0
身生羽服	shen'sheng'yu'fu	0
身无横患	shen'wu'heng'huan	0
身无疾病	shen'wu'ji'bing	0
神霞焕烂	shen'xia'huan'lan	0
神仙度世	shen'xian'du'shi	0
神仙受命	shen'xian'shou'ming	0
神仙所出	shen'xian'suo'chu	0
神仙所聚	shen'xian'suo'ju	0
身香体洁	shen'xiang'ti'jie	0
申酉之年	shen'you'zhi'nian	0
神运灵虚于寂台	shen'yun'ling'xu'yu'ji'tai	0
神咒流行	shen'zhou'liu'xing	0
生白精宝华七叶神	sheng'bai'jing'bao'hua'qi'ye'shen	0
生成兆民	sheng'cheng'zhao'min	0
生丹精宝华三叶神	sheng'dan'jing'bao'hua'san'ye'shen	0
生黄精宝华十二叶神	sheng'huang'jing'bao'hua'shi'er'ye'shen	0
生九炁青天	sheng'jiu'qi'qing'tian	0
生七炁素天	sheng'qi'qi'su'tian	0
生炁丈人	sheng'qi'zhang'ren	0
生青精宝华九叶神	sheng'qing'jing'bao'hua'jiu'ye'shen	0
升入无形	sheng'ru'wu'xing	0
生三炁丹天	sheng'san'qi'dan'tian	0
生死为仙	sheng'si'wei'xian	0
生天立地	sheng'tian'li'di	0
生为男身	sheng'wei'nan'shen	0
生五气玄天	sheng'wu'qi'xuan'tian	0
生玄精宝华五叶神	sheng'xuan'jing'bao'hua'wu'ye'shen	0
生于空洞之中	sheng'yu'kong'dong'zhi'zhong	0
生于元始之先	sheng'yu'yuan'shi'zhi'xian	0
生元一黄炁之天	sheng'yuan'yi'huang'qi'zhi'tian	0
圣者见之谓之圣	sheng'zhe'jian'zhi'wei'zhi'sheng	0
施安所住如法	shi'an'suo'zhu'ru'fa	0
施八威以正度	shi'ba'wei'yi'zheng'du	0
十八者老年反少	shi'ba'zhe'lao'nian'fan'shao	0
世出贤明	shi'chu'xian'ming	0
施德所延	shi'de'suo'yan	0
使地固安	shi'di'gu'an	0
师弟子对斋九日	shi'di'zi'dui'zhai'jiu'ri	0
十二念使鬼役神	shi'er'nian'shi'gui'yi'shen	0
十二炁黄天赤书玉篇真文	shi'er'qi'huang'tian'chi'shu'yu'pian'zhen'wen	0
十二为神	shi'er'wei'shen	0
十二者得与	shi'er'zhe'de'yu	0
十二者冬不冰霜	shi'er'zhe'dong'bu'bing'shuang	0
十二者功成德满	shi'er'zhe'gong'cheng'de'man	0
十二者七宝奇林	shi'er'zhe'qi'bao'qi'lin	0
十二者其德如四时	shi'er'zhe'qi'de'ru'si'shi	0
十二者一切普福	shi'er'zhe'yi'qie'pu'fu	0
十二真丈人	shi'er'zhen'zhang'ren	0
十方至真	shi'fang'zhi'zhen	0
是故关机乘之不倾	shi'gu'guan'ji'cheng'zhi'bu'qing	0
始皇青天	shi'huang'qing'tian	0
始见天关停轮	shi'jian'tian'guan'ting'lun	0
寔九天之玄根	shi'jiu'tian'zhi'xuan'gen	0
十九者鸟兽六畜	shi'jiu'zhe'niao'shou'liu'chu	0
十绝羽盖	shi'jue'yu'gai	0
十苦八难	shi'ku'ba'nan	0
氏老归宾	shi'lao'gui'bin	0
寔灵文之妙德	shi'ling'wen'zhi'miao'de	0
十六者狮子猛兽	shi'liu'zhe'shi'zi'meng'shou	0
十念畜牧已下	shi'nian'xu'mu'yi'xia	0
十七者天下男女	shi'qi'zhe'tian'xia'nan'nv	0
十三为人	shi'san'wei'ren	0
十三者功德之大	shi'san'zhe'gong'de'zhi'da	0
十三者林木禾稼	shi'san'zhe'lin'mu'he'jia	0
十三者其德如泰山	shi'san'zhe'qi'de'ru'tai'shan	0
是上天八会大庆之日也	shi'shang'tian'ba'hui'da'qing'zhi'ri'ye	0
始生五老	shi'sheng'wu'lao	0
世世安宁	shi'shi'an'ning	0
是时上圣太上大道君	shi'shi'shang'sheng'tai'shang'da'dao'jun	0
是时天降十二玄瑞	shi'shi'tian'jiang'shi'er'xuan'rui	0
世世兴隆	shi'shi'xing'long	0
是时学者	shi'shi'xue'zhe	0
十四为一切万物	shi'si'wei'yi'qie'wan'wu	0
十四者功言	shi'si'zhe'gong'yan	0
十四者其德如大江	shi'si'zhe'qi'de'ru'da'jiang	0
十四者四气调和	shi'si'zhe'si'qi'tiao'he	0
是天北元玄斗中书也	shi'tian'bei'yuan'xuan'dou'zhong'shu'ye	0
视天音于金格	shi'tian'yin'yu'jin'ge	0
侍卫身形	shi'wei'shen'xing	0
十为世间	shi'wei'shi'jian	0
侍卫五帝神官	shi'wei'wu'di'shen'guan	0
侍卫左右	shi'wei'zuo'you	0
十五者毒螫闭齿	shi'wu'zhe'du'shi'bi'chi	0
世享王侯	shi'xiang'wang'hou	0
十一念志远荣华	shi'yi'nian'zhi'yuan'rong'hua	0
施一十二念	shi'yi'shi'er'nian	0
施一十四福	shi'yi'shi'si'fu	0
适意所欲	shi'yi'suo'yu	0
十一为天	shi'yi'wei'tian	0
使依玄科	shi'yi'xuan'ke	0
使以应天之炁	shi'yi'ying'tian'zhi'qi	0
十一月	shi'yi'yue	0
十一者甘露自生	shi'yi'zhe'gan'lu'zi'sheng	0
十一者其德如风	shi'yi'zhe'qi'de'ru'feng	0
十一者是时悬下七宝神奇	shi'yi'zhe'shi'shi'xuan'xia'qi'bao'shen'qi	0
十一者寿骨日生	shi'yi'zhe'shou'gu'ri'sheng	0
十一者为	shi'yi'zhe'wei	0
十一者仙度之后	shi'yi'zhe'xian'du'zhi'hou	0
室有青腰玉女	shi'you'qing'yao'yu'nv	0
室有太丹玉女	shi'you'tai'dan'yu'nv	0
室有太上素女	shi'you'tai'shang'su'nv	0
室有夜光玉女	shi'you'ye'guang'yu'nv	0
十者河水停流	shi'zhe'he'shui'ting'liu	0
十者其德如云雨	shi'zhe'qi'de'ru'yun'yu	0
十者五镇安立	shi'zhe'wu'zhen'an'li	0
十者斩邪破敌	shi'zhe'zhan'xie'po'di	0
十者志无不克	shi'zhe'zhi'wu'bu'ke	0
十者卒得上仙	shi'zhe'zu'dei'shang'xian	0
侍真五帝神官五亿万人	shi'zhen'wu'di'shen'guan'wu'yi'wan'ren	0
施镇五岳	shi'zhen'wu'yue	0
狮子	shi'zi	0
狮子俯呜	shi'zi'fu'wu	0
受符北元	shou'fu'bei'yuan	0
受俯仰之格	shou'fu'yang'zhi'ge	0
收甘津于舌头	shou'gan'jin'yu'she'tou	0
受其生成	shou'qi'sheng'cheng	0
收摄邪奸	shou'she'xie'jian	0
受生乎玄孕之胞	shou'sheng'hu'xuan'yun'zhi'bao	0
寿同天地	shou'tong'tian'di	0
受仙南宫	shou'xian'nan'gong	0
收真人而为友	shou'zhen'ren'er'wei'you	0
书东桑司灵之馆	shu'dong'sang'si'ling'zhi'guan	0
书九天东北玉阙丹台	shu'jiu'tian'dong'bei'yu'que'dan'tai	0
书九天洞阳之馆	shu'jiu'tian'dong'yang'zhi'guan	0
书九天素灵宫北轩之上	shu'jiu'tian'su'ling'gong'bei'xuan'zhi'shang	0
书九天元台	shu'jiu'tian'yuan'tai	0
书名仙簿	shu'ming'xian'bu	0
书名玉历	shu'ming'yu'li	0
束魔送鬼	shu'mo'song'gui	0
书三炁丹台	shu'san'qi'dan'tai	0
漱神津于元首	shu'shen'jin'yu'yuan'shou	0
束送魔宗	shu'song'mo'zong	0
书太玄玉宝玄台	shu'tai'xuan'yu'bao'xuan'tai	0
书文佩身	shu'wen'pei'shen	0
书文置东方	shu'wen'zhi'dong'fang	0
数元鞅数万重道气君	shu'yuan'yang'shu'wan'zhong'dao'qi'jun	0
书紫微宫东华殿	shu'zi'wei'gong'dong'hua'dian	0
双皇太微	shuang'huang'tai'wei	0
水府开道	shui'fu'kai'dao	0
水陌洞开	shui'mo'dong'kai	0
水涌河决	shui'yong'he'jue	0
水灾连天	shui'zai'lian'tian	0
水之盈缩	shui'zhi'ying'suo	0
四部刺奸	si'bu'ci'jian	0
司察人神功过深浅	si'cha'ren'shen'gong'guo'shen'qian	0
司察善恶功过轻重	si'cha'shan'e'gong'guo'qing'zhong	0
司察天人善恶	si'cha'tian'ren'shan'e	0
司察兆民功过轻重	si'cha'zhao'min'gong'guo'qing'zhong	0
四帝共典卫于上宫	si'di'gong'dian'wei'yu'shang'gong	0
四方安平	si'fang'an'ping	0
四方和睦	si'fang'he'mu	0
斯功至重	si'gong'zhi'zhong	0
四海水帝	si'hai'shui'di	0
四极真人	si'ji'zhen'ren	0
四景回旋	si'jing'hui'xuan	0
四景朗清	si'jing'lang'qing	0
司考所糺	si'kao'suo'jiu	0
思灵念真	si'ling'nian'zhen	0
司录	si'lu	0
四面八方	si'mian'ba'fang	0
司命	si'ming	0
四念愿求神仙	si'nian'yuan'qiu'shen'xian	0
四炁驱除	si'qi'qu'chu	0
四气柔和	si'qi'rou'he	0
四泉之水	si'quan'zhi'shui	0
司人功过	si'ren'gong'guo	0
司杀善恶功过	si'sha'shan'e'gong'guo	0
四万劫六天气消	si'wan'jie'liu'tian'qi'xiao	0
四万劫一出	si'wan'jie'yi'chu	0
四万劫一开	si'wan'jie'yi'kai	0
四为居山	si'wei'ju'shan	0
斯文隐秘	si'wen'yin'mi	0
巳午之年	si'wu'zhi'nian	0
思仙念道	si'xian'nian'dao	0
私心实欲使云荫八遐	si'xin'shi'yu'shi'yun'yin'ba'xia	0
斯一十四德	si'yi'shi'si'de	0
四运齐晨	si'yun'qi'chen	0
四者白虎吐金	si'zhe'bai'hu'tu'jin	0
四者德慧长新	si'zhe'de'hui'chang'xin	0
四者其德如天	si'zhe'qi'de'ru'tian	0
四者世间万姓敬奉	si'zhe'shi'jian'wan'xing'jing'feng	0
四者是时上圣大神	si'zhe'shi'shi'shang'sheng'da'shen	0
死者无遗	si'zhe'wu'yi	0
四者招财致禄	si'zhe'zhao'cai'zhi'lu	0
诵经行道	song'jing'xing'dao	0
诵咏洞章	song'yong'dong'zhang	0
搜择种人	sou'ze'zhong'ren	0
宿简玉文	su'jian'yu'wen	0
宿考解散	su'kao'jie'san	0
算会簿录	suan'hui'bu'lu	0
筭校五岳四渎河海水帝	suan'xiao'wu'yue'si'du'he'hai'shui'di	0
筭校玉札金名	suan'xiao'yu'zha'jin'ming	0
虽鼎味而不殊	sui'ding'wei'er'bu'shu	0
虽尔	sui'er	0
岁星辅肝	sui'xing'fu'gan	0
随运沉浮	sui'yun'chen'fu	0
所向所求	suo'xiang'suo'qiu	0
所以采之者无终	suo'yi'cai'zhi'zhe'wu'zhong	0
所以存之者若遂	suo'yi'cun'zhi'zhe'ruo'sui	0
所以尔者	suo'yi'er'zhe	0
所以为之者长存	suo'yi'wei'zhi'zhe'chang'cun	0
所以营溉之者无极	suo'yi'ying'gai'zhi'zhe'wu'ji	0
所在司迎	suo'zai'si'ying	0
所诛无蠲	suo'zhu'wu'juan	0
他念秽浊于口	ta'nian'hui'zhuo'yu'kou	0
太白检肺	tai'bai'jian'fei	0
太伯龙王	tai'bo'long'wang	0
太初君	tai'chu'jun	0
太初丈人	tai'chu'zhang'ren	0
太丹玉女三人侍卫	tai'dan'yu'nv'san'ren'shi'wei	0
太帝君	tai'di'jun	0
太帝丈人	tai'di'zhang'ren	0
太和君	tai'he'jun	0
太和玉女	tai'he'yu'nv	0
太和丈人	tai'he'zhang'ren	0
太华流氛	tai'hua'liu'fen	0
太华执巾	tai'hua'zhi'jin	0
太极上宫	tai'ji'shang'gong	0
太平君	tai'ping'jun	0
太平丈人	tai'ping'zhang'ren	0
太清君	tai'qing'jun	0
太清三十六真君	tai'qing'san'shi'liu'zhen'jun	0
太清十二真君	tai'qing'shi'er'zhen'jun	0
太清玄元上三天元极大道	tai'qing'xuan'yuan'shang'san'tian'yuan'ji'da'dao	0
太清玉陛下	tai'qing'yu'bi'xia	0
太清丈人	tai'qing'zhang'ren	0
泰山二十四狱罪刑簿目	tai'shan'er'shi'si'yu'zui'xing'bu'mu	0
太上大道君受于元始天尊	tai'shang'da'dao'jun'shou'yu'yuan'shi'tian'zun	0
太上大道君受之于元始天尊	tai'shang'da'dao'jun'shou'zhi'yu'yuan'shi'tian'zun	0
太上道德君	tai'shang'dao'de'jun	0
太上道君启问不已	tai'shang'dao'jun'qi'wen'bu'yi	0
太上皇真道君	tai'shang'huang'zhen'dao'jun	0
太上老君	tai'shang'lao'jun	0
太上三气君	tai'shang'san'qi'jun	0
太上所传黄帝	tai'shang'suo'chuan'huang'di	0
太上万度万生神皇	tai'shang'wan'du'wan'sheng'shen'huang	0
太上无极	tai'shang'wu'ji	0
太上五老君	tai'shang'wu'lao'jun	0
太上无为大道诸君丈人	tai'shang'wu'wei'da'dao'zhu'jun'zhang'ren	0
太上玉真君	tai'shang'yu'zhen'jun	0
太上元君丈人	tai'shang'yuan'jun'zhang'ren	0
太上丈人	tai'shang'zhang'ren	0
太始君	tai'shi'jun	0
太始丈人	tai'shi'zhang'ren	0
太素君	tai'su'jun	0
太素玉女七人侍卫	tai'su'yu'nv'qi'ren'shi'wei	0
太素丈人	tai'su'zhang'ren	0
太岁某子某月朔某日子	tai'sui'mou'zi'mou'yue'shuo'mou'ri'zi	0
太虚君	tai'xu'jun	0
太虚丈人	tai'xu'zhang'ren	0
太玄都玉京黄房	tai'xuan'dou'yu'jing'huang'fang	0
太玄上宫北帝	tai'xuan'shang'gong'bei'di	0
太玄上宫高真大神	tai'xuan'shang'gong'gao'zhen'da'shen	0
太玄上宫天上三官	tai'xuan'shang'gong'tian'shang'san'guan	0
太玄上宫天真众仙	tai'xuan'shang'gong'tian'zhen'zhong'xian	0
太玄上宫五帝	tai'xuan'shang'gong'wu'di	0
太玄上宫五岳诸真人	tai'xuan'shang'gong'wu'yue'zhu'zhen'ren	0
太玄上宫阳台真人	tai'xuan'shang'gong'yang'tai'zhen'ren	0
太玄上宫至真尊神	tai'xuan'shang'gong'zhi'zhen'zun'shen	0
太玄上官上皇大帝	tai'xuan'shang'guan'shang'huang'da'di	0
太玄上官太素真人	tai'xuan'shang'guan'tai'su'zhen'ren	0
太玄上一君	tai'xuan'shang'yi'jun	0
太玄玉女五人侍卫	tai'xuan'yu'nv'wu'ren'shi'wei	0
太玄丈人	tai'xuan'zhang'ren	0
太阳待之以明	tai'yang'dai'zhi'yi'ming	0
太阳激喷	tai'yang'ji'pen	0
太一欢喜	tai'yi'huan'xi	0
太一君	tai'yi'jun	0
太仪君	tai'yi'jun	0
太乙使者	tai'yi'shi'zhe	0
太一丈人	tai'yi'zhang'ren	0
太乙丈人	tai'yi'zhang'ren	0
太仪丈人	tai'yi'zhang'ren	0
太元君	tai'yuan'jun	0
太渊君	tai'yuan'jun	0
太元一君	tai'yuan'yi'jun	0
太元一君丈人	tai'yuan'yi'jun'zhang'ren	0
太元丈人	tai'yuan'zhang'ren	0
太渊丈人	tai'yuan'zhang'ren	0
太真按笔	tai'zhen'an'bi	0
堂有太上真王	tang'you'tai'shang'zhen'wang	0
堂有元气大夫	tang'you'yuan'qi'dai'fu	0
堂有元炁丈人	tang'you'yuan'qi'zhang'ren	0
题金阙之玄窗	ti'jin'que'zhi'xuan'chuang	0
提携仙人	ti'xie'xian'ren	0
题于西南阳正玉阙	ti'yu'xi'nan'yang'zheng'yu'que	0
天宝君	tian'bao'jun	0
天宝丈人	tian'bao'zhang'ren	0
天宝之以致浮	tian'bao'zhi'yi'zhi'fu	0
天仓玉女却死养生	tian'cang'yu'nv'que'si'yang'sheng	0
天地乘之以分判	tian'di'cheng'zhi'yi'fen'pan	0
天地大劫之欲交	tian'di'da'jie'zhi'yu'jiao	0
天地得之而分判	tian'di'de'zhi'er'fen'pan	0
天地分判	tian'di'fen'pan	0
天地父母	tian'di'fu'mu	0
天地改易	tian'di'gai'yi	0
天地俱存	tian'di'ju'cun	0
天帝君	tian'di'jun	0
天地开张	tian'di'kai'zhang	0
天地溟涬	tian'di'ming'xing	0
天地淇津	tian'di'qi'jin	0
天地守以不亏	tian'di'shou'yi'bu'kui	0
天地未根	tian'di'wei'gen	0
天地运度	tian'di'yun'du	0
天帝丈人	tian'di'zhang'ren	0
天地周	tian'di'zhou	0
天帝自下者	tian'di'zi'xia'zhe	0
天官	tian'guan	0
天官导从	tian'guan'dao'cong	0
天光开阳	tian'guang'kai'yang	0
天号之灵	tian'hao'zhi'ling	0
天皇老君	tian'huang'lao'jun	0
天皇丈人	tian'huang'zhang'ren	0
天钧奏其袊盖	tian'jun'zou'qi'ling'gai	0
天炁勃于金宫	tian'qi'bo'yu'jin'gong	0
天炁勃于木宫	tian'qi'bo'yu'mu'gong	0
天炁勃于水宫	tian'qi'bo'yu'shui'gong	0
天炁勃于土宫	tian'qi'bo'yu'tu'gong	0
天炁反一劫之灾	tian'qi'fan'yi'jie'zhi'zai	0
天炁激于火宫	tian'qi'ji'yu'huo'gong	0
天炁激于木宫	tian'qi'ji'yu'mu'gong	0
天炁激于水宫	tian'qi'ji'yu'shui'gong	0
天炁激于土宫	tian'qi'ji'yu'tu'gong	0
天气柔顺而无极	tian'qi'rou'shun'er'wu'ji	0
天炁一交	tian'qi'yi'jiao	0
天炁中开运	tian'qi'zhong'kai'yun	0
天人称庆	tian'ren'cheng'qing	0
天人歌咏	tian'ren'ge'yong	0
天人无害	tian'ren'wu'hai	0
天人悦庆	tian'ren'yue'qing	0
天上天下	tian'shang'tian'xia	0
天神记名	tian'shen'ji'ming	0
天神侍护	tian'shen'shi'hu	0
天师丈人	tian'shi'zhang'ren	0
天无五文	tian'wu'wu'wen	0
天无昼夜	tian'wu'zhou'ye	0
天下	tian'xia	0
天下歌唱	tian'xia'ge'chang	0
天下燋枯	tian'xia'jiao'ku	0
天下燋烧	tian'xia'jiao'shao	0
天玄地张	tian'xuan'di'zhang	0
天颜愍论	tian'yan'min'lun	0
天有九元	tian'you'jiu'yuan	0
天元分度	tian'yuan'fen'du	0
天灾荡民	tian'zai'dang'min	0
天真妙重	tian'zhen'miao'zhong	0
天真所尊	tian'zhen'suo'zun	0
天之极	tian'zhi'ji	0
天致元精于太极	tian'zhi'yuan'jing'yu'tai'ji	0
天致元精于太玄真人	tian'zhi'yuan'jing'yu'tai'xuan'zhen'ren	0
天中黄庭戊己	tian'zhong'huang'ting'wu'ji	0
天子得之以致治	tian'zi'de'zhi'yi'zhi'zhi	0
天子侯王奉之	tian'zi'hou'wang'feng'zhi	0
儵欻自玄	tiao'chua'zi'xuan	0
条列善恶	tiao'lie'shan'e	0
条人罪状	tiao'ren'zui'zhuang	0
条正鬼事	tiao'zheng'gui'shi	0
挺自然之运表	ting'zi'ran'zhi'yun'biao	0
同出太玄都	tong'chu'tai'xuan'dou	0
同到帝门	tong'dao'di'men	0
同会云庭	tong'hui'yun'ting	0
通径百千	tong'jing'bai'qian	0
同学之人	tong'xue'zhi'ren	0
统御四乡	tong'yu'si'xiang	0
头戴白精玉冠	tou'dai'bai'jing'yu'guan	0
头戴赤精玉冠	tou'dai'chi'jing'yu'guan	0
头戴黄精玉冠	tou'dai'huang'jing'yu'guan	0
头戴青精玉冠	tou'dai'qing'jing'yu'guan	0
头戴玄精玉冠	tou'dai'xuan'jing'yu'guan	0
土地陷没	tu'di'xian'mo	0
吐神祝以遐震	tu'shen'zhu'yi'xia'zhen	0
土雾障天	tu'wu'zhang'tian	0
土中生火	tu'zhong'sheng'huo	0
推数劫会	tui'shu'jie'hui	0
推校运度	tui'xiao'yun'du	0
外有醴泉玉浆之池	wai'you'li'quan'yu'jiang'zhi'chi	0
万道父母	wan'dao'fu'mu	0
万德父母	wan'de'fu'mu	0
万帝朝真	wan'di'chao'zhen	0
万帝众神	wan'di'zhong'shen	0
万福君	wan'fu'jun	0
万福丈人	wan'fu'zhang'ren	0
万劫无穷	wan'jie'wu'qiong	0
万里无烟	wan'li'wu'yan	0
万民自死	wan'min'zi'si	0
万民罪简深重	wan'min'zui'jian'shen'zhong	0
万品存焉	wan'pin'cun'yan	0
万气扬津	wan'qi'yang'jin	0
万气丈人	wan'qi'zhang'ren	0
万神卫护	wan'shen'wei'hu	0
万生丈人	wan'sheng'zhang'ren	0
万试摧亡	wan'shi'cui'wang	0
万物一时消灭	wan'wu'yi'shi'xiao'mie	0
万无遗一	wan'wu'yi'yi	0
万妖灭摧	wan'yao'mie'cui	0
万疫驱除	wan'yi'qu'chu	0
万愿如心	wan'yuan'ru'xin	0
万元丈人	wan'yuan'zhang'ren	0
万灾不干	wan'zai'bu'gan	0
万灾不经	wan'zai'bu'jing	0
万灾不生	wan'zai'bu'sheng	0
万灾四充	wan'zai'si'chong	0
万灾消亡	wan'zai'xiao'wang	0
万中遗一	wan'zhong'yi'yi	0
胃昂毕觜	wei'ang'bi'zui	0
谓大百六	wei'da'bai'liu	0
为大劫更始	wei'da'jie'geng'shi	0
谓大阳九	wei'da'yang'jiu	0
为大阳九之灾	wei'da'yang'jiu'zhi'zai	0
未得行于下世	wei'de'xing'yu'xia'shi	0
为恶犯戒	wei'e'fan'jie	0
威伏八方	wei'fu'ba'fang	0
威灵恢廓	wei'ling'hui'kuo	0
唯清为贵	wei'qing'wei'gui	0
惟清斋合式	wei'qing'zhai'he'shi	0
为神明之宝	wei'shen'ming'zhi'bao	0
为神明之宗	wei'shen'ming'zhi'zong	0
为圣君种民	wei'sheng'jun'zhong'min	0
为使存之不绝	wei'shi'cun'zhi'bu'jue	0
为世桥梁	wei'shi'qiao'liang	0
为太乙所举	wei'tai'yi'suo'ju	0
为太一所举言	wei'tai'yi'suo'ju'yan	0
为天地大灾	wei'tian'di'da'zai	0
为天地之根	wei'tian'di'zhi'gen	0
为天中之尊	wei'tian'zhong'zhi'zun	0
为万气之根	wei'wan'qi'zhi'gen	0
为万物之尊	wei'wan'wu'zhi'zun	0
巍巍乎太空	wei'wei'hu'tai'kong	0
巍巍乎太虚	wei'wei'hu'tai'xu	0
为无始之宗	wei'wu'shi'zhi'zong	0
谓小百六	wei'xiao'bai'liu	0
谓小阳九六天炁上	wei'xiao'yang'jiu'liu'tian'qi'shang	0
为役使通灵致神仙	wei'yi'shi'tong'ling'zhi'shen'xian	0
未有光明	wei'you'guang'ming	0
为之者永居	wei'zhi'zhe'yong'ju	0
为众道之尊	wei'zhong'dao'zhi'zun	0
文势曲折	wen'shi'qu'zhe	0
勿不精	wu'bu'jing	0
无尘埃之是恋	wu'chen'ai'zhi'shi'lian	0
五道开涂	wu'dao'kai'tu	0
五帝符	wu'di'fu	0
五帝辅翼	wu'di'fu'yi	0
五帝四司真人	wu'di'si'si'zhen'ren	0
五帝所敬	wu'di'suo'jing	0
五帝纹彩五匹	wu'di'wen'cai'wu'pi	0
五帝掌之以得镇	wu'di'zhang'zhi'yi'de'zhen	0
五帝真符	wu'di'zhen'fu	0
五方运关三十二覆	wu'fang'yun'guan'san'shi'er'fu	0
无复光明	wu'fu'guang'ming	0
无敢疾伤	wu'gan'ji'shang	0
无根冥寂玄通大智慧原	wu'gen'ming'ji'xuan'tong'da'zhi'hui'yuan	0
五宫清明	wu'gong'qing'ming	0
五谷大贵	wu'gu'da'gui	0
五谷丰而无食民	wu'gu'feng'er'wu'shi'min	0
五谷丰熟	wu'gu'feng'shu	0
无毫不载	wu'hao'bu'zai	0
无极大道	wu'ji'da'dao	0
无极太上元君	wu'ji'tai'shang'yuan'jun	0
无极无穷	wu'ji'wu'qiong	0
五苦八难	wu'ku'ba'nan	0
五老灵宝五篇真文	wu'lao'ling'bao'wu'pian'zhen'wen	0
五老玉篇	wu'lao'yu'pian	0
五老掌录	wu'lao'zhang'lu	0
无吏可随	wu'li'ke'sui	0
无量洞明	wu'liang'dong'ming	0
五灵玄老帝君	wu'ling'xuan'lao'di'jun	0
五念度诸苦难	wu'nian'du'zhu'ku'nan	0
五年皆生黑精宝华五重	wu'nian'jie'sheng'hei'jing'bao'hua'wu'zhong	0
五气君	wu'qi'jun	0
五炁徘徊	wu'qi'pai'huai	0
五气丈人	wu'qi'zhang'ren	0
无上万福君	wu'shang'wan'fu'jun	0
无上万气君	wu'shang'wan'qi'jun	0
无上万生君	wu'shang'wan'sheng'jun	0
无上万元君	wu'shang'wan'yuan'jun	0
无上无巅	wu'shang'wu'dian	0
无上玄老	wu'shang'xuan'lao	0
无失毫分	wu'shi'hao'fen	0
无所隐匿	wu'suo'yin'ni	0
五为修道	wu'wei'xiu'dao	0
五仙君	wu'xian'jun	0
无先寥廓无端	wu'xian'liao'kuo'wu'duan	0
五仙丈人	wu'xian'zhang'ren	0
无形荡荡	wu'xing'dang'dang	0
五星皇妃	wu'xing'huang'fei	0
五星真君	wu'xing'zhen'jun	0
无鞅数众	wu'yang'shu'zhong	0
无以立形	wu'yi'li'xing	0
无幽不彻	wu'you'bu'che	0
无幽不开	wu'you'bu'kai	0
无有凋伤	wu'you'diao'shang	0
无有毁沦	wu'you'hui'lun	0
无有伤疾	wu'you'shang'ji	0
无有天年	wu'you'tian'nian	0
无有幽隐	wu'you'you'yin	0
无有折伤	wu'you'zhe'shang	0
无有昼夜	wu'you'zhou'ye	0
无有祖宗	wu'you'zu'zong	0
五狱保之以长存	wu'yu'bao'zhi'yi'chang'cun	0
五岳	wu'yue	0
五月	wu'yue	0
五岳保镇	wu'yue'bao'zhen	0
五岳不灵	wu'yue'bu'ling	0
五岳从之以得灵	wu'yue'cong'zhi'yi'de'ling	0
五岳飞仙	wu'yue'fei'xian	0
五岳名山学人及得道兆庶	wu'yue'ming'shan'xue'ren'ji'de'dao'zhao'shu	0
五岳四渎	wu'yue'si'du	0
五岳四渎河海大神	wu'yue'si'du'he'hai'da'shen	0
五灾之中	wu'zai'zhi'zhong	0
五者其德如地	wu'zhe'qi'de'ru'di	0
五者青龙奉符	wu'zhe'qing'long'feng'fu	0
五者神童玉女	wu'zhe'shen'tong'yu'nv	0
五者天发自然妓乐	wu'zhe'tian'fa'zi'ran'ji'le	0
五者谓之所诣	wu'zhe'wei'zhi'suo'yi	0
五者宜后世子孙	wu'zhe'yi'hou'shi'zi'sun	0
五镇长存	wu'zhen'chang'cun	0
吾真道乃行	wu'zhen'dao'nai'xing	0
无正吏可守	wu'zheng'li'ke'shou	0
无中生有	wu'zhong'sheng'you	0
无祖无宗	wu'zu'wu'zong	0
西北玉山紫微上宫	xi'bei'yu'shan'zi'wei'shang'gong	0
西方白帝灵宝赤书玉篇	xi'fang'bai'di'ling'bao'chi'shu'yu'pian	0
西方七宝金门皓灵皇老	xi'fang'qi'bao'jin'men'hao'ling'huang'lao	0
西方七宝金门皓灵皇老帝君	xi'fang'qi'bao'jin'men'hao'ling'huang'lao'di'jun	0
西方七宝金门皓灵皇老君符命	xi'fang'qi'bao'jin'men'hao'ling'huang'lao'jun'fu'ming	0
西方七炁素天	xi'fang'qi'qi'su'tian	0
西方七灾素天	xi'fang'qi'zai'su'tian	0
西方素天	xi'fang'su'tian	0
西方凶勃恶兽毒螫皆不生害心	xi'fang'xiong'bo'e'shou'du'shi'jie'bu'sheng'hai'xin	0
西方自归	xi'fang'zi'gui	0
悉封紫微上宫	xi'feng'zi'wei'shang'gong	0
西华金堂玉仙真母	xi'hua'jin'tang'yu'xian'zhen'mu	0
西山神咒	xi'shan'shen'zhou	0
西王母	xi'wang'mu	0
希为桥梁	xi'wei'qiao'liang	0
悉诣木宫	xi'yi'mu'gong	0
下北岳	xia'bei'yue	0
下策地祇	xia'ce'di'qi	0
下东岳	xia'dong'yue	0
下发二十四应	xia'fa'er'shi'si'ying	0
下副物心	xia'fu'wu'xin	0
下和三炁之陶镕	xia'he'san'qi'zhi'tao'rong	0
下和众生于灵衢	xia'he'zhong'sheng'yu'ling'qu	0
下教于未闻者乎	xia'jiao'yu'wei'wen'zhe'hu	0
下精在地为五岳	xia'jing'zai'di'wei'wu'yue	0
下流种孙	xia'liu'zhong'sun	0
下南岳	xia'nan'yue	0
下庆神真大慈之教	xia'qing'shen'zhen'da'ci'zhi'jiao	0
下生神灵	xia'sheng'shen'ling	0
下为常山	xia'wei'chang'shan	0
下为华阴山	xia'wei'hua'yin'shan	0
下为霍山	xia'wei'huo'shan	0
下为嵩高山	xia'wei'song'gao'shan	0
下为泰山	xia'wei'tai'shan	0
下谓之宝	xia'wei'zhi'bao	0
下西岳	xia'xi'yue	0
下西岳制天分度	xia'xi'yue'zhi'tian'fen'du	0
下旋五土之灵	xia'xuan'wu'tu'zhi'ling	0
下引九泉之流芳	xia'yin'jiu'quan'zhi'liu'fang	0
下有长生之渊	xia'you'chang'sheng'zhi'yuan	0
下有赤泉之丹池	xia'you'chi'quan'zhi'dan'chi	0
下游五岳	xia'you'wu'yue	0
下有玉泉长河	xia'you'yu'quan'chang'he	0
下有朝华之渊	xia'you'zhao'hua'zhi'yuan	0
下与八极司隶	xia'yu'ba'ji'si'li	0
下与北酆都伯使者	xia'yu'bei'feng'du'bo'shi'zhe	0
下与三官九府九部刺奸	xia'yu'san'guan'jiu'fu'jiu'bu'ci'jian	0
下与三官考召	xia'yu'san'guan'kao'zhao	0
下元小阳九小百六	xia'yuan'xiao'yang'jiu'xiao'bai'liu	0
下元玄黄洞渊洞灵万仙	xia'yuan'xuan'huang'dong'yuan'dong'ling'wan'xian	0
下赞三天之宝文	xia'zan'san'tian'zhi'bao'wen	0
下拯生生之众和	xia'zheng'sheng'sheng'zhi'zhong'he	0
下治地门	xia'zhi'di'men	0
下制东河	xia'zhi'dong'he	0
下中岳	xia'zhong'yue	0
下周行地上	xia'zhou'xing'di'shang	0
仙道日成	xian'dao'ri'cheng	0
仙度之后	xian'du'zhi'hou	0
仙炼八威	xian'lian'ba'wei	0
祆孽鬼神	xian'nie'gui'shen	0
鲜其正文	xian'qi'zheng'wen	0
仙圣所宗	xian'sheng'suo'zong	0
衔书	xian'shu	0
贤者见之谓之贤	xian'zhe'jian'zhi'wei'zhi'xian	0
向北服之五枚	xiang'bei'fu'zhi'wu'mei	0
向东服之九枚	xiang'dong'fu'zhi'jiu'mei	0
项负宝光	xiang'fu'bao'guang	0
享福无穷	xiang'fu'wu'qiong	0
向南服之三枚	xiang'nan'fu'zhi'san'mei	0
向王服之十二枚	xiang'wang'fu'zhi'shi'er'mei	0
向西服之七枚	xiang'xi'fu'zhi'qi'mei	0
向幽夜照曜无穷	xiang'you'ye'zhao'yao'wu'qiong	0
享祚无穷也	xiang'zuo'wu'qiong'ye	0
小百六	xiao'bai'liu	0
小百六丑未	xiao'bai'liu'chou'wei	0
小百六卯	xiao'bai'liu'mao	0
小百六午	xiao'bai'liu'wu	0
小百六酉	xiao'bai'liu'you	0
小百六子	xiao'bai'liu'zi	0
校地上人鬼功过	xiao'di'shang'ren'gui'gong'guo	0
校地上兆民	xiao'di'shang'zhao'min	0
校定灵宝真经学者	xiao'ding'ling'bao'zhen'jing'xue'zhe	0
校定学者功过	xiao'ding'xue'zhe'gong'guo	0
校定兆民	xiao'ding'zhao'min	0
校定众仙名录	xiao'ding'zhong'xian'ming'lu	0
啸歌邕邕	xiao'ge'yong'yong	0
小劫	xiao'jie	0
小劫符命	xiao'jie'fu'ming	0
小劫之交	xiao'jie'zhi'jiao	0
啸朗九玄	xiao'lang'jiu'xuan	0
啸命河源	xiao'ming'he'yuan	0
啸命十天	xiao'ming'shi'tian	0
校天宿周行	xiao'tian'su'zhou'hang	0
校天下学道	xiao'tian'xia'xue'dao	0
啸五帝以召龙	xiao'wu'di'yi'zhao'long	0
校学道簿录名目轻重深浅	xiao'xue'dao'bu'lu'ming'mu'qing'zhong'shen'qian	0
小阳九辰戌	xiao'yang'jiu'chen'xu	0
小阳九亥	xiao'yang'jiu'hai	0
小阳九申	xiao'yang'jiu'shen	0
小阳九巳	xiao'yang'jiu'si	0
小阳九寅	xiao'yang'jiu'yin	0
逍遥取道于玄元之根	xiao'yao'qu'dao'yu'xuan'yuan'zhi'gen	0
邪谄假伪	xie'chan'jia'wei	0
心聪体圣	xin'cong'ti'sheng	0
心端神定	xin'duan'shen'ding	0
欣国太平	xin'guo'tai'ping	0
心所希愿	xin'suo'xi'yuan	0
欣五老之开明	xin'wu'lao'zhi'kai'ming	0
行此宜精	xing'ci'yi'jing	0
姓洞浮	xing'dong'fu	0
姓黑节	xing'hei'jie	0
行来坐起	xing'lai'zuo'qi	0
姓上金	xing'shang'jin	0
姓通班	xing'tong'ban	0
星宿不行	xing'xiu'bu'xing	0
姓爓	xing'xun	0
形自能飞	xing'zi'neng'fei	0
凶寇自夷	xiong'kou'zi'yi	0
凶逆自消	xiong'ni'zi'xiao	0
朽骸蒙受灵奥之津	xiu'hai'meng'shou'ling'ao'zhi'jin	0
修来者之桥梁也	xiu'lai'zhe'zhi'qiao'liang'ye	0
修斋供养	xiu'zhai'gong'yang	0
修斋戒	xiu'zhai'jie	0
玄都宿有金名	xuan'du'su'you'jin'ming	0
玄都紫微宫旧格	xuan'du'zi'wei'gong'jiu'ge	0
玄都紫微宫下元格	xuan'du'zi'wei'gong'xia'yuan'ge	0
玄都紫微宫中元格	xuan'du'zi'wei'gong'zhong'yuan'ge	0
玄都紫微官中元格	xuan'du'zi'wei'guan'zhong'yuan'ge	0
玄都紫微上宫旧格	xuan'du'zi'wei'shang'gong'jiu'ge	0
玄都紫微上官旧格	xuan'du'zi'wei'shang'guan'jiu'ge	0
蝖飞蠢动	xuan'fei'chun'dong	0
宣告普闻	xuan'gao'pu'wen	0
璇玑北斗惨然俱下	xuan'ji'bei'dou'can'ran'ju'xia	0
璇玑玉衡	xuan'ji'yu'heng	0
璇玑玉衡星真君	xuan'ji'yu'heng'xing'zhen'jun	0
玄科有禁	xuan'ke'you'jin	0
玄图肇运	xuan'tu'zhao'yun	0
玄象开图	xuan'xiang'kai'tu	0
玄象推迁	xuan'xiang'tui'qian	0
旋行上宫	xuan'xing'shang'gong	0
旋行诵经	xuan'xing'song'jing	0
旋行太虚	xuan'xing'tai'xu	0
旋行玉山一匝	xuan'xing'yu'shan'yi'za	0
玄元老君	xuan'yuan'lao'jun	0
选择种人	xuan'ze'zhong'ren	0
玄滋长生	xuan'zi'zhang'sheng	0
削除生籍	xue'chu'sheng'ji	0
削除罪简	xue'chu'zui'jian	0
削除罪录	xue'chu'zui'lu	0
学道应得神仙人名	xue'dao'ying'de'shen'xian'ren'ming	0
学人善恶	xue'ren'shan'e	0
削死上生	xue'si'shang'sheng	0
血为海川	xue'wei'hai'chuan	0
学仙人名功过深浅	xue'xian'ren'ming'gong'guo'shen'qian	0
学者身	xue'zhe'shen	0
学者以其月随科修斋	xue'zhe'yi'qi'yue'sui'ke'xiu'zhai	0
逊谢不逮	xun'xie'bu'dai	0
延惛朽之枯	yan'hun'xiu'zhi'ku	0
延年长生	yan'nian'chang'sheng	0
延算益命	yan'suan'yi'ming	0
演五行于玄府	yan'wu'xing'yu'xuan'fu	0
焉有能胜	yan'you'neng'sheng	0
焉知荣辱之所如	yan'zhi'rong'ru'zhi'suo'ru	0
阳丹灵真老帝君	yang'dan'ling'zhen'lao'di'jun	0
养二仪以长存	yang'er'yi'yi'chang'cun	0
养精和于太初	yang'jing'he'yu'tai'chu	0
养六府于齿牙	yang'liu'fu'yu'chi'ya	0
阳炁否	yang'qi'fou	0
阳炁激	yang'qi'ji	0
阳炁则转天关	yang'qi'ze'zhuan'tian'guan	0
阳炁之极	yang'qi'zhi'ji	0
养人精于丹唇	yang'ren'jing'yu'dan'chun	0
阳数九九	yang'shu'jiu'jiu	0
阳数之九九者	yang'shu'zhi'jiu'jiu'zhe	0
仰寻太真之灵官	yang'xun'tai'zhen'zhi'ling'guan	0
遥观天下至学之人	yao'guan'tian'xia'zhi'xue'zhi'ren	0
妖伪鬼神	yao'wei'gui'shen	0
妖伪杂俗	yao'wei'za'su	0
冶之于流火之庭	ye'zhi'yu'liu'huo'zhi'ting	0
以安北方五炁之天	yi'an'bei'fang'wu'qi'zhi'tian	0
以安东方九炁之天	yi'an'dong'fang'jiu'qi'zhi'tian	0
以安南方三黑之天	yi'an'nan'fang'san'hei'zhi'tian	0
以安西方七炁之天	yi'an'xi'fang'qi'qi'zhi'tian	0
以安中央一炁之天	yi'an'zhong'yang'yi'qi'zhi'tian	0
衣白羽飞衣	yi'bai'yu'fei'yi	0
以赤明开玄之始	yi'chi'ming'kai'xuan'zhi'shi	0
以崇天真也	yi'chong'tian'zhen'ye	0
以出俯仰之式	yi'chu'fu'yang'zhi'shi	0
以传西王母	yi'chuan'xi'wang'mu	0
以此文故固天元始之炁	yi'ci'wen'gu'gu'tian'yuan'shi'zhi'qi	0
以此文固天炁	yi'ci'wen'gu'tian'qi	0
以此文固天元始之黑	yi'ci'wen'gu'tian'yuan'shi'zhi'hei	0
以此文固天元始之炁	yi'ci'wen'gu'tian'yuan'shi'zhi'qi	0
亦得尸解	yi'de'shi'jie	0
以度五帝人	yi'du'wu'di'ren	0
以度种人大灾出	yi'du'zhong'ren'da'zai'chu	0
一方仁人	yi'fang'ren'ren	0
一方凶勃恶兽毒螫	yi'fang'xiong'bo'e'shou'du'shi	0
一方凶勃恶兽毒螫皆不生害心	yi'fang'xiong'bo'e'shou'du'shi'jie'bu'sheng'hai'xin	0
移付地官	yi'fu'di'guan	0
以付太上大道君	yi'fu'tai'shang'da'dao'jun	0
以告水帝	yi'gao'shui'di	0
以告五帝	yi'gao'wu'di	0
以固白天元始之炁	yi'gu'bai'tian'yuan'shi'zhi'qi	0
以固赤天分度	yi'gu'chi'tian'fen'du	0
以固赤天元始之炁	yi'gu'chi'tian'yuan'shi'zhi'qi	0
以固黄天元始之炁	yi'gu'huang'tian'yuan'shi'zhi'qi	0
以固青天元始之炁	yi'gu'qing'tian'yuan'shi'zhi'qi	0
以固玄天元始之黑	yi'gu'xuan'tian'yuan'shi'zhi'hei	0
移还鬼府	yi'hai'gui'fu	0
以黑书白缯七寸佩身	yi'hei'shu'bai'zeng'qi'cun'pei'shen	0
衣九炁青羽飞衣	yi'jiu'qi'qing'yu'fei'yi	0
易枯朽而茂繁	yi'ku'xiu'er'mao'fan	0
以立要用	yi'li'yao'yong	0
诣灵都宫	yi'ling'dou'gong	0
驿龙凤驰	yi'long'feng'chi	0
一名八威龙书	yi'ming'ba'wei'long'shu	0
一名八威召龙文	yi'ming'ba'wei'zhao'long'wen	0
一名八威制天文	yi'ming'ba'wei'zhi'tian'wen	0
一名宝劫洞清九天灵书	yi'ming'bao'jie'dong'qing'jiu'tian'ling'shu	0
一名北山神呪	yi'ming'bei'shan'shen'zhou	0
一名赤帝八威策文	yi'ming'chi'di'ba'wei'ce'wen	0
移名地官	yi'ming'di'guan	0
一名东山神呪八威策文	yi'ming'dong'shan'shen'zhou'ba'wei'ce'wen	0
移名付地官	yi'ming'fu'di'guan	0
移名鬼官	yi'ming'gui'guan	0
一名黄帝威灵策文	yi'ming'huang'di'wei'ling'ce'wen	0
一名黄神大呪	yi'ming'huang'shen'da'zhou	0
一名金真宝明洞微篇	yi'ming'jin'zhen'bao'ming'dong'wei'pian	0
一名九天神呪	yi'ming'jiu'tian'shen'zhou	0
一名九阴灵书	yi'ming'jiu'yin'ling'shu	0
一名南云通天宝灵衿	yi'ming'nan'yun'tong'tian'bao'ling'jin	0
一名生神宝真洞玄章	yi'ming'sheng'shen'bao'zhen'dong'xuan'zhang	0
一名生真券	yi'ming'sheng'zhen'quan	0
一名西山神呪	yi'ming'xi'shan'shen'zhou	0
一名元神生真宝明文	yi'ming'yuan'shen'sheng'zhen'bao'ming'wen	0
一念精进苦行	yi'nian'jing'jin'ku'xing	0
以佩身	yi'pei'shen	0
疫炁流行	yi'qi'liu'xing	0
疫炁弥天	yi'qi'mi'tian	0
一切蠢动	yi'qie'chun'dong	0
一切蠢飞蜎息	yi'qie'chun'fei'yuan'xi	0
一切神灵	yi'qie'shen'ling	0
一切所宗	yi'qie'suo'zong	0
一切万物	yi'qie'wan'wu	0
一切万物受其施泄	yi'qie'wan'wu'shou'qi'shi'xie	0
一切之人	yi'qie'zhi'ren	0
一切众生	yi'qie'zhong'sheng	0
以青书黑缯五寸佩身	yi'qing'shu'hei'zeng'wu'cun'pei'shen	0
亦阙无守吏	yi'que'wu'shou'li	0
以禳此灾	yi'rang'ci'zai	0
以禳大小阳九	yi'rang'da'xiao'yang'jiu	0
依人为邻	yi'ren'wei'lin	0
衣三炁丹羽飞衣	yi'san'qi'dan'yu'fei'yi	0
以散诸地	yi'san'zhu'di	0
以上金五两	yi'shang'jin'wu'liang	0
已生未生	yi'sheng'wei'sheng	0
已生未生门内六畜	yi'sheng'wei'sheng'men'nei'liu'chu	0
一时成形	yi'shi'cheng'xing	0
一十二交为一度	yi'shi'er'jiao'wei'yi'du	0
一时复形	yi'shi'fu'xing	0
役使鬼神	yi'shi'gui'shen	0
一时开张	yi'shi'kai'zhang	0
一时空生光明	yi'shi'kong'sheng'guang'ming	0
以释来者之心	yi'shi'lai'zhe'zhi'xin	0
一十四德	yi'shi'si'de	0
以誓五老上帝	yi'shi'wu'lao'shang'di	0
一时消减	yi'shi'xiao'jian	0
一时消灭	yi'shi'xiao'mie	0
以施于上学好道之士	yi'shi'yu'shang'xue'hao'dao'zhi'shi	0
一岁六会于太上三天	yi'sui'liu'hui'yu'tai'shang'san'tian	0
挹天气而自度	yi'tian'qi'er'zi'du	0
一为上世	yi'wei'shang'shi	0
以五符次第置其中	yi'wu'fu'ci'di'zhi'qi'zhong	0
衣五色飞衣	yi'wu'se'fei'yi	0
以献帝王	yi'xian'di'wang	0
移校河源	yi'xiao'he'yuan	0
依玄科	yi'xuan'ke	0
依玄科四万劫一出	yi'xuan'ke'si'wan'jie'yi'chu	0
衣玄羽飞衣	yi'xuan'yu'fei'yi	0
衣以神衣	yi'yi'shen'yi	0
以应天象地也	yi'ying'tian'xiang'di'ye	0
役御神官	yi'yu'shen'guan	0
诣元始天尊金阙之下	yi'yuan'shi'tian'zun'jin'que'zhi'xia	0
以元始同生	yi'yuan'shi'tong'sheng	0
挹云露于皓芝	yi'yun'lu'yu'hao'zhi	0
一者解上世之考	yi'zhe'jie'shang'shi'zhi'kao	0
一者其德如太空	yi'zhe'qi'de'ru'tai'kong	0
一者身体刚强	yi'zhe'shen'ti'gang'qiang	0
一者是时天气混沌	yi'zhe'shi'shi'tian'qi'hun'dun	0
一者是时无天无地	yi'zhe'shi'shi'wu'tian'wu'di	0
一者形神澄正	yi'zhe'xing'shen'cheng'zheng	0
以朱书青缯九寸佩	yi'zhu'shu'qing'zeng'jiu'cun'pei	0
一字白招拒	yi'zi'bai'zhao'ju	0
一字叶光纪	yi'zi'ye'guang'ji	0
以总御元始之天也	yi'zong'yu'yuan'shi'zhi'tian'ye	0
饮灵液于龙须	yin'ling'ye'yu'long'xu	0
寅卯之年	yin'mao'zhi'nian	0
阴炁勃	yin'qi'bo	0
阴炁则转地机	yin'qi'ze'zhuan'di'ji	0
饮食卧息	yin'shi'wo'xi	0
阴数之八谓之八灾	yin'shu'zhi'ba'wei'zhi'ba'zai	0
阴阳二气	yin'yang'er'qi	0
阴阳生炁君	yin'yang'sheng'qi'jun	0
阴阳用之不倾	yin'yang'yong'zhi'bu'qing	0
应得神仙之人	ying'de'shen'xian'zhi'ren	0
莹发光芒	ying'fa'guang'mang	0
应会太阳	ying'hui'tai'yang	0
荧惑辅心	ying'huo'fu'xin	0
影响相酬	ying'xiang'xiang'chou	0
营之者永存	ying'zhi'zhe'yong'cun	0
应转轮此文	ying'zhuan'lun'ci'wen	0
永亨利贞	yong'heng'li'zhen	0
永离痛恼	yong'li'tong'nao	0
用灵山向阳之竹	yong'ling'shan'xiang'yang'zhi'zhu	0
永无开听于陈辞	yong'wu'kai'ting'yu'chen'ci	0
用之者寿多	yong'zhi'zhe'shou'duo	0
右别簿录	you'bie'bu'lu	0
又当白书黑缯	you'dang'bai'shu'hei'zeng	0
又当赤书黄缯	you'dang'chi'shu'huang'zeng	0
又当黑书青缯	you'dang'hei'shu'qing'zeng	0
又当青书绛文	you'dang'qing'shu'jiang'wen	0
有得之者	you'de'zhi'zhe	0
有得之子	you'de'zhi'zi	0
右洞阳之炁	you'dong'yang'zhi'qi	0
右洞阴之炁	you'dong'yin'zhi'qi	0
有犯科律	you'fan'ke'lv	0
有俯仰之仪	you'fu'yang'zhi'yi	0
右光元灵文	you'guang'yuan'ling'wen	0
又黄书白缯	you'huang'shu'bai'zeng	0
有火水阴阳官考	you'huo'shui'yin'yang'guan'kao	0
有考吏	you'kao'li	0
有佩灵宝玉文	you'pei'ling'bao'yu'wen	0
由七炁之娱	you'qi'qi'zhi'yu	0
有其人依科	you'qi'ren'yi'ke	0
右上始天光文	you'shang'shi'tian'guang'wen	0
右上阳明文	you'shang'yang'ming'wen	0
右少阳之气	you'shao'yang'zhi'qi	0
右少阴之炁	you'shao'yin'zhi'qi	0
有十部妙经三十六卷	you'shi'bu'miao'jing'san'shi'liu'juan	0
有十方至真尊神	you'shi'fang'zhi'zhen'zun'shen	0
由始老九炁之功	you'shi'lao'jiu'qi'zhi'gong	0
右太阳之炁	you'tai'yang'zhi'qi	0
右太阴之气	you'tai'yin'zhi'qi	0
右通明文	you'tong'ming'wen	0
有违科犯法	you'wei'ke'fan'fa	0
有违科犯戒	you'wei'ke'fan'jie	0
有违科犯禁	you'wei'ke'fan'jin	0
有违科律则长充鬼役	you'wei'ke'lv'ze'chang'chong'gui'yi	0
由五气之兴	you'wu'qi'zhi'xing	0
有修斋立德	you'xiu'zhai'li'de	0
由一炁之永固	you'yi'qi'zhi'yong'gu	0
有一十二恩	you'yi'shi'er'en	0
有一十二念	you'yi'shi'er'nian	0
有一十四功	you'yi'shi'si'gong	0
幽幽冥冥	you'you'ming'ming	0
右元皇之气	you'yuan'huang'zhi'qi	0
右元阳之气	you'yuan'yang'zhi'qi	0
右元一之炁	you'yuan'yi'zhi'qi	0
右元阴之气	you'yuan'yin'zhi'qi	0
由真老三黑之勋	you'zhen'lao'san'hei'zhi'xun	0
友真人以为好	you'zhen'ren'yi'wei'hao	0
有中归无	you'zhong'gui'wu	0
右总灵文	you'zong'ling'wen	0
有左右阴阳考典赏	you'zuo'you'yin'yang'kao'dian'shang	0
玉陛朝轩	yu'bi'chao'xuan	0
于大劫之中	yu'da'jie'zhi'zhong	0
与道合同	yu'dao'he'tong	0
与道念同	yu'dao'nian'tong	0
玉妃拂筵	yu'fei'fu'yan	0
玉京金阙七宝宫	yu'jing'jin'que'qi'bao'gong	0
玉京七宝紫微官	yu'jing'qi'bao'zi'wei'guan	0
玉京山洞灵元阳之绾	yu'jing'shan'dong'ling'yuan'yang'zhi'wan	0
玉京山上宫	yu'jing'shan'shang'gong	0
玉京山紫微上官	yu'jing'shan'zi'wei'shang'guan	0
玉诀二卷	yu'jue'er'juan	0
玉历君	yu'li'jun	0
玉历丈人	yu'li'zhang'ren	0
鱼鳞交会	yu'lin'jiao'hui	0
于灵宝阳台之上	yu'ling'bao'yang'tai'zhi'shang	0
与灵宝玉篇真文大劫	yu'ling'bao'yu'pian'zhen'wen'da'jie	0
与灵仙而高登	yu'ling'xian'er'gao'deng	0
玉女乘九山之兽	yu'nv'cheng'jiu'shan'zhi'shou	0
玉女典香	yu'nv'dian'xiang	0
与日同寿	yu'ri'tong'shou	0
与三气长存	yu'san'qi'chang'cun	0
玉山洞灵丹台	yu'shan'dong'ling'dan'tai	0
玉山青华玉陛官	yu'shan'qing'hua'yu'bi'guan	0
玉山通阳青微宫	yu'shan'tong'yang'qing'wei'gong	0
与善因缘	yu'shan'yin'yuan	0
于上下同光明	yu'shang'xia'tong'guang'ming	0
欲使北乡安镇	yu'shi'bei'xiang'an'zhen	0
于是存焉	yu'shi'cun'yan	0
欲使东乡安镇	yu'shi'dong'xiang'an'zhen	0
于是回万劫而更始	yu'shi'hui'wan'jie'er'geng'shi	0
于是迥阳光之西倾	yu'shi'jiong'yang'guang'zhi'xi'qing	0
于是抗虞渊之颓日	yu'shi'kang'yu'yuan'zhi'tui'ri	0
欲使南乡安镇	yu'shi'nan'xiang'an'zhen	0
于是却凋老于反婴	yu'shi'que'diao'lao'yu'fan'ying	0
于是太上大道君	yu'shi'tai'shang'da'dao'jun	0
欲使西乡安镇	yu'shi'xi'xiang'an'zhen	0
玉童侍卫	yu'tong'shi'wei	0
与五帝同俦	yu'wu'di'tong'chou	0
与五帝五岳四渎	yu'wu'di'wu'yue'si'du	0
与仙宝而为宗	yu'xian'bao'er'wei'zong	0
玉音激乎云庭	yu'yin'ji'hu'yun'ting	0
与元始玉篇真文同出于赤天之中	yu'yuan'shi'yu'pian'zhen'wen'tong'chu'yu'chi'tian'zhi'zhong	0
与月同寿	yu'yue'tong'shou	0
与运推迁	yu'yun'tui'qian	0
与真结缘	yu'zhen'jie'yuan	0
玉真丈人	yu'zhen'zhang'ren	0
元极大道	yuan'ji'da'dao	0
元极大道南上赤帝	yuan'ji'da'dao'nan'shang'chi'di	0
元极大道南上老君	yuan'ji'da'dao'nan'shang'lao'jun	0
元极大道上帝	yuan'ji'da'dao'shang'di	0
元极大道天皇老人	yuan'ji'da'dao'tian'huang'lao'ren	0
元精往来	yuan'jing'wang'lai	0
元灵君	yuan'ling'jun	0
元灵老君	yuan'ling'lao'jun	0
元灵丈人	yuan'ling'zhang'ren	0
元上丈人	yuan'shang'zhang'ren	0
元神君	yuan'shen'jun	0
元神丈人	yuan'shen'zhang'ren	0
元始白帝真符	yuan'shi'bai'di'zhen'fu	0
元始赤帝真符	yuan'shi'chi'di'zhen'fu	0
元始赤书玉篇真文	yuan'shi'chi'shu'yu'pian'zhen'wen	0
元始登命	yuan'shi'deng'ming	0
元始洞玄灵宝赤书玉篇真文	yuan'shi'dong'xuan'ling'bao'chi'shu'yu'pian'zhen'wen	0
元始付太上丈人	yuan'shi'fu'tai'shang'zhang'ren	0
元始黑帝真符	yuan'shi'hei'di'zhen'fu	0
元始黄帝真符	yuan'shi'huang'di'zhen'fu	0
元始开图	yuan'shi'kai'tu	0
元始刻题上帝灵都之绾	yuan'shi'ke'ti'shang'di'ling'dou'zhi'wan	0
元始炼之于洞阳之馆	yuan'shi'lian'zhi'yu'dong'yang'zhi'guan	0
元始良久乃垂眄眦之容	yuan'shi'liang'jiu'nai'chui'mian'zi'zhi'rong	0
元始灵宝北天大圣众	yuan'shi'ling'bao'bei'tian'da'sheng'zhong	0
元始灵宝东北天大圣众	yuan'shi'ling'bao'dong'bei'tian'da'sheng'zhong	0
元始灵宝东南天大圣众	yuan'shi'ling'bao'dong'nan'tian'da'sheng'zhong	0
元始灵宝南天大圣众	yuan'shi'ling'bao'nan'tian'da'sheng'zhong	0
元始灵宝上元天大圣众	yuan'shi'ling'bao'shang'yuan'tian'da'sheng'zhong	0
元始灵宝束天大圣众	yuan'shi'ling'bao'shu'tian'da'sheng'zhong	0
元始灵宝五老尊神	yuan'shi'ling'bao'wu'lao'zun'shen	0
元始灵宝西北天大圣	yuan'shi'ling'bao'xi'bei'tian'da'sheng	0
元始灵宝西南大圣众	yuan'shi'ling'bao'xi'nan'da'sheng'zhong	0
元始灵宝西天大圣众	yuan'shi'ling'bao'xi'tian'da'sheng'zhong	0
元始灵宝下元天大圣众	yuan'shi'ling'bao'xia'yuan'tian'da'sheng'zhong	0
元始青帝真符	yuan'shi'qing'di'zhen'fu	0
元始神杖	yuan'shi'shen'zhang	0
元始施安灵宝五帝镇官宅上法	yuan'shi'shi'an'ling'bao'wu'di'zhen'guan'zhai'shang'fa	0
元始收其本文	yuan'shi'shou'qi'ben'wen	0
元始天书	yuan'shi'tian'shu	0
元始天尊方凝真遐想	yuan'shi'tian'zun'fang'ning'zhen'xia'xiang	0
元始天尊封于神杖之中	yuan'shi'tian'zun'feng'yu'shen'zhang'zhi'zhong	0
元始五老赤书玉篇	yuan'shi'wu'lao'chi'shu'yu'pian	0
元始五老赤书玉篇真文天书经	yuan'shi'wu'lao'chi'shu'yu'pian'zhen'wen'tian'shu'jing	0
元始五老出五帝真符	yuan'shi'wu'lao'chu'wu'di'zhen'fu	0
元始五老灵宝官号	yuan'shi'wu'lao'ling'bao'guan'hao	0
元始五老三元玉符	yuan'shi'wu'lao'san'yuan'yu'fu	0
元始五老始生五帝	yuan'shi'wu'lao'shi'sheng'wu'di	0
元始以付太上大道君	yuan'shi'yi'fu'tai'shang'da'dao'jun	0
元始置法	yuan'shi'zhi'fa	0
元始自然赤书玉篇真文	yuan'shi'zi'ran'chi'shu'yu'pian'zhen'wen	0
愿所欲闻	yuan'suo'yu'wen	0
愿无不从	yuan'wu'bu'cong	0
元真君	yuan'zhen'jun	0
元真丈人	yuan'zhen'zhang'ren	0
月后	yue'hou	0
运导阴阳	yun'dao'yin'yang	0
运关三百三十度	yun'guan'san'bai'san'shi'du	0
运四气以应神	yun'si'qi'yi'ying'shen	0
运天精于南夏	yun'tian'jing'yu'nan'xia	0
运推数周	yun'tui'shu'zhou	0
运推自来	yun'tui'zi'lai	0
运役阴阳	yun'yi'yin'yang	0
运走星辰	yun'zou'xing'chen	0
杂法开化	za'fa'kai'hua	0
杂气普消	za'qi'pu'xiao	0
灾不加身	zai'bu'jia'shen	0
灾不行	zai'bu'xing	0
在所校录	zai'suo'xiao'lu	0
在玄都宫	zai'xuan'du'gong	0
灾疫不行	zai'yi'bu'xing	0
灾自灭	zai'zi'mie	0
赞诵灵文	zan'song'ling'wen	0
则北辰列言善功	ze'bei'chen'lie'yan'shan'gong	0
则北岳仙官至	ze'bei'yue'xian'guan'zhi	0
则东岳仙官至	ze'dong'yue'xian'guan'zhi	0
则九天炁交	ze'jiu'tian'qi'jiao	0
则免此灾	ze'mian'ci'zai	0
则名上仙簿	ze'ming'shang'xian'bu	0
则南岳仙官至	ze'nan'yue'xian'guan'zhi	0
则三尸不得	ze'san'shi'bu'de	0
则司命长生司马注上生簿	ze'si'ming'chang'sheng'si'ma'zhu'shang'sheng'bu	0
则司命勒名生录	ze'si'ming'le'ming'sheng'lu	0
则天真下降	ze'tian'zhen'xia'jiang	0
则为三官九府所保	ze'wei'san'guan'jiu'fu'suo'bao	0
则五帝保举	ze'wu'di'bao'ju	0
则西岳仙官至	ze'xi'yue'xian'guan'zhi	0
则中岳仙官至	ze'zhong'yue'xian'guan'zhi	0
乍存乍亡	zha'cun'zha'wang	0
斋戒愿念	zhai'jie'yuan'nian	0
斋直上圣之法	zhai'zhi'shang'sheng'zhi'fa	0
斩灭邪根	zhan'mie'xie'gen	0
斩灭邪源	zhan'mie'xie'yuan	0
障炁行	zhang'qi'xing	0
障气障天	zhang'qi'zhang'tian	0
长牙扣钟	zhang'ya'kou'zhong	0
召蛟龙及水神事	zhao'jiao'long'ji'shui'shen'shi	0
召蛟龙水神事	zhao'jiao'long'shui'shen'shi	0
召蛟龙以负身	zhao'jiao'long'yi'fu'shen	0
召龙上云	zhao'long'shang'yun	0
兆民歌唱	zhao'min'ge'chang	0
召神使仙	zhao'shen'shi'xian	0
昭示来生	zhao'shi'lai'sheng	0
召水神及蛟龙事	zhao'shui'shen'ji'jiao'long'shi	0
召天下神	zhao'tian'xia'shen	0
照曜诸天	zhao'yao'zhu'tian	0
召运促会	zhao'yun'cu'hui	0
召云龙以防水灾	zhao'yun'long'yi'fang'shui'zai	0
召直符昌中守灵宝天文	zhao'zhi'fu'chang'zhong'shou'ling'bao'tian'wen	0
召直符更生守灵宝天文	zhao'zhi'fu'geng'sheng'shou'ling'bao'tian'wen	0
召直符曲正守灵宝天文	zhao'zhi'fu'qu'zheng'shou'ling'bao'tian'wen	0
召直符尹丰守灵宝天文	zhao'zhi'fu'yin'feng'shou'ling'bao'tian'wen	0
真宝君	zhen'bao'jun	0
真宝丈人	zhen'bao'zhang'ren	0
真道当行	zhen'dao'dang'hang	0
镇东方九日	zhen'dong'fang'jiu'ri	0
真皇老人	zhen'huang'lao'ren	0
真乐乎哉	zhen'le'hu'zai	0
镇南方八日	zhen'nan'fang'ba'ri	0
真人名曰子丹	zhen'ren'ming'yue'zi'dan	0
真王驾九光神龙	zhen'wang'jia'jiu'guang'shen'long	0
真文天书经卷下	zhen'wen'tian'shu'jing'juan'xia	0
镇五灵以立真	zhen'wu'ling'yi'li'zhen	0
镇五岳于灵馆	zhen'wu'yue'yu'ling'guan	0
镇星辅脾	zhen'xing'fu'pi	0
镇星吐辉	zhen'xing'tu'hui	0
真阳始青神人	zhen'yang'shi'qing'shen'ren	0
真亦冥行	zhen'yi'ming'xing	0
镇玉篇以固劫	zhen'yu'pian'yi'gu'jie	0
枕云岫而练神	zhen'yun'xiu'er'lian'shen	0
镇中央十二日	zhen'zhong'yang'shi'er'ri	0
轸总七宿	zhen'zong'qi'su	0
正道当行	zheng'dao'dang'hang	0
正道驿行	zheng'dao'yi'xing	0
正斗明轮	zheng'dou'ming'lun	0
正法兴隆	zheng'fa'xing'long	0
正鬼气	zheng'gui'qi	0
正九天气	zheng'jiu'tian'qi	0
正明天度	zheng'ming'tian'du	0
正如睡眠之顷尔	zheng'ru'shui'mian'zhi'qing'er	0
正天度数	zheng'tian'du'shu	0
正天分	zheng'tian'fen	0
正天分度	zheng'tian'fen'du	0
正天分数	zheng'tian'fen'shu	0
正天气	zheng'tian'qi	0
整心修敬	zheng'xin'xiu'jing	0
正一盟威太上无为大道	zheng'yi'meng'wei'tai'shang'wu'wei'da'dao	0
置北方五日	zhi'bei'fang'wu'ri	0
制到玉阶	zhi'dao'yu'jie	0
直符吏区更生随符入腹肝藏之府	zhi'fu'li'qu'geng'sheng'sui'fu'ru'fu'gan'cang'zhi'fu	0
直符吏辱曲正随符入腹肺府之中	zhi'fu'li'ru'qu'zheng'sui'fu'ru'fu'fei'fu'zhi'zhong	0
直符吏尹丰随符入腹肾府之中	zhi'fu'li'yin'feng'sui'fu'ru'fu'shen'fu'zhi'zhong	0
直符吏祝昌中随符入腹心府之中	zhi'fu'li'zhu'chang'zhong'sui'fu'ru'fu'xin'fu'zhi'zhong	0
致国太平	zhi'guo'tai'ping	0
制河上龙	zhi'he'shang'long	0
至黄帝五劫下教	zhi'huang'di'wu'jie'xia'jiao	0
制会促运	zhi'hui'cu'yun	0
制会酆山	zhi'hui'feng'shan	0
制会黄河	zhi'hui'huang'he	0
制劫运于三关	zhi'jie'yun'yu'san'guan	0
治九九阴炁涌	zhi'jiu'jiu'yin'qi'yong	0
制九炁青天分度	zhi'jiu'qi'qing'tian'fen'du	0
置立玄科	zhi'li'xuan'ke	0
指拈太无	zhi'nian'tai'wu	0
制七炁素天分度	zhi'qi'qi'su'tian'fen'du	0
制三炁丹天分度	zhi'san'qi'dan'tian'fen'du	0
制天分度	zhi'tian'fen'du	0
致天高澄	zhi'tian'gao'cheng	0
制天民三尸魂神	zhi'tian'min'san'shi'hun'shen	0
制五黑玄天分度	zhi'wu'hei'xuan'tian'fen'du	0
至五劫周末	zhi'wu'jie'zhou'mo	0
置西方六日	zhi'xi'fang'liu'ri	0
执心奉斋	zhi'xin'feng'zhai	0
执凶纠非	zhi'xiong'jiu'fei	0
至学之士	zhi'xue'zhi'shi	0
制一炁黄天分度	zhi'yi'qi'huang'tian'fen'du	0
值以有黄帝生人	zhi'yi'you'huang'di'sheng'ren	0
芝英滂沱	zhi'ying'pang'tuo	0
执斋持法	zhi'zhai'chi'fa	0
执斋持戒	zhi'zhai'chi'jie	0
执斋奉戒	zhi'zhai'feng'jie	0
止召蛟龙	zhi'zhao'jiao'long	0
制召上仙	zhi'zhao'shang'xian	0
智者见之谓之智	zhi'zhe'jian'zhi'wei'zhi'zhi	0
至真大神	zhi'zhen'da'shen	0
至真学者行之德也	zhi'zhen'xue'zhe'xing'zhi'de'ye	0
殖真于九灵之府	zhi'zhen'yu'jiu'ling'zhi'fu	0
至真尊神	zhi'zhen'zun'shen	0
中和三元洞明之气	zhong'he'san'yuan'dong'ming'zhi'qi	0
中黄高尊	zhong'huang'gao'zun	0
中黄丈人	zhong'huang'zhang'ren	0
中黄正一君	zhong'huang'zheng'yi'jun	0
中黄总炁	zhong'huang'zong'qi	0
中检五灵	zhong'jian'wu'ling	0
中精在人身中为五脏	zhong'jing'zai'ren'shen'zhong'wei'wu'zang	0
中山神咒	zhong'shan'shen'zhou	0
中台大使者皆条善功	zhong'tai'da'shi'zhe'jie'tiao'shan'gong	0
中外享庆	zhong'wai'xiang'qing	0
中为辰星	zhong'wei'chen'xing	0
中为岁星	zhong'wei'sui'xing	0
中为太白	zhong'wei'tai'bai	0
中为荧惑星	zhong'wei'ying'huo'xing	0
中为镇星	zhong'wei'zhen'xing	0
众仙	zhong'xian	0
中央黄帝灵宝赤书玉篇	zhong'yang'huang'di'ling'bao'chi'shu'yu'pian	0
中央凶勃恶兽毒螫皆不生害心	zhong'yang'xiong'bo'e'shou'du'shi'jie'bu'sheng'hai'xin	0
中央一炁黄天	zhong'yang'yi'qi'huang'tian	0
中央一炁黄天上元大劫之周	zhong'yang'yi'qi'huang'tian'shang'yuan'da'jie'zhi'zhou	0
中央玉宝元灵元老	zhong'yang'yu'bao'yuan'ling'yuan'lao	0
中央玉宝元灵元老帝君	zhong'yang'yu'bao'yuan'ling'yuan'lao'di'jun	0
中央玉宝元灵元老君符命	zhong'yang'yu'bao'yuan'ling'yuan'lao'jun'fu'ming	0
中央总灵	zhong'yang'zong'ling	0
中应人情	zhong'ying'ren'qing	0
中有大神	zhong'you'da'shen	0
中有黑帝	zhong'you'hei'di	0
中有老人	zhong'you'lao'ren	0
中有太上之家	zhong'you'tai'shang'zhi'jia	0
中元出此文	zhong'yuan'chu'ci'wen	0
中元大阳九大百六	zhong'yuan'da'yang'jiu'da'bai'liu	0
众真并以上合天庆之日	zhong'zhen'bing'yi'shang'he'tian'qing'zhi'ri	0
众真侍卫	zhong'zhen'shi'wei	0
众真同时退斋三月	zhong'zhen'tong'shi'tui'zhai'san'yue	0
众至真尊神	zhong'zhi'zhen'zun'shen	0
周行天地	zhou'hang'tian'di	0
周行五岳三官水府	zhou'hang'wu'yue'san'guan'shui'fu	0
周行诸天地上	zhou'hang'zhu'tian'di'shang	0
周行诸天诸地	zhou'hang'zhu'tian'zhu'di	0
周回三十二覆	zhou'hui'san'shi'er'fu	0
周回诸天日月星宿十空之外	zhou'hui'zhu'tian'ri'yue'xing'xiu'shi'kong'zhi'wai	0
周五方之炁	zhou'wu'fang'zhi'qi	0
周行天下	zhou'xing'tian'xia	0
周行天下四海八极	zhou'xing'tian'xia'si'hai'ba'ji	0
昼夜不别	zhou'ye'bu'bie	0
昼夜不分	zhou'ye'bu'fen	0
昼夜三十日	zhou'ye'san'shi'ri	0
昼夜思神	zhou'ye'si'shen	0
主北方星官正天气	zhu'bei'fang'xing'guan'zheng'tian'qi	0
朱丹长生	zhu'dan'chang'sheng	0
诸地上五岳神仙真人	zhu'di'shang'wu'yue'shen'xian'zhen'ren	0
诛罚魔精	zhu'fa'mo'jing	0
铸金为简	zhu'jin'wei'jian	0
主九天神仙图箓金名	zhu'jiu'tian'shen'xian'tu'lu'jin'ming	0
主摄白帝星官	zhu'she'bai'di'xing'guan	0
主摄北帝	zhu'she'bei'di	0
主摄北海水帝制水中万精	zhu'she'bei'hai'shui'di'zhi'shui'zhong'wan'jing	0
主摄东海水帝	zhu'she'dong'hai'shui'di	0
主摄鬼魔	zhu'she'gui'mo	0
主摄六天鬼炁	zhu'she'liu'tian'gui'qi	0
主摄南海水帝	zhu'she'nan'hai'shui'di	0
主摄天魔北帝万鬼事	zhu'she'tian'mo'bei'di'wan'gui'shi	0
主摄西海水帝及水中万精	zhu'she'xi'hai'shui'di'ji'shui'zhong'wan'jing	0
主摄星官	zhu'she'xing'guan	0
主摄中海水帝	zhu'she'zhong'hai'shui'di	0
主神仙玉简宿名总归仙炁	zhu'shen'xian'yu'jian'su'ming'zong'gui'xian'qi	0
朱书白素上	zhu'shu'bai'su'shang	0
诸天称善	zhu'tian'cheng'shan	0
诸天大圣	zhu'tian'da'sheng	0
诸天大圣尊神	zhu'tian'da'sheng'zun'shen	0
诸天帝皇	zhu'tian'di'huang	0
诸天各下天帝	zhu'tian'ge'xia'tian'di	0
诸天伎乐	zhu'tian'ji'yue	0
诸天皆一月三朝真文	zhu'tian'jie'yi'yue'san'zhao'zhen'wen	0
诸天普受光明	zhu'tian'pu'shou'guang'ming	0
诸天炁王于火	zhu'tian'qi'wang'yu'huo	0
诸天炁王于金	zhu'tian'qi'wang'yu'jin	0
诸天炁王于木	zhu'tian'qi'wang'yu'mu	0
诸天炁王于水	zhu'tian'qi'wang'yu'shui	0
诸天炁王于土	zhu'tian'qi'wang'yu'tu	0
诸天至真	zhu'tian'zhi'zhen	0
诸天至真尊神	zhu'tian'zhi'zhen'zun'shen	0
诸天诸地	zhu'tian'zhu'di	0
主仙玉郎	zhu'xian'yu'lang	0
主小劫丑未	zhu'xiao'jie'chou'wei	0
主小劫亥	zhu'xiao'jie'hai	0
主小劫申	zhu'xiao'jie'shen	0
主小劫巳	zhu'xiao'jie'si	0
主校九天	zhu'xiao'jiu'tian	0
主召九天上帝校神仙图录	zhu'zhao'jiu'tian'shang'di'xiao'shen'xian'tu'lu	0
主召仙炁	zhu'zhao'xian'qi	0
主召星官	zhu'zhao'xing'guan	0
主制北酆	zhu'zhi'bei'feng	0
主制七关	zhu'zhi'qi'guan	0
主诸真人神仙图箓	zhu'zhu'zhen'ren'shen'xian'tu'lu	0
转轮成仙	zhuan'lun'cheng'xian	0
转轮神仙	zhuan'lun'shen'xian	0
濯澜上玄	zhuo'lan'shang'xuan	0
自不精身苦志	zi'bu'jing'shen'ku'zhi	0
字赤熛弩	zi'chi'biao'nu	0
自非此文	zi'fei'ci'wen	0
自光真名	zi'guang'zhen'ming	0
字含枢纽	zi'han'shu'niu	0
子今所扣	zi'jin'suo'kou	0
自可黄书白缯佩身	zi'ke'huang'shu'bai'zeng'pei'shen	0
字灵威仰	zi'ling'wei'yang	0
资生兆民	zi'sheng'zhao'min	0
子孙昌炽	zi'sun'chang'chi	0
子孙昌盛	zi'sun'chang'sheng	0
紫微上宫	zi'wei'shang'gong	0
字曜魄宝	zi'yao'po'bao	0
咨以禁戒之仪	zi'yi'jin'jie'zhi'yi	0
字隐侯局	zi'yin'hou'ju	0
宗奉灵文	zong'feng'ling'wen	0
宗奉天文	zong'feng'tian'wen	0
总领肺炁	zong'ling'fei'qi	0
总领符命	zong'ling'fu'ming	0
总领群仙	zong'ling'qun'xian	0
总七节	zong'qi'jie	0
总摄无穷	zong'she'wu'qiong	0
总校图录	zong'xiao'tu'lu	0
总御九天之兵	zong'yu'jiu'tian'zhi'bing	0
奏上三天上帝	zou'shang'san'tian'shang'di	0
走使鬼神	zou'shi'gui'shen	0
最大至尊	zui'da'zhi'zun	0
罪简所由轻重	zui'jian'suo'you'qing'zhong	0
最上正真无鞅数道气	zui'shang'zheng'zhen'wu'yang'shu'dao'qi	0
尊道重法	zun'dao'zhong'fa	0
尊奉天真	zun'feng'tian'zhen	0
坐要自然	zuo'yao'zi'ran	0
坐招自然	zuo'zhao'zi'ran	0
坐致神灵	zuo'zhi'shen'ling	0
坐致天厨玉女侍卫	zuo'zhi'tian'chu'yu'nv'shi'wei	0
