阿格斯	a'ge'si	0
阿古斯防御者	a'gu'si'fang'yu'zhe	0
阿拉希武器匠	a'la'xi'wu'qi'jiang	0
阿莱克斯塔罗	a'lai'ke'si'ta'luo	0
阿莱克丝塔萨	a'lai'ke'si'ta'sa	0
阿莱克丝塔萨的勇士	a'lai'ke'si'ta'sa'de'yong'shi	0
阿曼尼狂战士	a'man'ni'kuang'zhan'shi	0
阿努巴尔伏击者	a'nu'ba'er'fu'ji'zhe	0
阿努巴拉克	a'nu'ba'la'ke	0
阿努比萨斯哨兵	a'nu'bi'sa'si'shao'bing	0
阿努布雷坎	a'nu'bu'lei'kan	0
阿诺玛鲁斯	a'nuo'ma'lu'si	0
艾德温范克里夫	ai'de'wen'fan'ke'li'fu	0
艾德温范克里卡	ai'de'wen'fan'ke'li'ka	0
艾尔文灾星霍格	ai'er'wen'zai'xing'huo'ge	0
哀嚎	ai'hao	0
哀嚎的灵魂	ai'hao'de'ling'hun	0
埃隆巴克保护者	ai'long'ba'ke'bao'hu'zhe	0
艾露恩的女祭司	ai'lu'en'de'nv'ji'si	0
艾露恩女祭司	ai'lu'en'nv'ji'si	0
哀绿	ai'lv	0
艾维娜	ai'wei'na	0
埃辛诺斯战刃	ai'xin'nuo'si'zhan'ren	0
埃辛诺斯之焰	ai'xin'nuo'si'zhi'yan	0
爱雅黑掌	ai'ya'hei'zhang	0
艾雅黑掌	ai'ya'hei'zhang	0
艾卓曼德斯	ai'zhuo'man'de'si	0
安东尼	an'dong'ni	0
安度因乌瑞恩	an'du'yin'wu'rui'en	0
安戈洛	an'ge'luo	0
安戈洛卡牌包	an'ge'luo'ka'pai'bao	0
暗黑低语者	an'hei'di'yu'zhe	0
暗金教	an'jin'jiao	0
暗金教恶魔商贩	an'jin'jiao'e'mo'shang'fan	0
暗金教炼金师	an'jin'jiao'lian'jin'shi	0
暗金教窃歌者	an'jin'jiao'qie'ge'zhe	0
暗金教侍从	an'jin'jiao'shi'cong	0
暗金教水晶侍女	an'jin'jiao'shui'jing'shi'nv	0
暗金教信使	an'jin'jiao'xin'shi	0
暗金教鸦人祭司	an'jin'jiao'ya'ren'ji'si	0
暗鳞先知	an'lin'xian'zhi	0
暗鳞治愈者	an'lin'zhi'yu'zhe	0
暗矛猎手	an'mao'lie'shou	0
暗色炸弹	an'se'zha'dan	0
暗言术骇	an'yan'shu'hai	0
暗言术灭	an'yan'shu'mie	0
暗言术疼	an'yan'shu'teng	0
暗言术痛	an'yan'shu'tong	0
暗影步	an'ying'bu	0
暗影打击	an'ying'da'ji	0
暗影打击装甲	an'ying'da'ji'zhuang'jia	0
暗影大师	an'ying'da'shi	0
暗影箭	an'ying'jian	0
暗影狂暴	an'ying'kuang'bao	0
暗影狂乱	an'ying'kuang'luan	0
暗影狂怒者	an'ying'kuang'nu'zhe	0
暗影烈焰	an'ying'lie'yan	0
暗影魔	an'ying'mo	0
暗影施法者	an'ying'shi'fa'zhe	0
暗影视界	an'ying'shi'jie	0
暗影兽	an'ying'shou	0
暗影投弹手	an'ying'tou'dan'shou	0
暗影形态	an'ying'xing'tai	0
暗影之拥	an'ying'zhi'yong	0
暗影子嗣	an'ying'zi'si	0
暗中破坏	an'zhong'po'huai	0
肮脏的希尔盖	ang'zang'de'xi'er'gai	0
奥爆	ao'bao	0
奥冲	ao'chong	0
奥达曼	ao'da'man	0
奥达曼守护者	ao'da'man'shou'hu'zhe	0
奥蛋	ao'dan	0
奥尔多卫士	ao'er'duo'wei'shi	0
奥格玛什地狱咆哮	ao'ge'ma'shen'di'yu'pao'xiao	0
奥格瑞玛狼骑士	ao'ge'rui'ma'lang'qi'shi	0
奥金斧	ao'jin'fu	0
奥金尼	ao'jin'ni	0
奥金尼灵魂祭司	ao'jin'ni'ling'hun'ji'si	0
奥金尼灵魂祭祀	ao'jin'ni'ling'hun'ji'si	0
奥垃圾	ao'la'ji	0
奥秘	ao'mi	0
奥秘守护者	ao'mi'shou'hu'zhe	0
奥秘吞噬者	ao'mi'tun'shi'zhe	0
奥能金刚	ao'neng'jin'gang	0
奥能铁匠	ao'neng'tie'jiang	0
奥妮克希亚	ao'ni'ke'xi'ya	0
奥妮克希亚之爪	ao'ni'ke'xi'ya'zhi'zhao	0
獒犬	ao'quan	0
奥射	ao'she	0
奥数冲击	ao'shu'chong'ji	0
奥术冲击	ao'shu'chong'ji	0
奥术飞弹	ao'shu'fei'dan	0
奥术畸体	ao'shu'ji'ti	0
奥术巨人	ao'shu'ju'ren	0
奥术傀儡	ao'shu'kui'lei	0
奥术射击	ao'shu'she'ji	0
奥术智慧	ao'shu'zhi'hui	0
八八大树	ba'ba'da'shu	0
拔根	ba'gen	0
把狗放出来	ba'gou'fang'chu'lai	0
巴内斯	ba'nei'si	0
把尸体拿过来	ba'shi'ti'na'guo'lai	0
霸王龙	ba'wang'long	0
巴西	ba'xi	0
白富美杨幂拐卖	bai'fu'mei'yang'mi'guai'mai	0
白骨结构体	bai'gu'jie'gou'ti	0
白骨卫士军官	bai'gu'wei'shi'jun'guan	0
白骨爪牙	bai'gu'zhao'ya	0
白石头人小小	bai'shi'tou'ren'xiao'xiao	0
百兽之王	bai'shou'zhi'wang	0
白眼大侠	bai'yan'da'xia	0
白银之枪	bai'yin'zhi'qiang	0
白银之手教官	bai'yin'zhi'shou'jiao'guan	0
白银之手骑士	bai'yin'zhi'shou'qi'shi	0
白银之手新兵	bai'yin'zhi'shou'xin'bing	0
半神	ban'shen	0
半神的恩赐	ban'shen'de'en'ci	0
爆刀	bao'dao	0
爆发	bao'fa	0
暴风城骑士	bao'feng'cheng'qi'shi	0
暴风城勇士	bao'feng'cheng'yong'shi	0
暴风雪	bao'feng'xue	0
保护之手	bao'hu'zhi'shou	0
报警机器人	bao'jing'ji'qi'ren	0
爆晶药水	bao'jing'yao'shui	0
暴龙王克鲁什	bao'long'wang'ke'lu'shen	0
暴龙之王摩什	bao'long'zhi'wang'mo'shen	0
暴露狂	bao'lu'kuang	0
暴乱狂战士	bao'luan'kuang'zhan'shi	0
暴掠龙幼崽	bao'lve'long'you'zai	0
暴怒的狼人	bao'nu'de'lang'ren	0
暴怒狂战士	bao'nu'kuang'zhan'shi	0
爆牌卡组	bao'pai'ka'zu	0
爆破小队	bao'po'xiao'dui	0
宝石甲虫	bao'shi'jia'chong	0
宝石鹦鹉	bao'shi'ying'wu	0
保卫国王	bao'wei'guo'wang	0
宝物据藏者	bao'wu'ju'cang'zhe	0
暴躁的恐角龙	bao'zao'de'kong'jiao'long	0
暴躁的牧羊人	bao'zao'de'mu'yang'ren	0
爆炸	bao'zha	0
爆炸射击	bao'zha'she'ji	0
爆炸陷阱	bao'zha'xian'jing	0
孢子	bao'zi	0
孢子爆发	bao'zi'bao'fa	0
豹子戏法	bao'zi'xi'fa	0
被冰冻的勇士	bei'bing'dong'de'yong'shi	0
背刺	bei'ci	0
贝恩血蹄	bei'en'xue'ti	0
被感染的牛头人	bei'gan'ran'de'niu'tou'ren	0
被感染的贮藏者	bei'gan'ran'de'zhu'cang'zhe	0
北海海怪	bei'hai'hai'guai	0
北郡牧师	bei'jun'mu'shi	0
卑劣的窃蛋者	bei'lie'de'qie'dan'zhe	0
卑劣的脏鼠	bei'lie'de'zang'shu	0
背叛	bei'pan	0
备用零件	bei'yong'ling'jian	0
奔腾	ben'teng	0
崩盘领主	beng'pan'ling'zhu	0
碧池北婊	bi'chi'bei'biao	0
俾格米斥候	bi'ge'mi'chi'hou	0
俾格米刺客	bi'ge'mi'ci'ke	0
俾格米蛮兵	bi'ge'mi'man'bing	0
比格沃斯先生	bi'ge'wo'si'xian'sheng	0
碧火萨特	bi'huo'sa'te	0
碧蓝幼龙	bi'lan'you'long	0
匕首精通	bi'shou'jing'tong	0
比斯巨兽	bi'si'ju'shou	0
变鸡器	bian'ji'qi	0
变脸美少女变身	bian'lian'mei'shao'nv'bian'shen	0
变形	bian'xing	0
变形神龟	bian'xing'shen'gui	0
变形术	bian'xing'shu	0
变形术野猪	bian'xing'shu'ye'zhu	0
变形药水	bian'xing'yao'shui	0
变形者泽鲁斯	bian'xing'zhe'ze'lu'si	0
变羊咩	bian'yang'mie	0
变异注射	bian'yi'zhu'she	0
变猪	bian'zhu	0
标记	biao'ji	0
蹩脚海盗	bie'jiao'hai'dao	0
冰爆	bing'bao	0
冰川碎片	bing'chuan'sui'pian	0
冰冻	bing'dong	0
冰冻粉碎者	bing'dong'fen'sui'zhe	0
冰冻陷阱	bing'dong'xian'jing	0
冰冻药水	bing'dong'yao'shui	0
冰法	bing'fa	0
冰风雪人	bing'feng'xue'ren	0
冰冠守卫	bing'guan'shou'wei	0
冰吼	bing'hou	0
冰喉	bing'hou	0
冰环	bing'huan	0
冰甲	bing'jia	0
冰龙	bing'long	0
冰枪术	bing'qiang'shu	0
冰霜冲击	bing'shuang'chong'ji	0
冰霜巨人	bing'shuang'ju'ren	0
冰霜吐息	bing'shuang'tu'xi	0
冰霜新星	bing'shuang'xin'xing	0
冰霜元素	bing'shuang'yuan'su	0
冰霜震击	bing'shuang'zhen'ji	0
冰箱	bing'xiang	0
冰锥术	bing'zhui'shu	0
博尔夫碎盾	bo'er'fu'sui'dun	0
波戈蒙斯塔	bo'ge'meng'si'ta	0
玻璃	bo'li	0
伯瓦尔弗塔根	bo'wa'er'fu'ta'gen	0
博物馆馆长	bo'wu'guan'guan'zhang	0
补刀锤	bu'dao'chui	0
补丁	bu'ding	0
布莱恩铜须	bu'lai'en'tong'xu	0
布林顿	bu'lin'dun	0
布林顿型	bu'lin'dun'xing	0
部落的力量	bu'luo'de'li'liang	0
不稳定的传送门	bu'wen'ding'de'chuan'song'men	0
不稳定的元素	bu'wen'ding'de'yuan'su	0
捕熊陷阱	bu'xiong'xian'jing	0
裁决者格里斯通	cai'jue'zhe'ge'li'si'tong	0
裁决者图哈特	cai'jue'zhe'tu'ha'te	0
残暴的恐龙术士	can'bao'de'kong'long'shu'shi	0
残杀	can'sha	0
残阳	can'yang	0
藏宝海湾保镖	cang'bao'hai'wan'bao'biao	0
苍老师	cang'lao'shi	0
苍绿长颈龙	cang'lv'chang'jing'long	0
策反	ce'fan	0
叉闪	cha'shan	0
叉妆闪电	cha'zhuang'shan'dian	0
叉状闪电	cha'zhuang'shan'dian	0
豺狼人	chai'lang'ren	0
豺狼人土枪手	chai'lang'ren'tu'qiang'shou	0
颤地者特洛格佐尔	chan'di'zhe'te'luo'ge'zuo'er	0
忏悔	chan'hui	0
长鬃草原师	chang'zong'cao'yuan'shi	0
长鬃草原狮	chang'zong'cao'yuan'shi	0
吵吵机器人	chao'chao'ji'qi'ren	0
嘲讽	chao'feng	0
陈美嘉	chen'mei'jia	0
尘魔	chen'mo	0
沉默	chen'mo	0
沉默的骑士	chen'mo'de'qi'shi	0
沉默之子李显龙	chen'mo'zhi'zi'li'xian'long	0
陈妍希盾妹	chen'yan'xi'dun'mei	0
城管	cheng'guan	0
惩黑除恶	cheng'hei'chu'e	0
惩击	cheng'ji	0
成长	cheng'zhang	0
持盾侍卫	chi'dun'shi'wei	0
持盾卫士	chi'dun'wei'shi	0
迟钝卫士	chi'dun'wei'shi	0
痴汉	chi'han	0
炽烈的火把	chi'lie'de'huo'ba	0
齿轮大师	chi'lun'da'shi	0
齿轮大师扳手	chi'lun'da'shi'ban'shou	0
齿轮光锤	chi'lun'guang'chui	0
持枪侍从	chi'qiang'shi'cong	0
炽炎蝙蝠	chi'yan'bian'fu	0
炽炎战斧	chi'yan'zhan'fu	0
冲动	chong'dong	0
冲锋	chong'feng	0
冲锋树人	chong'feng'shu'ren	0
冲锋詹姆斯	chong'feng'zhan'mu'si	0
冲锋猪小野菊中立照明弹	chong'feng'zhu'xiao'ye'ju'zhong'li'zhao'ming'dan	0
崇高牺牲	chong'gao'xi'sheng	0
充能	chong'neng	0
虫群风暴	chong'qun'feng'bao	0
重新开始满上	chong'xin'kai'shi'man'shang	0
重装佣兵	chong'zhuang'yong'bing	0
仇恨打击	chou'hen'da'ji	0
抽鸡	chou'ji	0
抽牌树	chou'pai'shu	0
抽牌鱼爆牌鱼秋日鱼人	chou'pai'yu'bao'pai'yu'qiu'ri'yu'ren	0
抽血抽一口	chou'xue'chou'yi'kou	0
橱柜蜘蛛	chu'gui'zhi'zhu	0
雏龙	chu'long	0
触须	chu'xu	0
穿刺者	chuan'ci'zhe	0
穿刺者戈莫克	chuan'ci'zhe'ge'mo'ke	0
传令官沃拉兹	chuan'ling'guan'wo'la'zi	0
传说	chuan'shuo	0
船载火炮	chuan'zai'huo'pao	0
船长的鹦鹉	chuan'zhang'de'ying'wu	0
吹风	chui'feng	0
吹箭鱼人	chui'jian'yu'ren	0
吹嘘海盗	chui'xu'hai'dao	0
纯洁者耶德瑞克	chun'jie'zhe'ye'de'rui'ke	0
纯净水的力量水领主	chun'jing'shui'de'li'liang'shui'ling'zhu	0
刺骨	ci'gu	0
次级治疗术	ci'ji'zhi'liao'shu	0
刺客	ci'ke	0
刺客之刃	ci'ke'zhi'ren	0
刺杀	ci'sha	0
慈祥的外婆	ci'xiang'de'wai'po	0
丛林猎豹	cong'lin'lie'bao	0
丛林猎人赫米特	cong'lin'lie'ren'he'mi'te	0
丛林守护者	cong'lin'shou'hu'zhe	0
丛林枭兽	cong'lin'xiao'shou	0
丛林之魂	cong'lin'zhi'hun	0
丛林之魂剧毒之种	cong'lin'zhi'hun'ju'du'zhi'zhong	0
淬毒利刃	cui'du'li'ren	0
摧毁他们	cui'hui'ta'men	0
大宝剑	da'bao'jian	0
大刀大匕首	da'dao'da'bi'shou	0
大导师的教诲	da'dao'shi'de'jiao'hui	0
大帝	da'di	0
大地震击	da'di'zhen'ji	0
大地之环先知	da'di'zhi'huan'xian'zhi	0
大地之鳞	da'di'zhi'lin	0
大发明家	da'fa'ming'jia	0
大伐木机花母鸡	da'fa'mu'ji'hua'mu'ji	0
大法师	da'fa'shi	0
大法师安东尼达斯	da'fa'shi'an'dong'ni'da'si	0
大范	da'fan	0
大富翁比尔杜	da'fu'weng'bi'er'du	0
达基萨斯的命令	da'ji'sa'si'de'ming'ling	0
达基萨斯将军	da'ji'sa'si'jiang'jun	0
打开大门	da'kai'da'men	0
打开时空之门	da'kai'shi'kong'zhi'men	0
达拉然法师	da'la'ran'fa'shi	0
达拉然铁骑士	da'la'ran'tie'qi'shi	0
大脸盆抱歉	da'lian'pen'bao'qian	0
大螺丝	da'luo'si	0
大麦田狂战斧	da'mai'tian'kuang'zhan'fu	0
大漠沙驼	da'mo'sha'tuo	0
达纳苏斯豹骑士	da'na'su'si'bao'qi'shi	0
大胖	da'pang	0
大拳头	da'quan'tou	0
大师级枪骑士	da'shi'ji'qiang'qi'shi	0
大团长	da'tuan'zhang	0
大型豺狼人	da'xing'chai'lang'ren	0
大漩涡传送门	da'xuan'wo'chuan'song'men	0
淡水鳄	dan'shui'e	0
挡刀坚持不懈	dang'dao'jian'chi'bu'xie	0
刀瓣鞭笞者	dao'ban'bian'chi'zhe	0
刀瓣齐射	dao'ban'qi'she	0
导航小鸡	dao'hang'xiao'ji	0
盗墓匪贼	dao'mu'fei'zei	0
刀扇	dao'shan	0
德莱尼图腾师	de'lai'ni'tu'teng'shi	0
德鲁伊	de'lu'yi	0
德鲁伊优胜	de'lu'yi'you'sheng	0
德鲁伊支配者	de'lu'yi'zhi'pei'zhe	0
等攻	deng'gong	0
迪菲亚海盗	di'fei'ya'hai'dao	0
迪菲亚清道夫	di'fei'ya'qing'dao'fu	0
迪菲亚头目	di'fei'ya'tou'mu	0
地环	di'huan	0
帝皇眼镜蛇	di'huang'yan'jing'she	0
低阶侍从	di'jie'shi'cong	0
地精工兵	di'jing'gong'bing	0
地精炎术士	di'jing'yan'shu'shi	0
地精炎术师	di'jing'yan'shu'shi	0
地精自动理发装置	di'jing'zi'dong'li'fa'zhuang'zhi	0
地雷	di'lei	0
地雷车	di'lei'che	0
帝王传承	di'wang'chuan'cheng	0
帝王眼镜蛇	di'wang'yan'jing'she	0
地狱火	di'yu'huo	0
地狱烈焰	di'yu'lie'yan	0
电镀机械熊仔	dian'du'ji'xie'xiong'zai	0
电荷金刚	dian'he'jin'gang	0
电疗	dian'liao	0
点燃法力	dian'ran'fa'li	0
电视	dian'shi	0
电线杆	dian'xian'gan	0
钓鱼王不持盾卫士	diao'yu'wang'bu'chi'dun'wei'shi	0
冻结	dong'jie	0
动力战锤	dong'li'zhan'chui	0
动物伙伴	dong'wu'huo'ban	0
逗比风暴作死风暴最强驾驶员	dou'bi'feng'bao'zuo'si'feng'bao'zui'qiang'jia'shi'yuan	0
逗比工匠	dou'bi'gong'jiang	0
兜帽侍僧	dou'mao'shi'seng	0
毒镖陷阱	du'biao'xian'jing	0
渡魂者	du'hun'zhe	0
毒瘤卡组	du'liu'ka'zu	0
毒刃	du'ren	0
毒杀	du'sha	0
毒蛇	du'she	0
毒蛇陷阱	du'she'xian'jing	0
毒心者夏克里尔	du'xin'zhe'xia'ke'li'er	0
毒性污水软泥怪	du'xing'wu'shui'ruan'ni'guai	0
独眼欺诈者	du'yan'qi'zha'zhe	0
毒药涂毒	du'yao'tu'du	0
镀银魔像	du'yin'mo'xiang	0
毒云	du'yun	0
毒沼爬行者	du'zhao'pa'xing'zhe	0
盾格	dun'ge	0
盾甲侍女	dun'jia'shi'nv	0
盾猛	dun'meng	0
盾牌格挡	dun'pai'ge'dang	0
盾牌猛击	dun'pai'meng'ji	0
盾牌枪击	dun'pai'qiang'ji	0
多彩狗安德罗妮会长	duo'cai'gou'an'de'luo'ni'hui'zhang	0
多彩龙人	duo'cai'long'ren	0
多彩幼龙	duo'cai'you'long	0
多重射击	duo'chong'she'ji	0
堕落的瓦拉斯塔兹	duo'luo'de'wa'la'si'ta'zi	0
恶毒的铁匠	e'du'de'tie'jiang	0
恶毒铁匠	e'du'tie'jiang	0
噩梦	e'meng	0
恶魔融合	e'mo'rong'he	0
恶魔守卫	e'mo'shou'wei	0
恶魔卫士	e'mo'wei'shi	0
恶魔之火	e'mo'zhi'huo	0
恶魔之怒	e'mo'zhi'nu	0
恶魔之心	e'mo'zhi'xin	0
厄运召唤者	e'yun'zhao'huan'zhe	0
厄运之镜	e'yun'zhi'jing	0
恩师的教诲	en'shi'de'jiao'hui	0
恩佐斯	en'zuo'si	0
恩佐斯的触须	en'zuo'si'de'chu'xu	0
恩佐斯的副官	en'zuo'si'de'fu'guan	0
恩佐斯的子嗣	en'zuo'si'de'zi'si	0
二流打手	er'liu'da'shou	0
二四鬼爆破	er'si'gui'bao'po	0
法反反制	fa'fan'fan'zhi	0
法力浮龙	fa'li'fu'long	0
发力过剩	fa'li'guo'sheng	0
法力过剩	fa'li'guo'sheng	0
法力晶簇	fa'li'jing'cu	0
法力龙	fa'li'long	0
法力图腾之潮汐图腾	fa'li'tu'teng'zhi'chao'xi'tu'teng	0
法力怨魂	fa'li'yuan'hun	0
法力之潮图腾	fa'li'zhi'chao'tu'teng	0
法力之泉图腾	fa'li'zhi'quan'tu'teng	0
法师	fa'shi	0
法师反制	fa'shi'fan'zhi	0
法师学徒	fa'shi'xue'tu	0
法师优胜	fa'shi'you'sheng	0
法师支配者	fa'shi'zhi'pei'zhe	0
法术大师	fa'shu'da'shi	0
法术反制	fa'shu'fan'zhi	0
法术共鸣	fa'shu'gong'ming	0
法术伤害	fa'shu'shang'hai	0
发条巨人	fa'tiao'ju'ren	0
发条骑士	fa'tiao'qi'shi	0
发条强盗机器人	fa'tiao'qiang'dao'ji'qi'ren	0
发条侏儒	fa'tiao'zhu'ru	0
发现	fa'xian	0
发现猎物枪毙	fa'xian'lie'wu'qiang'bi	0
翻倍	fan'bei	0
范达尔鹿盔	fan'da'er'lu'kui	0
犯罪高手	fan'zui'gao'shou	0
放狗	fang'gou	0
防战	fang'zhan	0
翡翠蜂后	fei'cui'feng'hou	0
翡翠掠夺者	fei'cui'lve'duo'zhe	0
翡翠幼龙	fei'cui'you'long	0
飞刀杂耍者	fei'dao'za'shua'zhe	0
费尔根	fei'er'gen	0
费尔根斯塔拉格	fei'er'gen'si'ta'la'ge	0
飞火流星芬杰	fei'huo'liu'xing'fen'jie	0
废旧螺栓机甲	fei'jiu'luo'shuan'ji'jia	0
飞掠召唤	fei'lve'zhao'huan	0
飞行器	fei'xing'qi	0
芬杰	fen'jie	0
芬克恩霍尔	fen'ke'en'huo'er	0
芬利莫格顿爵士	fen'li'mo'ge'dun'jue'shi	0
分裂软泥怪	fen'lie'ruan'ni'guai	0
愤怒	fen'nu	0
愤怒的小鸡	fen'nu'de'xiao'ji	0
愤怒卫士	fen'nu'wei'shi	0
愤怒之锤	fen'nu'zhi'chui	0
风暴看守	feng'bao'kan'shou	0
风暴守护者	feng'bao'shou'hu'zhe	0
封闭测试补丁	feng'bi'ce'shi'bu'ding	0
风驰电掣	feng'chi'dian'che	0
疯狂爆破者	feng'kuang'bao'po'zhe	0
疯狂的冰法师	feng'kuang'de'bing'fa'shi	0
疯狂的猴子	feng'kuang'de'hou'zi	0
疯狂的科学家	feng'kuang'de'ke'xue'jia	0
疯狂的炼金师	feng'kuang'de'lian'jin'shi	0
疯狂的猎人	feng'kuang'de'lie'ren	0
疯狂轰炸者	feng'kuang'hong'zha'zhe	0
疯狂投弹者	feng'kuang'tou'dan'zhe	0
疯狂信徒	feng'kuang'xin'tu	0
疯狂药水	feng'kuang'yao'shui	0
风领主奥拉基尔	feng'ling'zhu'ao'la'ji'er	0
风怒	feng'nu	0
风怒雪人	feng'nu'xue'ren	0
风怒鹰身人	feng'nu'ying'shen'ren	0
风投	feng'tou	0
奉献	feng'xian	0
风险投资公司雇佣兵	feng'xian'tou'zi'gong'si'gu'yong'bing	0
风险投资公司佣兵	feng'xian'tou'zi'gong'si'yong'bing	0
风语者	feng'yu'zhe	0
风之领主奥拉基尔	feng'zhi'ling'zhu'ao'la'ji'er	0
复仇	fu'chou	0
复仇之怒	fu'chou'zhi'nu	0
缚法者	fu'fa'zhe	0
腐根	fu'gen	0
腐化的蛋	fu'hua'de'dan	0
腐化灰熊	fu'hua'hui'xiong	0
腐化迷雾	fu'hua'mi'wu	0
腐化先知	fu'hua'xian'zhi	0
腐化治疗机器人	fu'hua'zhi'liao'ji'qi'ren	0
俘获的冰虫	fu'huo'de'bing'chong	0
复活的铠甲	fu'huo'de'kai'jia	0
复活术	fu'huo'shu	0
妇联者	fu'lian'zhe	0
缚链者拉兹	fu'lian'zhe'la'zi	0
附灵术	fu'ling'shu	0
腐肉虫	fu'rou'chong	0
腐肉食尸鬼	fu'rou'shi'shi'gui	0
负伤的剑圣	fu'shang'de'jian'sheng	0
负伤剑圣	fu'shang'jian'sheng	0
腐蚀术	fu'shi'shu	0
符文蛋	fu'wen'dan	0
符文剑	fu'wen'jian	0
符文巨剑	fu'wen'ju'jian	0
复制	fu'zhi	0
盖斯	gai'si	0
干杯	gan'bei	0
感知恶魔	gan'zhi'e'mo	0
钢铁触须	gang'tie'chu'xu	0
钢铁武道家	gang'tie'wu'dao'jia	0
钢铁战蝎	gang'tie'zhan'xie	0
搞定他们	gao'ding'ta'men	0
高级修理机器人	gao'ji'xiu'li'ji'qi'ren	0
格斗陪练师	ge'dou'pei'lian'shi	0
格斗士	ge'dou'shi	0
格尔宾梅卡托克	ge'er'bin'mei'ka'tuo'ke	0
葛拉卡爬行蟹	ge'la'ka'pa'xing'xie	0
格拉斯	ge'la'si	0
格鲁尔	ge'lu'er	0
格罗布鲁斯	ge'luo'bu'lu'si	0
格罗玛什地狱咆哮	ge'luo'ma'shen'di'yu'pao'xiao	0
格罗姆地狱咆哮	ge'luo'mu'di'yu'pao'xiao	0
公辩律师	gong'bian'lv'shi	0
攻城车	gong'cheng'che	0
工程师学徒	gong'cheng'shi'xue'tu	0
功夫大师	gong'fu'da'shi	0
攻击模式	gong'ji'mo'shi	0
工匠大师欧沃斯巴克	gong'jiang'da'shi'ou'wo'si'ba'ke	0
工匠镇技师	gong'jiang'zhen'ji'shi	0
公正剑	gong'zheng'jian	0
公正之剑	gong'zheng'zhi'jian	0
沟渠潜伏者	gou'qu'qian'fu'zhe	0
沟通星界	gou'tong'xing'jie	0
狗头人地卜师	gou'tou'ren'di'bu'shi	0
古代酒仙	gu'dai'jiu'xian	0
古尔丹	gu'er'dan	0
古加尔	gu'jia'er	0
古拉巴克狂暴者	gu'la'ba'ke'kuang'bao'zhe	0
古拉巴什狂暴者	gu'la'ba'shi'kuang'bao'zhe	0
古拉巴什狂战士	gu'la'ba'shi'kuang'zhan'shi	0
古老的教诲	gu'lao'de'jiao'hui	0
古老的秘密	gu'lao'de'mi'mi	0
古神小精灵	gu'shen'xiao'jing'ling	0
钴制卫士	gu'zhi'wei'shi	0
冠军贼	guan'jun'zei	0
管理者埃克索图斯	guan'li'zhe'ai'ke'suo'tu'si	0
灌魔之锤	guan'mo'zhi'chui	0
馆长	guan'zhang	0
光明祭司	guang'ming'ji'si	0
光明圣印	guang'ming'sheng'yin	0
光明邪神菲奥拉	guang'ming'xie'shen'fei'ao'la	0
光明之泉	guang'ming'zhi'quan	0
光耀之主拉格纳罗斯	guang'yao'zhi'zhu'la'ge'na'luo'si	0
光耀之子	guang'yao'zhi'zi	0
光照元素	guang'zhao'yuan'su	0
光铸剑龙	guang'zhu'jian'long	0
鬼父	gui'fu	0
鬼灵爬行者	gui'ling'pa'xing'zhe	0
鬼灵骑兵	gui'ling'qi'bing	0
鬼灵骑士	gui'ling'qi'shi	0
鬼灵学徒	gui'ling'xue'tu	0
鬼灵战士	gui'ling'zhan'shi	0
鬼灵蜘蛛	gui'ling'zhi'zhu	0
诡异的雕像	gui'yi'de'diao'xiang	0
裹体之网	guo'ti'zhi'wang	0
国王护卫者	guo'wang'hu'wei'zhe	0
郭雅夫人	guo'ya'fu'ren	0
过载	guo'zai	0
聒噪的挖掘者	guo'zao'de'wa'jue'zhe	0
哈霍兰公主	ha'huo'lan'gong'zhu	0
哈里森琼斯	ha'li'sen'qiong'si	0
海潮涌动	hai'chao'yong'dong	0
海盗帕奇斯	hai'dao'pa'qi'si	0
海地精猎手	hai'di'jing'lie'shou	0
海巨人	hai'ju'ren	0
海龙战	hai'long'zhan	0
海魔钉刺者	hai'mo'ding'ci'zhe	0
海象人龟骑士	hai'xiang'ren'gui'qi'shi	0
海象人警长	hai'xiang'ren'jing'zhang	0
海象人图腾师	hai'xiang'ren'tu'teng'shi	0
海贼王	hai'zei'wang	0
寒冰暴怒者	han'bing'bao'nu'zhe	0
寒冰护体	han'bing'hu'ti	0
寒冰箭	han'bing'jian	0
寒冰屏障	han'bing'ping'zhang	0
寒光先知	han'guang'xian'zhi	0
寒光智者	han'guang'zhi'zhe	0
赫米特奈辛瓦里	he'mi'te'nai'xin'wa'li	0
河爪豺狼人	he'zhao'chai'lang'ren	0
黑暗低语者	hei'an'di'yu'zhe	0
黑暗教徒	hei'an'jiao'tu	0
黑暗契约	hei'an'qi'yue	0
黑暗曙光	hei'an'shu'guang	0
黑暗邪神艾蒂丝	hei'an'xie'shen'ai'di'si	0
黑暗鸦人	hei'an'ya'ren	0
黑暗渔夫纳特	hei'an'yu'fu'na'te	0
黑暗召唤者	hei'an'zhao'huan'zhe	0
黑洞扭一扭	hei'dong'niu'yi'niu	0
黑金大亨	hei'jin'da'heng	0
黑科技卡组	hei'ke'ji'ka'zu	0
黑龙	hei'long	0
黑龙吐息	hei'long'tu'xi	0
黑女巫法琳娜	hei'nv'wu'fa'lin'na	0
黑骑	hei'qi	0
黑骑士	hei'qi'shi	0
黑石观众	hei'shi'guan'zhong	0
黑市摊贩	hei'shi'tan'fan	0
黑水海盗	hei'shui'hai'dao	0
黑铁	hei'tie	0
黑铁矮人	hei'tie'ai'ren	0
黑铁保镖	hei'tie'bao'biao	0
黑铁潜藏者	hei'tie'qian'cang'zhe	0
黑曜石毁灭者	hei'yao'shi'hui'mie'zhe	0
黑曜石碎片	hei'yao'shi'sui'pian	0
黑翼	hei'yi	0
黑翼腐蚀者	hei'yi'fu'shi'zhe	0
黑翼技师	hei'yi'ji'shi	0
横扫	heng'sao	0
轰击	hong'ji	0
红龙	hong'long	0
红龙精华	hong'long'jing'hua	0
红石头人	hong'shi'tou'ren	0
虹吸	hong'xi	0
吼爹	hou'die	0
后街男巫	hou'jie'nan'wu	0
后院保镖	hou'yuan'bao'biao	0
护盾机器人	hu'dun'ji'qi'ren	0
琥口脱险	hu'kou'tuo'xian	0
猢狲医者	hu'sun'yi'zhe	0
湖之仙女	hu'zhi'xian'nv	0
滑行者索格斯	hua'xing'zhe'suo'ge'si	0
化学怪人	hua'xue'guai'ren	0
化血为脓	hua'xue'wei'nong	0
幻觉	huan'jue	0
唤魔者克鲁尔	huan'mo'zhe'ke'lu'er	0
环牧	huan'mu	0
欢雾者	huan'wu'zhe	0
唤雾者伊戈瓦尔	huan'wu'zhe'yi'ge'wa'er	0
幻象制造者	huan'xiang'zhi'zao'zhe	0
欢笑的姐妹	huan'xiao'de'jie'mei	0
唤醒造物者	huan'xing'zao'wu'zhe	0
皇家雷象	huang'jia'lei'xiang	0
黄金猿	huang'jin'yuan	0
黄金猿藏宝图	huang'jin'yuan'cang'bao'tu	0
荒蛮之主卡利莫斯	huang'man'zhi'zhu'ka'li'mo'si	0
黄铜指虎	huang'tong'zhi'hu	0
皇血草毒素	huang'xue'cao'du'su	0
荒野骑士	huang'ye'qi'shi	0
荒野行者	huang'ye'xing'zhe	0
灰烬使者	hui'jin'shi'zhe	0
灰烬漩涡	hui'jin'xuan'wo	0
毁灭之锤	hui'mie'zhi'chui	0
毁灭之刃	hui'mie'zhi'ren	0
回收	hui'shou	0
回收机器人	hui'shou'ji'qi'ren	0
回响之锣	hui'xiang'zhi'luo	0
回音定位	hui'yin'ding'wei	0
魂火	hun'huo	0
魂体双分	hun'ti'shuang'fen	0
霍巴特钩锤	huo'ba'te'gou'chui	0
火车王	huo'che'wang	0
火车王里诺艾	huo'che'wang'li'nuo'ai	0
火车王里诺艾奥妮克希亚	huo'che'wang'li'nuo'ai'ao'ni'ke'xi'ya	0
火冲点一下	huo'chong'dian'yi'xia	0
火爹陈奕迅	huo'die'chen'yi'xun	0
活动假人	huo'dong'jia'ren	0
霍弗	huo'fu	0
霍格	huo'ge	0
活力图腾	huo'li'tu'teng	0
火枪轰击	huo'qiang'hong'ji	0
火球术	huo'qiu'shu	0
火山爆发	huo'shan'bao'fa	0
火山龙	huo'shan'long	0
火山邪木	huo'shan'xie'mu	0
火山药水	huo'shan'yao'shui	0
火山幼龙	huo'shan'you'long	0
火舌	huo'she	0
火舌图腾	huo'she'tu'teng	0
火誓者	huo'shi'zhe	0
活体法力	huo'ti'fa'li	0
活体风暴	huo'ti'feng'bao	0
活体根须	huo'ti'gen'xu	0
活体熔岩	huo'ti'rong'yan	0
活体炸弹	huo'ti'zha'dan	0
火焰冲击	huo'yan'chong'ji	0
火焰花毒素	huo'yan'hua'du'su	0
火焰猎豹形态	huo'yan'lie'bao'xing'tai	0
火焰领主拉格纳罗斯	huo'yan'ling'zhu'la'ge'na'luo'si	0
火焰驱逐者	huo'yan'qu'zhu'zhe	0
火焰使者	huo'yan'shi'zhe	0
火岩元素	huo'yan'yuan'su	0
火焰杂耍者	huo'yan'za'shua'zhe	0
火焰之地传送门	huo'yan'zhi'di'chuan'song'men	0
火焰之雨	huo'yan'zhi'yu	0
火妖	huo'yao	0
火妖管理者	huo'yao'guan'li'zhe	0
火翼精灵	huo'yi'jing'ling	0
火鹰形态	huo'ying'xing'tai	0
火羽凤凰	huo'yu'feng'huang	0
火羽之心	huo'yu'zhi'xin	0
火元素	huo'yuan'su	0
吉安娜普罗德摩尔	ji'an'na'pu'luo'de'mo'er	0
畸变的龙鹰	ji'bian'de'long'ying	0
畸变怪	ji'bian'guai	0
畸变狂战士	ji'bian'kuang'zhan'shi	0
饥饿的巨龙	ji'e'de'ju'long	0
饥饿的螃蟹	ji'e'de'pang'xie	0
饥饿的秃鹫	ji'e'de'tu'jiu	0
饥饿的翼手龙	ji'e'de'yi'shou'long	0
极恶之咒	ji'e'zhi'zhou	0
机关枪共产主义机关枪	ji'guan'qiang'gong'chan'zhu'yi'ji'guan'qiang	0
极寒之击	ji'han'zhi'ji	0
集合石	ji'he'shi	0
激活	ji'huo	0
激活电荷金刚	ji'huo'dian'he'jin'gang	0
激活金刚单位	ji'huo'jin'gang'dan'wei	0
激活剧毒金刚	ji'huo'ju'du'jin'gang	0
激活熔岩金刚	ji'huo'rong'yan'jin'gang	0
击剑教头	ji'jian'jiao'tou	0
集结之刃	ji'jie'zhi'ren	0
基佬来我房间思聪	ji'lao'lai'wo'fang'jian'si'cong	0
激励	ji'li	0
激怒	ji'nu	0
疾跑	ji'pao	0
寄生恶狼	ji'sheng'e'lang	0
寄生感染	ji'sheng'gan'ran	0
急速真空吸	ji'su'zhen'kong'xi	0
基维斯	ji'wei'si	0
机械	ji'xie	0
机械动物管理员	ji'xie'dong'wu'guan'li'yuan	0
机械雪人	ji'xie'xue'ren	0
机械野兽	ji'xie'ye'shou	0
机械幼龙	ji'xie'you'long	0
机械幼龙技工	ji'xie'you'long'ji'gong	0
机械幼龙技师	ji'xie'you'long'ji'shi	0
机械跃迁者	ji'xie'yue'qian'zhe	0
极性转换	ji'xing'zhuan'huan	0
基因转接	ji'yin'zhuan'jie	0
嘉顿	jia'dun	0
迦顿男爵	jia'dun'nan'jue	0
加尔	jia'er	0
加尔鲁什地狱咆哮	jia'er'lu'shen'di'yu'pao'xiao	0
加固	jia'gu	0
加基森	jia'ji'sen	0
加基森摆渡人	jia'ji'sen'bai'du'ren	0
加基森名媛	jia'ji'sen'ming'yuan	0
加基森拍卖师	jia'ji'sen'pai'mai'shi	0
加基森枪骑士	jia'ji'sen'qiang'qi'shi	0
加拉克苏斯大王	jia'la'ke'su'si'da'wang	0
加拉克苏斯之拳	jia'la'ke'su'si'zhi'quan	0
加里维克斯	jia'li'wei'ke'si	0
加里维克斯的硬币	jia'li'wei'ke'si'de'ying'bi	0
假死	jia'si	0
嘉沃顿	jia'wo'dun	0
加兹鲁维	jia'zi'lu'wei	0
加兹瑞拉	jia'zi'rui'la	0
剑齿追猎者	jian'chi'zhui'lie'zhe	0
监工	jian'gong	0
剑龙	jian'long	0
剑龙骑术	jian'long'qi'shu	0
坚韧祷言	jian'ren'dao'yan	0
剑刃乱舞	jian'ren'luan'wu	0
剑圣	jian'sheng	0
践踏	jian'ta	0
践踏者班纳布斯	jian'ta'zhe'ban'na'bu'si	0
尖牙德鲁伊	jian'ya'de'lu'yi	0
渐隐	jian'yin	0
角斗士的长弓	jiao'dou'shi'de'chang'gong	0
教官拉苏维奥斯	jiao'guan'la'su'wei'ao'si	0
叫嚣	jiao'xiao	0
叫嚣的中士	jiao'xiao'de'zhong'shi	0
焦油爬行者	jiao'you'pa'xing'zhe	0
焦油潜伏者	jiao'you'qian'fu'zhe	0
劫持者	jie'chi'zhe	0
结晶预言者	jie'jing'yu'yan'zhe	0
街头调查员	jie'tou'diao'cha'yuan	0
结网蛛	jie'wang'zhu	0
节奏卡组	jie'zou'ka'zu	0
浸毒武器	jin'du'wu'qi	0
金刚刃牙兽	jin'gang'ren'ya'shou	0
进化	jin'hua	0
进化大师	jin'hua'da'shi	0
进化的狗头人	jin'hua'de'gou'tou'ren	0
禁忌古树	jin'ji'gu'shu	0
禁忌畸变	jin'ji'ji'bian	0
紧急冷冻剂	jin'ji'leng'dong'ji	0
禁忌烈焰	jin'ji'lie'yan	0
禁忌仪式	jin'ji'yi'shi	0
禁忌治疗	jin'ji'zhi'liao	0
禁魔	jin'mo	0
金手指卡努克	jin'shou'zhi'ka'nu'ke	0
锦鱼人水语者	jin'yu'ren'shui'yu'zhe	0
警报机器人	jing'bao'ji'qi'ren	0
惊骇恐魔	jing'hai'kong'mo	0
净化	jing'hua	0
竞技场霸主	jing'ji'chang'ba'zhu	0
竞技场推广员	jing'ji'chang'tui'guang'yuan	0
竞技场主宰	jing'ji'chang'zhu'zai	0
荆棘谷猛虎	jing'ji'gu'meng'hu	0
竞技推广员	jing'ji'tui'guang'yuan	0
精控	jing'kong	0
精灵弓箭手	jing'ling'gong'jian'shou	0
精灵龙	jing'ling'long	0
精灵射手	jing'ling'she'shou	0
精神崩溃	jing'shen'beng'kui	0
精神控制	jing'shen'kong'zhi	0
精神控制技师	jing'shen'kong'zhi'ji'shi	0
精神控制水晶	jing'shen'kong'zhi'shui'jing	0
镜像	jing'xiang	0
镜像实体	jing'xiang'shi'ti	0
镜像术	jing'xiang'shu	0
精英对决	jing'ying'dui'jue	0
精英牛头酋长	jing'ying'niu'tou'qiu'zhang	0
精英牛头人酋长	jing'ying'niu'tou'ren'qiu'zhang	0
旧部落	jiu'bu'luo	0
旧部落兽人	jiu'bu'luo'shou'ren	0
救赎	jiu'shu	0
九五至尊	jiu'wu'zhi'zun	0
巨齿刀叶	ju'chi'dao'ye	0
剧毒金刚	ju'du'jin'gang	0
剧毒之种	ju'du'zhi'zhong	0
巨颚	ju'e	0
菊花茶	ju'hua'cha	0
巨化术	ju'hua'shu	0
狙击	ju'ji	0
巨龙领主死亡之翼	ju'long'ling'zhu'si'wang'zhi'yi	0
巨型蟾蜍	ju'xing'chan'chu	0
巨型独眼怪	ju'xing'du'yan'guai	0
巨型黄蜂	ju'xing'huang'feng	0
巨型蟒蛇	ju'xing'mang'she	0
巨型乳齿象	ju'xing'ru'chi'xiang	0
巨型沙虫	ju'xing'sha'chong	0
角斗场主管	jue'dou'chang'zhu'guan	0
倔强的蜗牛	jue'jiang'de'wo'niu	0
绝命乱斗	jue'ming'luan'dou	0
抉择	jue'ze	0
军备宝箱	jun'bei'bao'xiang	0
军情七处特工	jun'qing'qi'chu'te'gong	0
军需官	jun'xu'guan	0
卡费	ka'fei	0
卡拉克西织珀者	ka'la'ke'xi'zhi'po'zhe	0
卡利莫斯的仆从	ka'li'mo'si'de'pu'cong	0
卡牌赠礼	ka'pai'zeng'li	0
卡扎库斯	ka'zha'ku'si	0
开蛋器	kai'dan'qi	0
凯恩血蹄	kai'en'xue'ti	0
开始旋转陀螺打蛋器	kai'shi'xuan'zhuan'tuo'luo'da'dan'qi	0
开拓者伊莉斯	kai'tuo'zhe'yi'li'si	0
考达拉幼龙	kao'da'la'you'long	0
科多兽骑士	ke'duo'shou'qi'shi	0
克尔苏加德	ke'er'su'jia'de	0
科技德	ke'ji'de	0
科林烈酒	ke'lin'lie'jiu	0
克洛玛古斯	ke'luo'ma'gu'si	0
克苏恩	ke'su'en	0
克苏恩的侍从	ke'su'en'de'shi'cong	0
克苏恩的信徒	ke'su'en'de'xin'tu	0
克苏恩之刃	ke'su'en'zhi'ren	0
克瓦迪尔劫掠者	ke'wa'di'er'jie'lve'zhe	0
科赞秘术师	ke'zan'mi'shu'shi	0
肯瑞托法师	ken'rui'tuo'fa'shi	0
坑道穴居人	keng'dao'xue'ju'ren	0
恐怖的奴隶主	kong'bu'de'nu'li'zhu	0
恐怖海盗	kong'bu'hai'dao	0
恐怖末日守卫	kong'bu'mo'ri'shou'wei	0
恐角龙宝宝	kong'jiao'long'bao'bao	0
恐角龙头领	kong'jiao'long'tou'ling	0
恐惧地狱火	kong'ju'di'yu'huo	0
恐惧丧钟	kong'ju'sang'zhong	0
恐惧战马	kong'ju'zhan'ma	0
恐狼	kong'lang	0
恐狼前锋	kong'lang'qian'feng	0
恐鳞	kong'lin	0
恐鳞追猎者	kong'lin'zhui'lie'zhe	0
空灵	kong'ling	0
空灵召唤者	kong'ling'zhao'huan'zhe	0
恐龙学	kong'long'xue	0
空气元素	kong'qi'yuan'su	0
空气之怒图腾	kong'qi'zhi'nu'tu'teng	0
空无之影	kong'wu'zhi'ying	0
控心术	kong'xin'shu	0
口交斧	kou'jiao'fu	0
苦潮多头蛇	ku'chao'duo'tou'she	0
库尔塔兹领主	ku'er'ta'zi'ling'zhu	0
库卡隆精英	ku'ka'long'jing'ying	0
库卡隆精英卫士	ku'ka'long'jing'ying'wei'shi	0
骷髅	ku'lou	0
骷髅骑士	ku'lou'qi'shi	0
骷髅铁匠	ku'lou'tie'jiang	0
苦痛侍僧	ku'tong'shi'seng	0
苦修	ku'xiu	0
枯叶草毒素	ku'ye'cao'du'su	0
快速射击	kuai'su'she'ji	0
快速治疗	kuai'su'zhi'liao	0
狂暴	kuang'bao	0
狂奔的科多兽	kuang'ben'de'ke'duo'shou	0
狂奔的魔暴龙	kuang'ben'de'mo'bao'long	0
狂奔科多兽	kuang'ben'ke'duo'shou	0
狂乱	kuang'luan	0
狂乱传染	kuang'luan'chuan'ran	0
狂怒的狼人	kuang'nu'de'lang'ren	0
狂热的新兵	kuang're'de'xin'bing	0
狂热铸魂者	kuang're'zhu'hun'zhe	0
狂野的拉佐格尔	kuang'ye'de'la'zuo'ge'er	0
狂野魔法	kuang'ye'mo'fa	0
狂野怒火	kuang'ye'nu'huo	0
狂野炎术士	kuang'ye'yan'shu'shi	0
狂野炎术师	kuang'ye'yan'shu'shi	0
狂野争斗者	kuang'ye'zheng'dou'zhe	0
拉法姆的诅咒	la'fa'mu'de'zu'zhou	0
拉卡利地狱犬	la'ka'li'di'yu'quan	0
拉卡利献祭	la'ka'li'xian'ji	0
啦啦啦	la'la'la	0
拉文霍德刺客	la'wen'huo'de'ci'ke	0
拉希奥	la'xi'ao	0
拉西奥	la'xi'ao	0
拉兹	la'zi	0
拉佐格尔之爪	la'zuo'ge'er'zhi'zhao	0
来和我的小伙伴打个招呼	lai'he'wo'de'xiao'huo'ban'da'ge'zhao'hu	0
蓝碧幼龙	lan'bi'you'long	0
蓝龙卡组	lan'long'ka'zu	0
蓝胖	lan'pang	0
蓝腮战士	lan'sai'zhan'shi	0
狼骑兵	lang'qi'bing	0
狼人欺诈者	lang'ren'qi'zha'zhe	0
狼人渗透者	lang'ren'shen'tou'zhe	0
狼人追猎者	lang'ren'zhui'lie'zhe	0
老法师	lao'fa'shi	0
老虎	lao'hu	0
老九	lao'jiu	0
老旧的火把	lao'jiu'de'huo'ba	0
老猎手	lao'lie'shou	0
老鲨嘴	lao'sha'zui	0
老式治疗机器人	lao'shi'zhi'liao'ji'qi'ren	0
老乌龟	lao'wu'gui	0
老瞎眼	lao'xia'yan	0
雷暴术	lei'bao'shu	0
雷德黑手	lei'de'hei'shou	0
雷克萨	lei'ke'sa	0
雷矛特种兵	lei'mao'te'zhong'bing	0
雷鸣刺喉龙	lei'ming'ci'hou'long	0
雷诺	lei'nuo	0
雷诺杰克逊	lei'nuo'jie'ke'xun	0
雷欧可	lei'ou'ke	0
雷霆蜥蜴	lei'ting'xi'yi	0
雷霆崖勇士	lei'ting'ya'yong'shi	0
雷铸战斧	lei'zhu'zhan'fu	0
冷酷骑兵	leng'ku'qi'bing	0
冷酷学徒	leng'ku'xue'tu	0
冷酷战士	leng'ku'zhan'shi	0
冷血	leng'xue	0
力代	li'dai	0
力量的代价	li'liang'de'dai'jia	0
力量的祝福	li'liang'de'zhu'fu	0
力量祝福	li'liang'zhu'fu	0
利爪德鲁伊	li'zhua'de'lu'yi	0
连环爆裂	lian'huan'bao'lie	0
连击	lian'ji	0
联结治疗	lian'jie'zhi'liao	0
炼金师	lian'jin'shi	0
脸无面	lian'wu'mian	0
猎豹	lie'bao	0
猎豹形态	lie'bao'xing'tai	0
裂地触须	lie'di'chu'xu	0
裂颅之击	lie'lu'zhi'ji	0
猎犬	lie'quan	0
猎人	lie'ren	0
猎人印记	lie'ren'yin'ji	0
猎人优胜	lie'ren'you'sheng	0
烈日行者	lie'ri'xing'zhe	0
列王守卫	lie'wang'shou'wei	0
烈焰长枪	lie'yan'chang'qiang	0
烈焰德鲁伊	lie'yan'de'lu'yi	0
烈焰风暴	lie'yan'feng'bao	0
烈焰轰击	lie'yan'hong'ji	0
烈焰巨兽	lie'yan'ju'shou	0
烈焰喷涌	lie'yan'pen'yong	0
烈焰小鬼	lie'yan'xiao'gui	0
烈焰元素	lie'yan'yuan'su	0
烈焰之心	lie'yan'zhi'xin	0
烈焰之子	lie'yan'zhi'zi	0
林地树妖	lin'di'shu'yao	0
凛风巫师	lin'feng'wu'shi	0
林志玲	lin'zhi'ling	0
灵魂歌者安布拉	ling'hun'ge'zhe'an'bu'la	0
灵魂虹吸	ling'hun'hong'xi	0
灵魂回响	ling'hun'hui'xiang	0
灵魂之火	ling'hun'zhi'huo	0
零件	ling'jian	0
零食商贩	ling'shi'shang'fan	0
榴弹投手	liu'dan'tou'shou	0
龙蛋	long'dan	0
龙卵	long'luan	0
龙眠教官	long'mian'jiao'guan	0
龙人	long'ren	0
龙人打击者	long'ren'da'ji'zhe	0
龙人巫师	long'ren'wu'shi	0
龙人侦测者	long'ren'zhen'ce'zhe	0
龙王配偶	long'wang'pei'ou	0
龙系列卡组	long'xi'lie'ka'zu	0
龙息术	long'xi'shu	0
龙息药水	long'xi'yao'shui	0
龙血之痛	long'xue'zhi'tong	0
龙血之痛黑	long'xue'zhi'tong'hei	0
龙血之痛红	long'xue'zhi'tong'hong	0
龙血之痛蓝	long'xue'zhi'tong'lan	0
龙血之痛绿	long'xue'zhi'tong'lv	0
龙血之痛青铜	long'xue'zhi'tong'qing'tong	0
龙牙	long'ya	0
龙鹰雏兽	long'ying'chu'shou	0
龙鹰骑士	long'ying'qi'shi	0
鲁莽的火箭技师	lu'mang'de'huo'jian'ji'shi	0
鲁莽火箭兵	lu'mang'huo'jian'bing	0
炉石第一卡	lu'shi'di'yi'ka	0
乱斗	luan'dou	0
乱石滚动	luan'shi'gun'dong	0
掠夺者首领	lve'duo'zhe'shou'ling	0
轮到我上场了	lun'dao'wo'shang'chang'le	0
轮回	lun'hui	0
罗宁	luo'ning	0
洛欧塞布	luo'ou'sai'bu	0
绿龙	lv'long	0
绿皮	lv'pi	0
绿皮船长	lv'pi'chuan'zhang	0
绿皮队长	lv'pi'dui'zhang	0
驴爷	lv'ye	0
绿洲钳嘴龟	lv'zhou'qian'zui'gui	0
玛尔加尼斯	ma'er'jia'ni'si	0
马尔考罗克	ma'er'kao'luo'ke	0
玛法里奥怒风	ma'fa'li'ao'nu'feng	0
麻疯侏儒	ma'feng'zhu'ru	0
麻风侏儒	ma'feng'zhu'ru	0
玛克扎尔的小鬼	ma'ke'zha'er'de'xiao'gui	0
马克扎尔王子	ma'ke'zha'er'wang'zi	0
玛里苟斯	ma'li'gou'si	0
玛里斯	ma'li'si	0
玛洛恩	ma'luo'en	0
马洛拉克	ma'luo'la'ke	0
玛瑙主教	ma'nao'zhu'jiao	0
麦迪文	mai'di'wen	0
麦迪文的残影	mai'di'wen'de'can'ying	0
麦迪文的男仆	mai'di'wen'de'nan'pu	0
麦格尼铜须	mai'ge'ni'tong'xu	0
迈克斯纳	mai'ke'si'na	0
麦田傀儡	mai'tian'kui'lei	0
麦田麦傀	mai'tian'mai'kui	0
埋葬	mai'zang	0
满山的食尸鬼	man'shan'de'shi'shi'gui	0
蛮鱼斥候	man'yu'chi'hou	0
蛮鱼图腾	man'yu'tu'teng	0
蛮鱼勇士	man'yu'yong'shi	0
猫头鹰	mao'tou'ying	0
贸易亲王	mao'yi'qin'wang	0
没魔	mei'mo	0
魅魔	mei'mo	0
煤烟喷吐装置	mei'yan'pen'tu'zhuang'zhi	0
魅影歹徒	mei'ying'dai'tu	0
闷棍	men'gun	0
猛击	meng'ji	0
梦境	meng'jing	0
猛烈凝视	meng'lie'ning'shi	0
猛犸人头领	meng'ma'ren'tou'ling	0
梦魇之龙	meng'yan'zhi'long	0
猛砸	meng'za	0
米尔豪斯法力风暴	mi'er'hao'si'fa'li'feng'bao	0
秘法宝典	mi'fa'bao'dian	0
秘法学家	mi'fa'xue'jia	0
密教暗影祭祀	mi'jiao'an'ying'ji'si	0
秘教暗影祭司	mi'jiao'an'ying'ji'si	0
迷乱	mi'luan	0
米米尔隆的头部	mi'mi'er'long'de'tou'bu	0
秘能守护者	mi'neng'shou'hu'zhe	0
米莎	mi'sha	0
迷失丛林	mi'shi'cong'lin	0
迷失的陆行鸟	mi'shi'de'lu'xing'niao	0
绵羊	mian'yang	0
免疫	mian'yi	0
妙手空空	miao'shou'kong'kong	0
灭神	mie'shen	0
明光祭司	ming'guang'ji'si	0
命令怒吼	ming'ling'nu'hou	0
茉艾拉铜须公主	mo'ai'la'tong'xu'gong'zhu	0
膜拜者	mo'bai'zhe	0
魔暴龙	mo'bao'long	0
魔爆龙蛋	mo'bao'long'dan	0
魔爆术	mo'bao'shu	0
魔法的美味	mo'fa'de'mei'wei	0
魔法乌鸦	mo'fa'wu'ya	0
魔古山守望者	mo'gu'shan'shou'wang'zhe	0
蘑菇头	mo'gu'tou	0
莫罗斯	mo'luo'si	0
魔能机甲	mo'neng'ji'jia	0
末日践行者	mo'ri'jian'xing'zhe	0
末日降临	mo'ri'jiang'lin	0
末日镜像	mo'ri'jing'xiang	0
末日守卫	mo'ri'shou'wei	0
末日预言者	mo'ri'yu'yan'zhe	0
末日灾祸	mo'ri'zai'huo	0
墨水大师索莉亚	mo'shui'da'shi'suo'li'ya	0
墨水大师索莉娅	mo'shui'da'shi'suo'li'ya	0
摩天龙	mo'tian'long	0
摸腿骑	mo'tui'qi	0
魔瘾结晶者	mo'yin'jie'jing'zhe	0
魔瘾者	mo'yin'zhe	0
穆戈尔的勇士	mu'ge'er'de'yong'shi	0
暮光雏龙	mu'guang'chu'long	0
暮光地卜师	mu'guang'di'bu'shi	0
暮光烈焰召唤者	mu'guang'lie'yan'zhao'huan'zhe	0
暮光守护者	mu'guang'shou'hu'zhe	0
暮光幼龙	mu'guang'you'long	0
暮光召唤师	mu'guang'zhao'huan'shi	0
暮光之锤	mu'guang'zhi'chui	0
暮光治愈者	mu'guang'zhi'yu'zhe	0
暮光尊者	mu'guang'zun'zhe	0
穆克拉	mu'ke'la	0
穆克拉的勇士	mu'ke'la'de'yong'shi	0
木乃伊僵尸	mu'nai'yi'jiang'shi	0
暮色野猪	mu'se'ye'zhu	0
牧师	mu'shi	0
牧师优胜	mu'shi'you'sheng	0
牧师支配者	mu'shi'zhi'pei'zhe	0
木桶	mu'tong	0
墓穴蜘蛛	mu'xue'zhi'zhu	0
娜迦海盗	na'jia'hai'dao	0
纳迦海巫	na'jia'hai'wu	0
纳迦侍从	na'jia'shi'cong	0
纳克萨玛斯的诅咒	na'ke'sa'ma'si'de'zu'zhou	0
纳克萨玛斯之影	na'ke'sa'ma'si'zhi'ying	0
纳鲁之光	na'lu'zhi'guang	0
娜莎塔	na'sha'ta	0
纳特帕格	na'te'pa'ge	0
奶德	nai'de	0
奈法	nai'fa	0
奈法利安	nai'fa'li'an	0
耐普图隆	nai'pu'tu'long	0
奶骑	nai'qi	0
奶萨	nai'sa	0
耐心的刺客	nai'xin'de'ci'ke	0
耐心的逗比	nai'xin'de'dou'bi	0
南海船工	nan'hai'chuan'gong	0
南海船长	nan'hai'chuan'zhang	0
南海海盗队长	nan'hai'hai'dao'dui'zhang	0
南海畸变船长	nan'hai'ji'bian'chuan'zhang	0
南海水手	nan'hai'shui'shou	0
闹闹机器人	nao'nao'ji'qi'ren	0
内测补丁	nei'ce'bu'ding	0
能量之光	neng'liang'zhi'guang	0
泥浆怪	ni'jiang'guai	0
尼鲁巴蛛网领主	ni'lu'ba'zhu'wang'ling'zhu	0
拟态豆荚	ni'tai'dou'jia	0
年迈的长颈龙	nian'mai'de'chang'jing'long	0
年迈的法师	nian'mai'de'fa'shi	0
年迈的酒仙	nian'mai'de'jiu'xian	0
年轻的酒仙	nian'qing'de'jiu'xian	0
年轻的酿酒学徒	nian'qing'de'niang'jiu'xue'tu	0
年轻的女祭司	nian'qing'de'nv'ji'si	0
碾碎	nian'sui	0
鸟禽守护者	niao'qin'shou'hu'zhe	0
扭曲的狼人	niu'qu'de'lang'ren	0
扭曲虚空	niu'qu'xu'kong	0
牛头人战士	niu'tou'ren'zhan'shi	0
脓疮猎潮者	nong'chuang'lie'chao'zhe	0
怒火中烧	nu'huo'zhong'shao	0
奴隶战	nu'li'zhan	0
奴隶主	nu'li'zhu	0
怒袭	nu'xi	0
诺格弗格市长	nuo'ge'fu'ge'shi'zhang	0
诺莫瑞根步兵	nuo'mo'rui'gen'bu'bing	0
诺森德目标碧蓝幼龙	nuo'sen'de'mu'biao'bi'lan'you'long	0
诺兹多姆	nuo'zi'duo'mu	0
诺滋多姆	nuo'zi'duo'mu	0
女公爵布劳缪克丝	nv'gong'jue'bu'lao'miu'ke'si	0
女警萨莉	nv'jing'sa'li	0
女魔头	nv'mo'tou	0
女王	nv'wang	0
欧莫克大王	ou'mo'ke'da'wang	0
欧泽鲁克	ou'ze'lu'ke	0
帕奇斯	pa'qi'si	0
帕奇维克	pa'qi'wei'ke	0
派烙斯	pai'lao'si	0
蹒跚的食尸鬼	pan'shan'de'shi'shi'gui	0
咆哮	pao'xiao	0
碰瓷	peng'ci	0
砰砰	peng'peng	0
砰砰博士	peng'peng'bo'shi	0
砰砰机器人	peng'peng'ji'qi'ren	0
噼啪	pi'pa	0
漂浮观察者	piao'fu'guan'cha'zhe	0
剽窃	piao'qie	0
破法	po'fa	0
破法者	po'fa'zhe	0
破海者	po'hai'zhe	0
破坏者	po'huai'zhe	0
破碎残阳祭司	po'sui'can'yang'ji'si	0
破碎残阳祭祀	po'sui'can'yang'ji'si	0
普通	pu'tong	0
弃暗投明	qi'an'tou'ming	0
骑乘迅猛龙	qi'cheng'xun'meng'long	0
起飞	qi'fei	0
奇迹贼	qi'ji'zei	0
奇袭	qi'xi	0
潜行	qian'xing	0
潜行小鬼	qian'xing'xiao'gui	0
潜行者的伎俩	qian'xing'zhe'de'ji'liang	0
潜行者优胜	qian'xing'zhe'you'sheng	0
潜行者支配者	qian'xing'zhe'zhi'pei'zhe	0
谦逊	qian'xun	0
潜于地下	qian'yu'di'xia	0
枪毙	qiang'bi	0
强大的中立随从	qiang'da'de'zhong'li'sui'cong	0
强风射击	qiang'feng'she'ji	0
强化匕首精通	qiang'hua'bi'shou'jing'tong	0
强化变形	qiang'hua'bian'xing	0
强化次级治疗术	qiang'hua'ci'ji'zhi'liao'shu	0
强化火焰冲击	qiang'hua'huo'yan'chong'ji	0
强化机器人	qiang'hua'ji'qi'ren	0
强化全副武装	qiang'hua'quan'fu'wu'zhuang	0
强化生命分流	qiang'hua'sheng'ming'fen'liu	0
强化图腾召唤	qiang'hua'tu'teng'zhao'huan	0
强化稳固射击	qiang'hua'wen'gu'she'ji	0
强化援军	qiang'hua'yuan'jun	0
强能奥术飞弹	qiang'neng'ao'shu'fei'dan	0
强势围观	qiang'shi'wei'guan	0
强袭坦克	qiang'xi'tan'ke	0
强效治疗术	qiang'xiao'zhi'liao'shu	0
强效治疗药水	qiang'xiao'zhi'liao'yao'shui	0
切克闹小水元素	qie'ke'nao'xiao'shui'yuan'su	0
窃贼	qie'zei	0
庆典司仪	qing'dian'si'yi	0
青海萨控制卡组	qing'hai'sa'kong'zhi'ka'zu	0
青蛙	qing'wa	0
青玉	qing'yu	0
青玉飞镖	qing'yu'fei'biao	0
青玉护符	qing'yu'hu'fu	0
青玉巨兽	qing'yu'ju'shou	0
青玉酋长	qing'yu'qiu'zhang	0
青玉闪电	qing'yu'shan'dian	0
青玉游荡者	qing'yu'you'dang'zhe	0
青玉绽放	qing'yu'zhan'fang	0
青玉之灵	qing'yu'zhi'ling	0
青玉之爪	qing'yu'zhi'zhao	0
秋日	qiu'ri	0
囚嫂	qiu'sao	0
全副武装	quan'fu'wu'zhuang	0
全能金刚防御系统	quan'neng'jin'gang'fang'yu'xi'tong	0
全需党	quan'xu'dang	0
群蕉	qun'jiao	0
群居雏龙	qun'ju'chu'long	0
群驱	qun'qu	0
群体背刺	qun'ti'bei'ci	0
群体驱散	qun'ti'qu'san	0
燃烧刺激	ran'shao'ci'ji	0
燃鬃自走炮	ran'zong'zi'zou'pao	0
绕咒师	rao'zhou'shi	0
扰咒术	rao'zhou'shu	0
扰咒语	rao'zhou'yu	0
热情的探险家	re'qing'de'tan'xian'jia	0
热砂港狙击手	re'sha'gang'ju'ji'shou	0
热心的酒保	re'xin'de'jiu'bao	0
人气选手	ren'qi'xuan'shou	0
任务达人	ren'wu'da'ren	0
刃牙德鲁伊	ren'ya'de'lu'yi	0
日怒保卫者	ri'nu'bao'wei'zhe	0
日行者	ri'xing'zhe	0
熔核巨人	rong'he'ju'ren	0
熔喉	rong'hou	0
熔火恶犬	rong'huo'e'quan	0
熔火怒犬	rong'huo'nu'quan	0
熔岩	rong'yan	0
熔岩爆裂	rong'yan'bao'lie	0
熔岩金刚	rong'yan'jin'gang	0
熔岩镜像	rong'yan'jing'xiang	0
熔岩脉动	rong'yan'mai'dong	0
熔岩震击	rong'yan'zhen'ji	0
熔岩之刃	rong'yan'zhi'ren	0
肉酱血瓶	rou'jiang'xue'ping	0
肉用僵尸	rou'yong'jiang'shi	0
软泥怪	ruan'ni'guai	0
瑞文戴尔男爵	rui'wen'dai'er'nan'jue	0
瑞文上单	rui'wen'shang'dan	0
弱肉强食	ruo'rou'qiang'shi	0
萨尔	sa'er	0
萨尔玛先知	sa'er'ma'xian'zhi	0
萨菲隆	sa'fei'long	0
萨弗拉斯	sa'fu'la'si	0
萨兰德	sa'lan'de	0
萨满	sa'man	0
萨满优胜	sa'man'you'sheng	0
萨满支配者	sa'man'zhi'pei'zhe	0
萨瓦丝女王	sa'wa'si'nv'wang	0
赛场观众	sai'chang'guan'zhong	0
赛场医生	sai'chang'yi'sheng	0
塞纳留斯	sai'na'liu'si	0
三个代表	san'ge'dai'biao	0
三教九流	san'jiao'jiu'liu	0
三头蛇	san'tou'she	0
三王	san'wang	0
扫尾	sao'wei	0
瑟拉金之种	se'la'jin'zhi'zhong	0
瑟里耶克爵士	se'li'ye'ke'jue'shi	0
瑟玛普拉格	se'ma'pu'la'ge	0
森哥	sen'ge	0
森金持盾卫士	sen'jin'chi'dun'wei'shi	0
森金盾持盾卫士	sen'jin'dun'chi'dun'wei'shi	0
森金盾牌大师	sen'jin'dun'pai'da'shi	0
森林狼	sen'lin'lang	0
砂槌萨满祭司	sha'chui'sa'man'ji'si	0
沙鳞灵魂行者	sha'lin'ling'hun'xing'zhe	0
杀戮	sha'lu	0
杀戮命令	sha'lu'ming'ling	0
鲨鱼加佐	sha'yu'jia'zuo	0
傻子	sha'zi	0
傻子王	sha'zi'wang	0
闪电风暴	shan'dian'feng'bao	0
闪电箭	shan'dian'jian	0
山谷之王穆克拉	shan'gu'zhi'wang'mu'ke'la	0
闪金镇步兵	shan'jin'zhen'bu'bing	0
山岭巨人	shan'ling'ju'ren	0
上古看护者	shang'gu'kan'hu'zhe	0
上古看守	shang'gu'kan'shou	0
上古看守者	shang'gu'kan'shou'zhe	0
上古之神护卫	shang'gu'zhi'shen'hu'wei	0
上古之神先驱	shang'gu'zhi'shen'xian'qu	0
上膛	shang'tang	0
烧烤师傅	shao'kao'shi'fu	0
蛇德	she'de	0
射脸射一箭	she'lian'she'yi'jian	0
神恩	shen'en	0
神恩术	shen'en'shu	0
神秘女猎手	shen'mi'nv'lie'shou	0
神秘挑战者	shen'mi'tiao'zhan'zhe	0
审判	shen'pan	0
神奇四鱼	shen'qi'si'yu	0
神圣惩罚	shen'sheng'cheng'fa	0
神圣惩击	shen'sheng'cheng'ji	0
神圣愤怒	shen'sheng'fen'nu	0
神圣新星	shen'sheng'xin'xing	0
神圣勇士	shen'sheng'yong'shi	0
神圣之火	shen'sheng'zhi'huo	0
神圣之力	shen'sheng'zhi'li	0
神圣之灵	shen'sheng'zhi'ling	0
身陷绝境的哨卫	shen'xian'jue'jing'de'shao'wei	0
神勇弓箭手	shen'yong'gong'jian'shou	0
深渊巨蟒	shen'yuan'ju'mang	0
深渊领主	shen'yuan'ling'zhu	0
深渊探险	shen'yuan'tan'xian	0
深渊之物	shen'yuan'zhi'wu	0
圣殿执行者	sheng'dian'zhi'xing'zhe	0
圣盾	sheng'dun	0
生而平等	sheng'er'ping'deng	0
圣光的正义	sheng'guang'de'zheng'yi	0
圣光护卫者	sheng'guang'hu'wei'zhe	0
圣光守护者	sheng'guang'shou'hu'zhe	0
圣光术	sheng'guang'shu	0
圣光勇士	sheng'guang'yong'shi	0
圣光炸弹	sheng'guang'zha'dan	0
升级	sheng'ji	0
圣甲虫	sheng'jia'chong	0
圣疗	sheng'liao	0
圣疗术	sheng'liao'shu	0
生命分流	sheng'ming'fen'liu	0
生命之树	sheng'ming'zhi'shu	0
生平平等	sheng'ping'ping'deng	0
盛气凌人	sheng'qi'ling'ren	0
圣骑士	sheng'qi'shi	0
圣骑士优胜	sheng'qi'shi'you'sheng	0
圣骑士支配者	sheng'qi'shi'zhi'pei'zhe	0
升腾者海纳泽尔	sheng'teng'zhe'hai'na'ze'er	0
生锈的号角	sheng'xiu'de'hao'jiao	0
生长孢子	sheng'zhang'bao'zi	0
侍从	shi'cong	0
湿地女王	shi'di'nv'wang	0
石腭穴居人	shi'e'xue'ju'ren	0
嗜法者	shi'fa'zhe	0
施法者克星	shi'fa'zhe'ke'xing	0
释放畸变怪	shi'fang'ji'bian'guai	0
食腐鬣狗	shi'fu'lie'gou	0
食腐土狼	shi'fu'tu'lang	0
石化	shi'hua	0
石化魔暴龙	shi'hua'mo'bao'long	0
石化武器	shi'hua'wu'qi	0
石化迅猛龙	shi'hua'xun'meng'long	0
时间回溯装置	shi'jian'hui'su'zhuang'zhi	0
时间龙慌得要死龙北京龙	shi'jian'long'huang'de'yao'si'long'bei'jing'long	0
视界术	shi'jie'shu	0
时空扭曲	shi'kong'niu'qu	0
尸魔花瑟拉金	shi'mo'hua'se'la'jin	0
石南草毒素	shi'nan'cao'du'su	0
失窃物资	shi'qie'wu'zi	0
石丘防御者	shi'qiu'fang'yu'zhe	0
石拳食人魔	shi'quan'shi'ren'mo	0
石泉食人魔	shi'quan'shi'ren'mo	0
食人草	shi'ren'cao	0
食人魔	shi'ren'mo	0
食人魔步兵	shi'ren'mo'bu'bing	0
食人魔法师	shi'ren'mo'fa'shi	0
食人魔忍者	shi'ren'mo'ren'zhe	0
食人魔勇士穆戈尔	shi'ren'mo'yong'shi'mu'ge'er	0
食人魔战锤	shi'ren'mo'zhan'chui	0
食人鱼喷枪	shi'ren'yu'pen'qiang	0
食肉食尸鬼	shi'rou'shi'shi'gui	0
始生幼龙	shi'sheng'you'long	0
史诗	shi'shi	0
石塘猎人	shi'tang'lie'ren	0
嗜血	shi'xue	0
嗜血术	shi'xue'shu	0
石牙野猪	shi'ya'ye'zhu	0
适者生存	shi'zhe'sheng'cun	0
石爪图腾	shi'zhua'tu'teng	0
狮子	shi'zi	0
十字军统领	shi'zi'jun'tong'ling	0
始祖龟劫掠者	shi'zu'gui'jie'lve'zhe	0
始祖龟预言者	shi'zu'gui'yu'yan'zhe	0
始祖龟执盾者	shi'zu'gui'zhi'dun'zhe	0
收割	shou'ge	0
收割者戈提克	shou'ge'zhe'ge'ti'ke	0
收集者沙库尔	shou'ji'zhe'sha'ku'er	0
兽栏大师	shou'lan'da'shi	0
手牌龙暮光蚊子	shou'pai'long'mu'guang'wen'zi	0
手牌术	shou'pai'shu	0
兽群呼唤	shou'qun'hu'huan	0
兽群领袖	shou'qun'ling'xiu	0
兽人铸甲师	shou'ren'zhu'jia'shi	0
守日者塔林姆	shou'ri'zhe'ta'lin'mu	0
受伤的克瓦迪尔	shou'shang'de'ke'wa'di'er	0
守卫者	shou'wei'zhe	0
受祝福的勇士	shou'zhu'fu'de'yong'shi	0
书卷之龙	shu'juan'zhi'long	0
熟练的水手	shu'lian'de'shui'shou	0
树苗	shu'miao	0
树人	shu'ren	0
术士	shu'shi	0
术士优胜	shu'shi'you'sheng	0
术士支配者	shu'shi'zhi'pei'zhe	0
双持战刃	shuang'chi'zhan'ren	0
霜狼	shuang'lang	0
霜狼步兵	shuang'lang'bu'bing	0
霜狼督军	shuang'lang'du'jun	0
霜狼战争领主	shuang'lang'zhan'zheng'ling'zhu	0
双马尾贝拉武器匠	shuang'ma'wei'bei'la'wu'qi'jiang	0
水爸爸	shui'ba'ba	0
水晶核心	shui'jing'he'xin	0
水晶赠礼	shui'jing'zeng'li	0
水文学家	shui'wen'xue'jia	0
水元素	shui'yuan'su	0
顺劈	shun'pi	0
顺劈斩	shun'pi'zhan	0
死吧卑鄙的家伙	si'ba'bei'bi'de'jia'huo	0
死缠	si'chan	0
四大天王之首波多里亚尔	si'da'tian'wang'zhi'shou'bo'duo'li'ya'er	0
四大天王之一	si'da'tian'wang'zhi'yi	0
伺机待发	si'ji'dai'fa	0
斯克拉姆狂热者	si'ke'la'mu'kuang're'zhe	0
死灵毒药	si'ling'du'yao	0
死灵光环	si'ling'guang'huan	0
死灵骑士	si'ling'qi'shi	0
斯尼德的伐木机	si'ni'de'de'fa'mu'ji	0
肆虐食尸鬼	si'nve'shi'shi'gui	0
四驱车	si'qu'che	0
死神型	si'shen'xing	0
斯塔拉格	si'ta'la'ge	0
死亡缠绕	si'wang'chan'rao	0
死亡领主	si'wang'ling'zhu	0
死亡学员	si'wang'xue'yuan	0
死亡战马	si'wang'zhan'ma	0
死亡之花	si'wang'zhi'hua	0
死亡之咬	si'wang'zhi'yao	0
死亡之翼	si'wang'zhi'yi	0
死亡之愿	si'wang'zhi'yuan	0
思维窃取	si'wei'qie'qu	0
撕咬	si'yao	0
死鱼骑	si'yu'qi	0
松鼠	song'shu	0
送葬者	song'zang'zhe	0
搜寻猎物	sou'xun'lie'wu	0
酸喉	suan'hou	0
酸性沼泽软泥怪	suan'xing'zhao'ze'ruan'ni'guai	0
随从	sui'cong	0
碎石穴居人	sui'shi'xue'ju'ren	0
碎雪机器人	sui'xue'ji'qi'ren	0
损坏的傀儡	sun'huai'de'kui'lei	0
索菲亚头目	suo'fei'ya'tou'mu	0
锁链	suo'lian	0
索瑞森大帝	suo'rui'sen'da'di	0
缩小	suo'xiao	0
缩小射线工程师	suo'xiao'she'xian'gong'cheng'shi	0
缩小药水	suo'xiao'yao'shui	0
塔迪乌斯	ta'di'wu'si	0
塔斯丁狗	ta'si'ding'gou	0
塔斯克	ta'si'ke	0
泰拉图斯	tai'la'tu'si	0
泰森拳皇	tai'sen'quan'huang	0
太阳裂片莱拉	tai'yang'lie'pian'lai'la	0
苔原犀牛	tai'yuan'xi'niu	0
坦克模式	tan'ke'mo'shi	0
弹射之刃	tan'she'zhi'ren	0
贪食软泥怪	tan'shi'ruan'ni'guai	0
探索安戈洛	tan'suo'an'ge'luo	0
探索地下洞穴	tan'suo'di'xia'dong'xue	0
探险帽	tan'xian'mao	0
唐汉古	tang'han'gu	0
剃刀猎手	ti'dao'lie'shou	0
剃刀沼泽猎手	ti'dao'zhao'ze'lie'shou	0
提盾	ti'dun	0
剔骨	ti'gu	0
提里奥弗丁	ti'li'ao'fu'ding	0
天降蛛群	tian'jiang'zhu'qun	0
天空上尉库拉格	tian'kong'shang'wei'ku'la'ge	0
天启	tian'qi	0
天启骑士的印记	tian'qi'qi'shi'de'yin'ji	0
天神唤梦者	tian'shen'huan'meng'zhe	0
天神换蒙着	tian'shen'huan'meng'zhe	0
跳费德	tiao'fei'de	0
贴吧陷阱熊大陷阱	tie'ba'xian'jing'xiong'da'xian'jing	0
贴吧熊熊大	tie'ba'xiong'xiong'da	0
铁钩	tie'gou	0
铁喙猫头鹰	tie'hui'mao'tou'ying	0
铁炉堡传送门	tie'lu'bao'chuan'song'men	0
铁炉堡火枪手	tie'lu'bao'huo'qiang'shou	0
铁炉堡领袖	tie'lu'bao'ling'xiu	0
贴膜	tie'mo	0
贴片	tie'pian	0
铁下巴掀桌大表哥	tie'xia'ba'xian'zhuo'da'biao'ge	0
鉄啄猫头鹰	tie'zhuo'mao'tou'ying	0
铁鬃灰熊	tie'zong'hui'xiong	0
同福乱斗	tong'fu'luan'dou	0
痛苦女王	tong'ku'nv'wang	0
痛苦诗僧	tong'ku'shi'seng	0
铜皮铁甲	tong'pi'tie'jia	0
投火无面者	tou'huo'wu'mian'zhe	0
偷牌库	tou'pai'ku	0
偷手牌	tou'shou'pai	0
投资蹲坑	tou'zi'dun'keng	0
土地精海盗	tu'di'jing'hai'dao	0
土爹	tu'die	0
土豪战	tu'hao'zhan	0
秃鹫	tu'jiu	0
土狼	tu'lang	0
图腾魔像	tu'teng'mo'xiang	0
图腾召唤	tu'teng'zhao'huan	0
图腾之力	tu'teng'zhi'li	0
兔妖教头	tu'yao'jiao'tou	0
土元素	tu'yuan'su	0
团队领袖	tuan'dui'ling'xiu	0
团长	tuan'zhang	0
退化	tui'hua	0
鸵鸟板娘	tuo'niao'ban'niang	0
托妞	tuo'niu	0
托什雷	tuo'shen'lei	0
托维尔守望者	tuo'wei'er'shou'wang'zhe	0
托维尔塑石师	tuo'wei'er'su'shi'shi	0
驮运科多兽	tuo'yun'ke'duo'shou	0
挖宝卡组	wa'bao'ka'zu	0
瓦里安乌瑞恩	wa'li'an'wu'rui'en	0
瓦莉拉萨古纳尔	wa'li'la'sa'gu'na'er	0
瓦王	wa'wang	0
顽石元素	wan'shi'yuan'su	0
王昊	wang'hao	0
亡灵药剂师	wang'ling'yao'ji'shi	0
王牌猎人	wang'pai'lie'ren	0
王师傅	wang'shi'fu	0
亡语	wang'yu	0
亡者复生	wang'zhe'fu'sheng	0
亡者归来	wang'zhe'gui'lai	0
王者祝福	wang'zhe'zhu'fu	0
威尔弗雷德菲兹班	wei'er'fu'lei'de'fei'zi'ban	0
维克多奈法里奥斯	wei'ke'duo'nai'fa'li'ao'si	0
维克洛尔大帝	wei'ke'luo'er'da'di	0
维克尼拉斯大帝	wei'ke'ni'la'si'da'di	0
维纶	wei'lun	0
维纶的恩泽	wei'lun'de'en'ze	0
微软	wei'ruan	0
喂食时间	wei'shi'shi'jian	0
微型战斗机甲	wei'xing'zhan'dou'ji'jia	0
伪造的幸运币	wei'zao'de'xing'yun'bi	0
伪装大师	wei'zhuang'da'shi	0
稳定的传送门开门橙卡传送门	wen'ding'de'chuan'song'men'kai'men'cheng'ka'chuan'song'men	0
稳固射击	wen'gu'she'ji	0
温良的人必将承受	wen'liang'de'ren'bi'jiang'cheng'shou	0
温泉守卫	wen'quan'shou'wei	0
温柔的大恐龙	wen'rou'de'da'kong'long	0
瘟疫	wen'yi	0
瘟疫使者诺斯	wen'yi'shi'zhe'nuo'si	0
瘟疫鼠群	wen'yi'shu'qun	0
沃金	wo'jin	0
沃拉斯	wo'la'si	0
我是鱼人	wo'shi'yu'ren	0
无产阶级辅导员正义	wu'chan'jie'ji'fu'dao'yuan'zheng'yi	0
鋈大酋长换血	wu'da'qiu'zhang'huan'xie	0
误导	wu'dao	0
舞动之剑	wu'dong'zhi'jian	0
舞动之刃	wu'dong'zhi'ren	0
无羁元素	wu'ji'yuan'su	0
雾羁元素	wu'ji'yuan'su	0
无价的小鬼	wu'jia'de'xiao'gui	0
吴克大光头	wu'ke'da'guang'tou	0
悟空	wu'kong	0
污鳞劫掠者	wu'lin'jie'lve'zhe	0
无面操纵着	wu'mian'cao'zong'zhe	0
无面操纵者	wu'mian'cao'zong'zhe	0
无面巨兽	wu'mian'ju'shou	0
无面蹒跚者	wu'mian'pan'shan'zhe	0
无面破坏者	wu'mian'po'huai'zhe	0
无面召唤师	wu'mian'zhao'huan'shi	0
乌瑟尔光明使者	wu'se'er'guang'ming'shi'zhe	0
巫师学徒	wu'shi'xue'tu	0
污手	wu'shou	0
污手党	wu'shou'dang	0
污手街	wu'shou'jie	0
污手街惩罚者	wu'shou'jie'cheng'fa'zhe	0
污手街典当师	wu'shou'jie'dian'dang'shi	0
污手街供货商	wu'shou'jie'gong'huo'shang	0
污手街情报员	wu'shou'jie'qing'bao'yuan	0
污手街守护者	wu'shou'jie'shou'hu'zhe	0
污手街走私者	wu'shou'jie'zou'si'zhe	0
污手玩具商	wu'shou'wan'ju'shang	0
无私的英雄	wu'si'de'ying'xiong	0
乌鸦神像	wu'ya'shen'xiang	0
午夜噩龙	wu'ye'e'long	0
巫医	wu'yi	0
无证药剂师	wu'zheng'yao'ji'shi	0
无知维纶	wu'zhi'wei'lun	0
希尔瓦娜斯风行者	xi'er'wa'na'si'feng'xing'zhe	0
西风灯神	xi'feng'deng'shen	0
洗脚大师	xi'jiao'da'shi	0
犀牛	xi'niu	0
吸取生命	xi'qu'sheng'ming	0
牺牲契约	xi'sheng'qi'yue	0
系统发放	xi'tong'fa'fang	0
希望守护者阿玛拉	xi'wang'shou'hu'zhe'a'ma'la	0
稀有	xi'you	0
先到先得	xian'dao'xian'de	0
献血小鬼	xian'xue'xiao'gui	0
鲜血小鬼	xian'xue'xiao'gui	0
咸鱼王	xian'yu'wang	0
先知维纶	xian'zhi'wei'lun	0
先祖召唤	xian'zu'zhao'huan	0
先祖之魂	xian'zu'zhi'hun	0
先祖治疗	xian'zu'zhi'liao	0
先祖知识	xian'zu'zhi'shi	0
香蕉	xiang'jiao	0
象牙骑士	xiang'ya'qi'shi	0
小伐木机	xiao'fa'mu'ji	0
小范	xiao'fan	0
小斧子	xiao'fu'zi	0
小个子法师	xiao'ge'zi'fa'shi	0
小个子驱魔者	xiao'ge'zi'qu'mo'zhe	0
小个子扰咒师	xiao'ge'zi'rao'zhou'shi	0
小个子召唤师	xiao'ge'zi'zhao'huan'shi	0
小鬼	xiao'gui	0
小鬼爆破	xiao'gui'bao'po	0
小鬼大师	xiao'gui'da'shi	0
小鬼骑士	xiao'gui'qi'shi	0
小鬼首领	xiao'gui'shou'ling	0
小鬼召唤师	xiao'gui'zhao'huan'shi	0
小鬼召唤师小鬼爆破	xiao'gui'zhao'huan'shi'xiao'gui'bao'po	0
小鸡	xiao'ji	0
小剑圣	xiao'jian'sheng	0
小精灵	xiao'jing'ling	0
小蓝龙	xiao'lan'long	0
小鹿	xiao'lu	0
小螺丝	xiao'luo'si	0
小马	xiao'ma	0
小强	xiao'qiang	0
小软	xiao'ruan	0
消失	xiao'shi	0
小王二王	xiao'wang'er'wang	0
小小召唤师	xiao'xiao'zhao'huan'shi	0
小熊猫	xiao'xiong'mao	0
小迅猛龙	xiao'xun'meng'long	0
小蜘蛛	xiao'zhi'zhu	0
邪恶的巫医	xie'e'de'wu'yi	0
邪恶之刃	xie'e'zhi'ren	0
邪恶之影	xie'e'zhi'ying	0
邪火药水	xie'huo'yao'shui	0
邪脊吞噬者	xie'ji'tun'shi'zhe	0
邪教女巫	xie'jiao'nv'wu	0
邪教药剂师	xie'jiao'yao'ji'shi	0
邪灵拷问者	xie'ling'kao'wen'zhe	0
邪灵召唤师	xie'ling'zhao'huan'shi	0
邪能火炮	xie'neng'huo'pao	0
邪鳍审判者	xie'qi'shen'pan'zhe	0
邪兽人噬魂魔	xie'shou'ren'shi'hun'mo	0
心灵爆破	xin'ling'bao'po	0
心灵尖刺	xin'ling'jian'ci	0
心灵控制技师	xin'ling'kong'zhi'ji'shi	0
心灵视界	xin'ling'shi'jie	0
心灵碎裂	xin'ling'sui'lie	0
心灵震爆	xin'ling'zhen'bao	0
心灵之火	xin'ling'zhi'huo	0
心能魔像	xin'neng'mo'xiang	0
新月世界	xin'yue'shi'jie	0
新月视界	xin'yue'shi'jie	0
心智末日	xin'zhi'mo'ri	0
星辰坠落	xing'chen'zhui'luo	0
猩红法力浮龙	xing'hong'fa'li'fu'long	0
星火术	xing'huo'shu	0
型机械金刚	xing'ji'xie'jin'gang	0
星界沟通	xing'jie'gou'tong	0
形体改造仪	xing'ti'gai'zao'yi	0
幸运币	xing'yun'bi	0
幸运币的化身	xing'yun'bi'de'hua'shen	0
雄斑虎	xiong'ban'hu	0
凶暴猿猴	xiong'bao'yuan'hou	0
凶残撕咬	xiong'can'si'yao	0
熊德猫德	xiong'de'mao'de	0
凶恶的雏龙	xiong'e'de'chu'long	0
熊猫人斥候	xiong'mao'ren'chi'hou	0
雄狮形态	xiong'shi'xing'tai	0
熊形态	xiong'xing'tai	0
修补匠的磨刀油	xiu'bu'jiang'de'mo'dao'you	0
修理机器人	xiu'li'ji'qi'ren	0
锈蚀铁钩	xiu'shi'tie'gou	0
锈水海盗	xiu'shui'hai'dao	0
徐锦江政委	xu'jin'jiang'zheng'wei	0
虚空传送门	xu'kong'chuan'song'men	0
虚空恐魔	xu'kong'kong'mo	0
虚空碾压者	xu'kong'nian'ya'zhe	0
虚空行者	xu'kong'xing'zhe	0
虚空幽龙史学家	xu'kong'you'long'shi'xue'jia	0
虚灵奥术师	xu'ling'ao'shu'shi	0
虚灵大盗拉法姆	xu'ling'da'dao'la'fa'mu	0
虚灵商人	xu'ling'shang'ren	0
虚灵巫师	xu'ling'wu'shi	0
虚灵勇士萨兰德	xu'ling'yong'shi'sa'lan'de	0
旋风斩	xuan'feng'zhan	0
旋风之刃	xuan'feng'zhi'ren	0
雪地狗头人	xue'di'gou'tou'ren	0
血法	xue'fa	0
血法师萨尔诺斯	xue'fa'shi'sa'er'nuo'si	0
血帆海盗	xue'fan'hai'dao	0
血帆教徒	xue'fan'jiao'tu	0
血帆掠夺者	xue'fan'lve'duo'zhe	0
血帆袭击者	xue'fan'xi'ji'zhe	0
血吼	xue'hou	0
血蓟毒素	xue'ji'du'su	0
穴居人强盗	xue'ju'ren'qiang'dao	0
穴居人驯兽师	xue'ju'ren'xun'shou'shi	0
血怒药水	xue'nu'yao'shui	0
血骑士	xue'qi'shi	0
雪人	xue'ren	0
血色净化者	xue'se'jing'hua'zhe	0
血色十字军战士	xue'se'shi'zi'jun'zhan'shi	0
血色绽放	xue'se'zhan'fang	0
血蹄勇士	xue'ti'yong'shi	0
血性狂怒	xue'xing'kuang'nu	0
血沼迅猛龙	xue'zhao'xun'meng'long	0
寻路的探险者	xun'lu'de'tan'xian'zhe	0
迅猛龙	xun'meng'long	0
迅猛龙族王	xun'meng'long'zu'wang	0
训犬大师	xun'quan'da'shi	0
驯兽师	xun'shou'shi	0
亚煞极	ya'sha'ji	0
亚煞极印记	ya'sha'ji'yin'ji	0
炎爆术	yan'bao'shu	0
炎爆树	yan'bao'shu	0
岩肤石像鬼	yan'fu'shi'xiang'gui	0
宴会牧师	yan'hui'mu'shi	0
岩浆暴怒者	yan'jiang'bao'nu'zhe	0
岩浆狂怒者	yan'jiang'kuang'nu'zhe	0
眼镜蛇射击	yan'jing'she'she'ji	0
严酷的监工	yan'ku'de'jian'gong	0
严酷的监军	yan'ku'de'jian'jun	0
炎魔拉格纳罗斯	yan'mo'la'ge'na'luo'si	0
炎魔之王的力量	yan'mo'zhi'wang'de'li'liang	0
炎魔之王拉格纳罗斯	yan'mo'zhi'wang'la'ge'na'luo'si	0
岩石哨兵	yan'shi'shao'bing	0
岩元素	yan'yuan'su	0
严正警戒	yan'zheng'jing'jie	0
阳光牧	yang'guang'mu	0
摇摆的俾格米	yao'bai'de'bi'ge'mi	0
要塞指挥官	yao'sai'zhi'hui'guan	0
妖术	yao'shu	0
摇图腾	yao'tu'teng	0
野蛮	ye'man	0
野蛮咆哮	ye'man'pao'xiao	0
野蛮之击	ye'man'zhi'ji	0
夜幕奇袭	ye'mu'qi'xi	0
夜刃刺客	ye'ren'ci'ke	0
夜刃战士	ye'ren'zhan'shi	0
夜色镇炼金师	ye'se'zhen'lian'jin'shi	0
夜色镇图书管理员	ye'se'zhen'tu'shu'guan'li'yuan	0
夜色镇议员	ye'se'zhen'yi'yuan	0
夜色镇执法官	ye'se'zhen'zhi'fa'guan	0
野兽	ye'shou	0
野性成长	ye'xing'cheng'zhang	0
野性狼魂	ye'xing'lang'hun	0
野性炎术师	ye'xing'yan'shu'shi	0
野性印记	ye'xing'yin'ji	0
野性之力	ye'xing'zhi'li	0
野性之怒	ye'xing'zhi'nu	0
夜魇骑士	ye'yan'qi'shi	0
野猪	ye'zhu	0
野猪骑士蕾瑟兰	ye'zhu'qi'shi'lei'se'lan	0
野猪骑士斯派克	ye'zhu'qi'shi'si'pai'ke	0
野猪骑士塔纳利	ye'zhu'qi'shi'ta'na'li	0
易建联	yi'jian'lian	0
伊利丹怒风	yi'li'dan'nu'feng	0
伊莉斯逐星	yi'li'si'zhu'xing	0
伊瑟拉	yi'se'la	0
伊瑟拉苏醒	yi'se'la'su'xing	0
翼手龙宝宝	yi'shou'long'bao'bao	0
遗忘之王库恩	yi'wang'zhi'wang'ku'en	0
遗物搜寻者	yi'wu'sou'xun'zhe	0
移形之影	yi'xing'zhi'ying	0
以眼还眼	yi'yan'huan'yan	0
呓语魔典	yi'yu'mo'dian	0
异种群居蝎	yi'zhong'qun'ju'xie	0
银白指挥官	yin'bai'zhi'hui'guan	0
银背猩猩首领	yin'bei'xing'xing'shou'ling	0
银背族长	yin'bei'zu'zhang	0
音波吐息	yin'bo'tu'xi	0
隐藏	yin'cang	0
印度神油	yin'du'shen'you	0
隐秘立场	yin'mi'li'chang	0
银色保卫者	yin'se'bao'wei'zhe	0
银色警卫	yin'se'jing'wei	0
银色骑士	yin'se'qi'shi	0
银色神官帕尔崔丝	yin'se'shen'guan'pa'er'cui'si	0
银色侍从	yin'se'shi'cong	0
银色指挥官	yin'se'zhi'hui'guan	0
银月城传送门	yin'yue'cheng'chuan'song'men	0
银月城守护者	yin'yue'cheng'shou'hu'zhe	0
银月城卫兵	yin'yue'cheng'wei'bing	0
硬币基佬	ying'bi'ji'lao	0
鹰角弓	ying'jiao'gong	0
影袭	ying'xi	0
英雄母亲夜店工作者	ying'xiong'mu'qin'ye'dian'gong'zuo'zhe	0
英雄之魂	ying'xiong'zhi'hun	0
英勇打击	ying'yong'da'ji	0
英勇的记者	ying'yong'de'ji'zhe	0
英勇圣印	ying'yong'sheng'yin	0
影子杀手	ying'zi'sha'shou	0
影踪派武僧	ying'zong'pai'wu'seng	0
影踪骁骑兵	ying'zong'xiao'qi'bing	0
永恒哨卫	yong'heng'shao'wei	0
臃肿的蛇颈龙	yong'zhong'de'she'jing'long	0
幽暗城商贩	you'an'cheng'shang'fan	0
幽暗城勇士	you'an'cheng'yong'shi	0
尤格萨隆	you'ge'sa'long	0
尤格萨隆的仆从	you'ge'sa'long'de'pu'cong	0
幽灵狼	you'ling'lang	0
幽灵之爪	you'ling'zhi'zhao	0
幼龙机械师	you'long'ji'xie'shi	0
幼龙鹰	you'long'ying	0
鼬鼠挖掘工	you'shu'wa'jue'gong	0
游学者周卓	you'xue'zhe'zhou'zhuo	0
玉莲帮刺客	yu'lian'bang'ci'ke	0
玉莲帮法师	yu'lian'bang'fa'shi	0
玉莲帮幻术师	yu'lian'bang'huan'shu'shi	0
玉莲帮密探	yu'lian'bang'mi'tan	0
玉莲印记	yu'lian'yin'ji	0
淤泥董大师肚子疼	yu'ni'dong'da'shi'du'zi'teng	0
淤泥践踏者	yu'ni'jian'ta'zhe	0
淤泥喷射者	yu'ni'pen'she'zhe	0
鱼人	yu'ren	0
鱼人宝宝	yu'ren'bao'bao	0
鱼人潮汐猎手	yu'ren'chao'xi'lie'shou	0
鱼人斥候	yu'ren'chi'hou	0
鱼人恩典	yu'ren'en'dian	0
鱼人唤潮者	yu'ren'huan'chao'zhe	0
鱼人猎潮者	yu'ren'lie'chao'zhe	0
鱼人猎潮者我是鱼人	yu'ren'lie'chao'zhe'wo'shi'yu'ren	0
鱼人领军	yu'ren'ling'jun	0
鱼人骑	yu'ren'qi	0
鱼人骑士	yu'ren'qi'shi	0
鱼人杀手钳	yu'ren'sha'shou'qian	0
鱼人杀手蟹	yu'ren'sha'shou'xie	0
鱼人袭击者	yu'ren'xi'ji'zhe	0
鱼人招潮者	yu'ren'zhao'chao'zhe	0
鱼人总动员	yu'ren'zong'dong'yuan	0
浴血奋战	yu'xue'fen'zhan	0
愚者之灾	yu'zhe'zhi'zai	0
宇宙卡组	yu'zhou'ka'zu	0
远古暗影	yuan'gu'an'ying	0
远古雕文	yuan'gu'diao'wen	0
远古邪神	yuan'gu'xie'shen	0
远古邪神之血	yuan'gu'xie'shen'zhi'xue	0
远古之树	yuan'gu'zhi'shu	0
远古诅咒	yuan'gu'zu'zhou	0
援军	yuan'jun	0
元气弹	yuan'qi'dan	0
圆软紫软小圆	yuan'ruan'zi'ruan'xiao'yuan	0
原始融合	yuan'shi'rong'he	0
元帅	yuan'shuai	0
元素	yuan'su	0
元素毁灭	yuan'su'hui'mie	0
怨影狂怒者	yuan'ying'kuang'nu'zhe	0
渊狱惩击者	yuan'yu'cheng'ji'zhe	0
月光林地传送门	yue'guang'lin'di'chuan'song'men	0
月火术	yue'huo'shu	0
跃迁	yue'qian	0
跃下坐骑	yue'xia'zuo'qi	0
陨石术	yun'shi'shu	0
砸烂	za'lan	0
杂耍吞法者	za'shua'tun'fa'zhe	0
杂耍小鬼	za'shua'xiao'gui	0
载人飞天魔像	zai'ren'fei'tian'mo'xiang	0
载人收割机	zai'ren'shou'ge'ji	0
仔炸弹人	zai'zha'dan'ren	0
憎恶	zeng'wu	0
增压	zeng'ya	0
炸弹	zha'dan	0
扎根	zha'gen	0
战地记者	zhan'di'ji'zhe	0
战斗机器人	zhan'dou'ji'qi'ren	0
战斗怒火	zhan'dou'nu'huo	0
战斧	zhan'fu	0
战歌	zhan'ge	0
战歌指挥官	zhan'ge'zhi'hui'guan	0
战吼	zhan'hou	0
斩棘刀	zhan'ji'dao	0
展览馆法师	zhan'lan'guan'fa'shi	0
展览馆守卫	zhan'lan'guan'shou'wei	0
战利品储藏着	zhan'li'pin'chu'cang'zhe	0
战利品贮藏者	zhan'li'pin'zhu'cang'zhe	0
战马训练师	zhan'ma'xun'lian'shi	0
詹姆斯	zhan'mu'si	0
斩杀	zhan'sha	0
战士	zhan'shi	0
战士优胜	zhan'shi'you'sheng	0
战士支配者	zhan'shi'zhi'pei'zhe	0
战术撤离	zhan'shu'che'li	0
战争古树	zhan'zheng'gu'shu	0
战争傀儡	zhan'zheng'kui'lei	0
招报告	zhao'bao'gao	0
召唤宠物	zhao'huan'chong'wu	0
召唤传送门	zhao'huan'chuan'song'men	0
召唤猎豹	zhao'huan'lie'bao	0
爪击	zhao'ji	0
照明弹	zhao'ming'dan	0
着魔的村民	zhao'mo'de'cun'min	0
沼泽爬行者	zhao'ze'pa'xing'zhe	0
沼泽守护者	zhao'ze'shou'hu'zhe	0
沼泽之王爵德	zhao'ze'zhi'wang'jue'de	0
真言术触	zhen'yan'shu'chu	0
真言术盾	zhen'yan'shu'dun	0
真言术耀	zhen'yan'shu'yao	0
真银圣剑	zhen'yin'sheng'jian	0
真正的酋长	zhen'zheng'de'qiu'zhang	0
真正形态	zhen'zheng'xing'tai	0
蒸发	zheng'fa	0
征募官	zheng'mu'guan	0
蒸汽涌动者	zheng'qi'yong'dong'zhe	0
争强好胜	zheng'qiang'hao'sheng	0
正义之剑	zheng'yi'zhi'jian	0
掷斧者	zhi'fu'zhe	0
智慧祝福	zhi'hui'zhu'fu	0
治疗波	zhi'liao'bo	0
治疗图腾	zhi'liao'tu'teng	0
治疗之触	zhi'liao'zhi'chu	0
治疗之环	zhi'liao'zhi'huan	0
致命餐叉	zhi'ming'can'cha	0
致命毒药	zhi'ming'du'yao	0
致命膏药	zhi'ming'gao'yao	0
致命射击	zhi'ming'she'ji	0
致命药膏	zhi'ming'yao'gao	0
执刃教徒	zhi'ren'jiao'tu	0
致射	zhi'she	0
知识古树	zhi'shi'gu'shu	0
致死打击	zhi'si'da'ji	0
掷桐	zhi'tong	0
炙炎战斧	zhi'yan'zhan'fu	0
蜘蛛	zhi'zhu	0
蜘蛛蛋蛋	zhi'zhu'dan'dan	0
蜘蛛坦克	zhi'zhu'tan'ke	0
蜘蛛之卵	zhi'zhu'zhi'luan	0
重斧	zhong'fu	0
重甲战马	zhong'jia'zhan'ma	0
重碾	zhong'nian	0
重型攻城战车	zhong'xing'gong'cheng'zhan'che	0
重型护甲	zhong'xing'hu'jia	0
重型刃弩	zhong'xing'ren'nu	0
重压打击	zhong'ya'da'ji	0
种子	zhong'zi	0
主播冠名卡组	zhu'bo'guan'ming'ka'zu	0
筑巢双头鹏	zhu'chao'shuang'tou'peng	0
铸甲师	zhu'jia'shi	0
铸剑师	zhu'jian'shi	0
铸剑宗师	zhu'jian'zong'shi	0
蛛魔	zhu'mo	0
蛛魔先知	zhu'mo'xian'zhi	0
蛛魔之卵	zhu'mo'zhi'luan	0
侏儒变形师	zhu'ru'bian'xing'shi	0
侏儒发明家	zhu'ru'fa'ming'jia	0
侏儒实验技师	zhu'ru'shi'yan'ji'shi	0
转匕首转刀	zhuan'bi'shou'zhuan'dao	0
转护甲	zhuan'hu'jia	0
转生	zhuan'sheng	0
壮胆机器人型	zhuang'dan'ji'qi'ren'xing	0
追踪	zhui'zong	0
追踪术	zhui'zong'shu	0
灼热图腾	zhuo're'tu'teng	0
自爆绵羊	zi'bao'mian'yang	0
自闭卡组	zi'bi'ka'zu	0
子弹上膛	zi'dan'shang'tang	0
自动漩涡打击装置	zi'dong'xuan'wo'da'ji'zhuang'zhi	0
自负的演员	zi'fu'de'yan'yuan	0
紫弓小学生之弓	zi'gong'xiao'xue'sheng'zhi'gong	0
紫罗兰导师	zi'luo'lan'dao'shi	0
紫罗兰法师	zi'luo'lan'fa'shi	0
紫罗兰教师	zi'luo'lan'jiao'shi	0
紫罗兰学徒	zi'luo'lan'xue'tu	0
自然能量	zi'ran'neng'liang	0
自然平衡	zi'ran'ping'heng	0
自然印记	zi'ran'yin'ji	0
自然之力	zi'ran'zhi'li	0
自杀锤风怒锤	zi'sha'chui'feng'nu'chui	0
自杀领主烈焰大鬼	zi'sha'ling'zhu'lie'yan'da'gui	0
自杀小鬼	zi'sha'xiao'gui	0
自杀行者	zi'sha'xing'zhe	0
滋养	zi'yang	0
自走炮	zi'zou'pao	0
走私货物	zou'si'huo'wu	0
走私商贩	zou'si'shang'fan	0
走私物资	zou'si'wu'zi	0
阻击	zu'ji	0
组龙系列卡组	zu'long'xi'lie'ka'zu	0
诅咒	zu'zhou	0
诅咒教派大师	zu'zhou'jiao'pai'da'shi	0
诅咒教派领袖	zu'zhou'jiao'pai'ling'xiu	0
诅咒之刃	zu'zhou'zhi'ren	0
作战动员	zuo'zhan'dong'yuan	0
作战傀儡	zuo'zhan'kui'lei	0
