倍频程滤波器	bei'pin'cheng'lv'bo'qi	0
杯式过滤器	bei'shi'guo'lv'qi	0
布氏旋转粘度计	bu'shi'xuan'zhuan'nian'du'ji	0
蔡结晶点试验器	cai'jie'jing'dian'shi'yan'qi	0
测汞仪	ce'gong'yi	0
测氧仪	ce'yang'yi	0
车用汽油和航空燃料实际胶质测定法	che'yong'qi'you'he'hang'kong'ran'liao'shi'ji'jiao'zhi'ce'ding'fa	0
传声器测试仪	chuan'sheng'qi'ce'shi'yi	0
大三脚架	da'san'jiao'jia	0
单层板式过滤器	dan'ceng'ban'shi'guo'lv'qi	0
低温恒温水浴	di'wen'heng'wen'shui'yu	0
低温针入度试验器	di'wen'zhen'ru'du'shi'yan'qi	0
电动砂当量试验仪	dian'dong'sha'dang'liang'shi'yan'yi	0
电话机测试仪	dian'hua'ji'ce'shi'yi	0
电脑数显自控高速抽提仪	dian'nao'shu'xian'zi'kong'gao'su'chou'ti'yi	0
电声测试仪	dian'sheng'ce'shi'yi	0
电子湿度计	dian'zi'shi'du'ji	0
定时恒温磁力搅拌器	ding'shi'heng'wen'ci'li'jiao'ban'qi	0
冻存管夹	dong'cun'guan'jia	0
多功能低温试验器	duo'gong'neng'di'wen'shi'yan'qi	0
多功能电动击实仪	duo'gong'neng'dian'dong'ji'shi'yi	0
多功能循环恒温水浴	duo'gong'neng'xun'huan'heng'wen'shui'yu	0
多头细胞样品收集器	duo'tou'xi'bao'yang'pin'shou'ji'qi	0
发动机燃料饱和蒸汽压试验器	fa'dong'ji'ran'liao'bao'he'zheng'qi'ya'shi'yan'qi	0
防冻液冰点仪	fang'dong'ye'bing'dian'yi	0
灌注桩孔径检测系统	guan'zhu'zhuang'kong'jing'jian'ce'xi'tong	0
广电比色计	guang'dian'bi'se'ji	0
号转子	hao'zhuan'zi	0
恒温水浴	heng'wen'shui'yu	0
恒温油浴	heng'wen'you'yu	0
华润油液相锈蚀验器	hua'run'you'ye'xiang'xiu'shi'yan'qi	0
积分声级计	ji'fen'sheng'ji'ji	0
积分统计储存	ji'fen'tong'ji'chu'cun	0
金属刻字机	jin'shu'ke'zi'ji	0
精密积分声级计	jing'mi'ji'fen'sheng'ji'ji	0
精密脉冲声级计	jing'mi'mai'chong'sheng'ji'ji	0
精密声级计及自动测量系统	jing'mi'sheng'ji'ji'ji'zi'dong'ce'liang'xi'tong	0
精密盐度计	jing'mi'yan'du'ji	0
绝缘油耐压测定仪	jue'yuan'you'nai'ya'ce'ding'yi	0
绝缘油体积电阻率测定仪	jue'yuan'you'ti'ji'dian'zu'lv'ce'ding'yi	0
菌落计数器	jun'luo'ji'shu'qi	0
克利夫兰开口闪点试验器	ke'li'fu'lan'kai'kou'shan'dian'shi'yan'qi	0
沥青标准粘度计	li'qing'biao'zhun'nian'du'ji	0
沥青脆点试验器	li'qing'cui'dian'shi'yan'qi	0
沥青含蜡量试验器	li'qing'han'la'liang'shi'yan'qi	0
沥青含量测试仪	li'qing'han'liang'ce'shi'yi	0
沥青化学四组分分析器	li'qing'hua'xue'si'zu'fen'fen'xi'qi	0
沥青混合料理论最大相对密度试验器	li'qing'hun'he'liao'li'lun'zui'da'xiang'dui'mi'du'shi'yan'qi	0
沥青漂浮度试验器	li'qing'piao'fu'du'shi'yan'qi	0
沥青赛波特粘度试验仪	li'qing'sai'bo'te'nian'du'shi'yan'yi	0
沥青旋转薄膜烘箱	li'qing'xuan'zhuan'bao'mo'hong'xiang	0
沥青压力老化系统	li'qing'ya'li'lao'hua'xi'tong	0
沥青延度试验器	li'qing'yan'du'shi'yan'qi	0
沥青运动粘度试验器	li'qing'yun'dong'nian'du'shi'yan'qi	0
沥青粘韧性测定仪	li'qing'zhan'ren'xing'ce'ding'yi	0
两通道噪声频谱分析仪	liang'tong'dao'zao'sheng'pin'pu'fen'xi'yi	0
滤波器	lv'bo'qi	0
马歇尔电动击实仪	ma'xie'er'dian'dong'ji'shi'yi	0
马歇尔稳定度试验仪	ma'xie'er'wen'ding'du'shi'yan'yi	0
毛细管粘度清洗器	mao'xi'guan'nian'du'qing'xi'qi	0
耐腐蚀型连续可调移液器	nai'fu'shi'xing'lian'xu'ke'tiao'yi'ye'qi	0
耐高温消毒型连续可调八道移液器	nai'gao'wen'xiao'du'xing'lian'xu'ke'tiao'ba'dao'yi'ye'qi	0
耐高温消毒型连续可调十二道移液器	nai'gao'wen'xiao'du'xing'lian'xu'ke'tiao'shi'er'dao'yi'ye'qi	0
耐高温消毒型连续可调移液器	nai'gao'wen'xiao'du'xing'lian'xu'ke'tiao'yi'ye'qi	0
泥浆比重计	ni'jiang'bi'zhong'ji	0
泥浆测试箱	ni'jiang'ce'shi'xiang	0
泥浆含沙量测定计	ni'jiang'han'sha'liang'ce'ding'ji	0
泥浆粘度计	ni'jiang'nian'du'ji	0
泥浆失水量测定器	ni'jiang'shi'shui'liang'ce'ding'qi	0
皮带真空泵	pi'dai'zhen'kong'beng	0
普通声级计	pu'tong'sheng'ji'ji	0
普通型连续可调移液器	pu'tong'xing'lian'xu'ke'tiao'yi'ye'qi	0
汽油氧化安定性测定器	qi'you'yang'hua'an'ding'xing'ce'ding'qi	0
全自动闭口闪点试验器	quan'zi'dong'bi'kou'shan'dian'shi'yan'qi	0
全自动克利夫兰开口闪点试验器	quan'zi'dong'ke'li'fu'lan'kai'kou'shan'dian'shi'yan'qi	0
全自动沥青软化试验器	quan'zi'dong'li'qing'ruan'hua'shi'yan'qi	0
全自动张力测定仪	quan'zi'dong'zhang'li'ce'ding'yi	0
乳化沥青稠度试验器	ru'hua'li'qing'chou'du'shi'yan'qi	0
乳化沥青储存稳定性试验器	ru'hua'li'qing'chu'cun'wen'ding'xing'shi'yan'qi	0
乳化沥青负荷轮碾压试验器	ru'hua'li'qing'fu'he'lun'nian'ya'shi'yan'qi	0
乳化沥青粘附性试验器	ru'hua'li'qing'nian'fu'xing'shi'yan'qi	0
乳化沥青微粒电荷试验器	ru'hua'li'qing'wei'li'dian'he'shi'yan'qi	0
乳化沥青粘结力试验器	ru'hua'li'qing'zhan'jie'li'shi'yan'qi	0
润滑油抗泡沫特性试验器	run'hua'you'kang'pao'mo'te'xing'shi'yan'qi	0
润滑油空气释放值测定器	run'hua'you'kong'qi'shi'fang'zhi'ce'ding'qi	0
润滑脂滴点试验器	run'hua'zhi'di'dian'shi'yan'qi	0
润滑脂钢网分油试验器	run'hua'zhi'gang'wang'fen'you'shi'yan'qi	0
三元速快速分析仪	san'yuan'su'kuai'su'fen'xi'yi	0
深色石油产品硫含量试验器	shen'se'shi'you'chan'pin'liu'han'liang'shi'yan'qi	0
声级测试仪	sheng'ji'ce'shi'yi	0
石粉含量测试仪	shi'fen'han'liang'ce'shi'yi	0
石油产品苯胺点试验器	shi'you'chan'pin'ben'an'dian'shi'yan'qi	0
石油产品闭口闪点试验器	shi'you'chan'pin'bi'kou'shan'dian'shi'yan'qi	0
石油产品冰点试验器	shi'you'chan'pin'bing'dian'shi'yan'qi	0
石油产品低温蒸馏试验器	shi'you'chan'pin'di'wen'zheng'liu'shi'yan'qi	0
石油产品恩氏粘度计	shi'you'chan'pin'en'shi'nian'du'ji	0
石油产品和添加剂机械杂质	shi'you'chan'pin'he'tian'jia'ji'ji'xie'za'zhi	0
石油产品灰分试验器	shi'you'chan'pin'hui'fen'shi'yan'qi	0
石油产品开口闪点和燃点试验器	shi'you'chan'pin'kai'kou'shan'dian'he'ran'dian'shi'yan'qi	0
石油产品康氏残炭试验器	shi'you'chan'pin'kang'shi'can'tan'shi'yan'qi	0
石油产品馏程试验器	shi'you'chan'pin'liu'cheng'shi'yan'qi	0
石油产品硫含量试验器	shi'you'chan'pin'liu'han'liang'shi'yan'qi	0
石油产品密度试验器	shi'you'chan'pin'mi'du'shi'yan'qi	0
石油产品凝点冷滤点试验器	shi'you'chan'pin'ning'dian'leng'lv'dian'shi'yan'qi	0
石油产品凝点试验器	shi'you'chan'pin'ning'dian'shi'yan'qi	0
石油产品倾点浊点试验器	shi'you'chan'pin'qing'dian'zhuo'dian'shi'yan'qi	0
石油产品色度试验器	shi'you'chan'pin'se'du'shi'yan'qi	0
石油产品闪点和燃点试验器	shi'you'chan'pin'shan'dian'he'ran'dian'shi'yan'qi	0
石油产品水分试验器	shi'you'chan'pin'shui'fen'shi'yan'qi	0
石油产品水溶性酸及碱试验器	shi'you'chan'pin'shui'rong'xing'suan'ji'jian'shi'yan'qi	0
石油产品酸值酸度试验器	shi'you'chan'pin'suan'zhi'suan'du'shi'yan'qi	0
石油产品铜片腐蚀试验器	shi'you'chan'pin'tong'pian'fu'shi'shi'yan'qi	0
石油产品微量水分试验器	shi'you'chan'pin'wei'liang'shui'fen'shi'yan'qi	0
石油产品乌氏运动粘度测定器	shi'you'chan'pin'wu'shi'yun'dong'nian'du'ce'ding'qi	0
石油产品运动粘度测定器	shi'you'chan'pin'yun'dong'nian'du'ce'ding'qi	0
石油产品蒸馏试验器	shi'you'chan'pin'zheng'liu'shi'yan'qi	0
石油和合成液抗乳化性能试验器	shi'you'he'he'cheng'ye'kang'ru'hua'xing'neng'shi'yan'qi	0
石油沥青软化点试验器	shi'you'li'qing'ruan'hua'dian'shi'yan'qi	0
手持式读数显微镜	shou'chi'shi'du'shu'xian'wei'jing	0
手持式折光糖量计	shou'chi'shi'zhe'guang'tang'liang'ji	0
数控电炉法残炭试验器	shu'kong'dian'lu'fa'can'tan'shi'yan'qi	0
数字声级计	shu'zi'sheng'ji'ji	0
双层板式过滤器	shuang'ceng'ban'shi'guo'lv'qi	0
水环式真空泵	shui'huan'shi'zhen'kong'beng	0
台式吸引器	tai'shi'xi'yin'qi	0
通用声级计	tong'yong'sheng'ji'ji	0
微量恒温器	wei'liang'heng'wen'qi	0
微型空气压缩机	wei'xing'kong'qi'ya'suo'ji	0
微型台式真空泵	wei'xing'tai'shi'zhen'kong'beng	0
无油真空泵	wu'you'zhen'kong'beng	0
锈蚀腐蚀试验器	xiu'shi'fu'shi'shi'yan'qi	0
旋转粘度计	xuan'zhuan'nian'du'ji	0
循环玻璃保温套	xun'huan'bo'li'bao'wen'tao	0
盐度计	yan'du'ji	0
扬声器测试仪	yang'sheng'qi'ce'shi'yi	0
氧弹式热量计	yang'tan'shi're'liang'ji	0
液体石油产品水含量试验器	ye'ti'shi'you'chan'pin'shui'han'liang'shi'yan'qi	0
液体石油沥青蒸馏试验器	ye'ti'shi'you'li'qing'zheng'liu'shi'yan'qi	0
液压式车撤成型机	ye'ya'shi'che'che'cheng'xing'ji	0
一单元转片	yi'dan'yuan'zhuan'pian	0
圆筒式过滤器	yuan'tong'shi'guo'lv'qi	0
原油水含量试验器	yuan'you'shui'han'liang'shi'yan'qi	0
噪声频谱分析仪	zao'sheng'pin'pu'fen'xi'yi	0
噪声统计分析仪	zao'sheng'tong'ji'fen'xi'yi	0
噪声自动测试系统	zao'sheng'zi'dong'ce'shi'xi'tong	0
针入度试验器	zhen'ru'du'shi'yan'qi	0
直联旋片式真空泵	zhi'lian'xuan'pian'shi'zhen'kong'beng	0
智能冷原子荧光测汞仪	zhi'neng'leng'yuan'zi'ying'guang'ce'gong'yi	0
自动饱和蒸气压测定器	zi'dong'bao'he'zheng'qi'ya'ce'ding'qi	0
自动车撤试验仪	zi'dong'che'che'shi'yan'yi	0
自动混合料拌合机	zi'dong'hun'he'liao'ban'he'ji	0
自动凝点倾点试验器	zi'dong'ning'dian'qing'dian'shi'yan'qi	0
自动倾点试验器	zi'dong'qing'dian'shi'yan'qi	0
自动润滑油氧化安定性测定器	zi'dong'run'hua'you'yang'hua'an'ding'xing'ce'ding'qi	0
自动氧弹热量计	zi'dong'yang'tan're'liang'ji	0
自动震荡仪	zi'dong'zhen'dang'yi	0
自动针入度试验器	zi'dong'zhen'ru'du'shi'yan'qi	0
自燃点测定器	zi'ran'dian'ce'ding'qi	0
