安塔瑞斯炮台	an'ta'rui'si'pao'tai	0
暗影环绕	an'ying'huan'rao	0
奥普斯坦科	ao'pu'si'tan'ke	0
暴君	bao'jun	0
鞭打者坦克	bian'da'zhe'tan'ke	0
病毒狙击手	bing'du'ju'ji'shou	0
兵营	bing'ying	0
磁控坦克	ci'kong'tan'ke	0
磁力射线	ci'li'she'xian	0
地狱热能塔	di'yu're'neng'ta	0
地狱突袭	di'yu'tu'xi	0
动能屏障	dong'neng'ping'zhang	0
毒爆虱	du'bao'shi	0
毒爆虱陷阱	du'bao'shi'xian'jing	0
毒刺无人载具	du'ci'wu'ren'zai'ju	0
毒蜥	du'xi	0
恶灵升腾者	e'ling'sheng'teng'zhe	0
恶灵战机	e'ling'zhan'ji	0
厄普西隆机动建设车	e'pu'xi'long'ji'dong'jian'she'che	0
粉碎机	fen'sui'ji	0
工程师	gong'cheng'shi	0
弓箭手	gong'jian'shou	0
海军船坞	hai'jun'chuan'wu	0
护城墙	hu'cheng'qiang	0
化学组件	hua'xue'zu'jian	0
幻想核心	huan'xiang'he'xin	0
极速摩托车	ji'su'mo'tuo'che	0
基因地雷	ji'yin'di'lei	0
基因震爆	ji'yin'zhen'bao	0
基因组件	ji'yin'zu'jian	0
假建造场	jia'jian'zao'chang	0
加特林机炮	jia'te'lin'ji'pao	0
加特林坦克	jia'te'lin'tan'ke	0
假心灵支配	jia'xin'ling'zhi'pei	0
假心灵支配仪	jia'xin'ling'zhi'pei'yi	0
劫持者	jie'chi'zhe	0
精怪	jing'guai	0
剧毒空袭	ju'du'kong'xi	0
巨像	ju'xiang	0
巨型乌贼	ju'xing'wu'zei	0
克隆缸	ke'long'gang	0
空中要塞伊利卡拉	kong'zhong'yao'sai'yi'li'ka'la	0
狂暴	kuang'bao	0
狂暴激发器	kuang'bao'ji'fa'qi	0
矿石精炼厂	kuang'shi'jing'lian'chang	0
狂兽人	kuang'shou'ren	0
拉恩	la'en	0
雷达旋塔	lei'da'xuan'ta	0
炼狱平台	lian'yu'ping'tai	0
掠夺者坦克	lve'duo'zhe'tan'ke	0
马尔翁	ma'er'weng	0
梦魇行者	meng'yan'xing'zhe	0
迷雾机动车	mi'wu'ji'dong'che	0
魔影坦克	mo'ying'tan'ke	0
潘多拉枢纽	pan'duo'la'shu'niu	0
侵袭飞碟	qin'xi'fei'die	0
沙丘骑兵	sha'qiu'qi'bing	0
渗透者	shen'tou'zhe	0
神舟运输艇	shen'zhou'yun'shu'ting	0
生化反应室	sheng'hua'fan'ying'shi	0
食人鱼潜艇	shi'ren'yu'qian'ting	0
坦克碉堡	tan'ke'diao'bao	0
螳螂坦克	tang'lang'tan'ke	0
天秤	tian'cheng	0
天秤克隆体	tian'cheng'ke'long'ti	0
停机坪	ting'ji'ping	0
瘟神潜艇	wen'shen'qian'ting	0
瘟疫投石机	wen'yi'tou'shi'ji	0
心灵感应器	xin'ling'gan'ying'qi	0
心灵精英	xin'ling'jing'ying	0
心灵控制塔	xin'ling'kong'zhi'ta	0
心灵视界	xin'ling'shi'jie	0
心灵支配	xin'ling'zhi'pei	0
心灵支配仪	xin'ling'zhi'pei'yi	0
心灵之主	xin'ling'zhi'zhu	0
心灵专家	xin'ling'zhuan'jia	0
心灵组件	xin'ling'zu'jian	0
氧化防空车	yang'hua'fang'kong'che	0
尤里新兵	you'li'xin'bing	0
幽灵探矿车	you'ling'tan'kuang'che	0
闸门	zha'men	0
战车工厂	zhan'che'gong'chang	0
侦查暗鸦	zhen'cha'an'ya	0
钻地运输车	zuan'di'yun'shu'che	0
