爱丽舍宫	ai'li'she'gong	0
艾滋病	ai'zi'bing	0
按揭贷款	an'jie'dai'kuan	0
安居工程	an'ju'gong'cheng	0
暗亏	an'kui	0
按劳分配	an'lao'fen'pei	0
澳门大三巴牌坊	ao'men'da'san'ba'pai'fang	0
奥姆真理教	ao'mu'zhen'li'jiao	0
巴黎证券交易所	ba'li'zheng'quan'jiao'yi'suo	0
把握大局	ba'wo'da'ju	0
拜把兄弟	bai'ba'xiong'di	0
摆架子	bai'jia'zi	0
白马王子	bai'ma'wang'zi	0
拜年	bai'nian	0
摆谱儿	bai'pu'er	0
白色行情表	bai'se'hang'qing'biao	0
白色农业	bai'se'nong'ye	0
白手起家	bai'shou'qi'jia	0
白条	bai'tiao	0
半拉子工程	ban'la'zi'gong'cheng	0
搬迁户	ban'qian'hu	0
傍大款	bang'da'kuan	0
棒球运动记者	bang'qiu'yun'dong'ji'zhe	0
保持国有股	bao'chi'guo'you'gu	0
包干到户	bao'gan'dao'hu	0
包干制	bao'gan'zhi	0
包工包料	bao'gong'bao'liao	0
报国计划的实施	bao'guo'ji'hua'de'shi'shi	0
保护性关税	bao'hu'xing'guan'shui	0
保健食品	bao'jian'shi'pin	0
保理业务	bao'li'ye'wu	0
保税区	bao'shui'qu	0
保雅家	bao'ya'jia	0
保证重点支出	bao'zheng'zhong'dian'zhi'chu	0
保值储蓄	bao'zhi'chu'xu	0
包装机械	bao'zhuang'ji'xie	0
北欧投资银行	bei'ou'tou'zi'yin'hang	0
本本主义	ben'ben'zhu'yi	0
本垒打	ben'lei'da	0
本命年	ben'ming'nian	0
笨鸟先飞	ben'niao'xian'fei	0
奔小康	ben'xiao'kang	0
蹦极	beng'ji	0
比较经济学	bi'jiao'jing'ji'xue	0
闭门羹	bi'men'geng	0
比上不足	bi'shang'bu'zu	0
逼上梁山	bi'shang'liang'shan	0
边际报酬	bian'ji'bao'chou	0
变相涨价	bian'xiang'zhang'jia	0
便携式电脑	bian'xie'shi'dian'nao	0
边缘科学	bian'yuan'ke'xue	0
标书	biao'shu	0
表演赛	biao'yan'sai	0
剥夺冠军	bo'duo'guan'jun	0
博士生	bo'shi'sheng	0
不败记录	bu'bai'ji'lu	0
不承诺放弃使用武器	bu'cheng'nuo'fang'qi'shi'yong'wu'qi	0
不打不成交	bu'da'bu'cheng'jiao	0
布达拉宫	bu'da'la'gong	0
不到长城非好汉	bu'dao'chang'cheng'fei'hao'han	0
不可再生资源	bu'ke'zai'sheng'zi'yuan	0
布雷顿森林体系	bu'lei'dun'sen'lin'ti'xi	0
不良贷款	bu'liang'dai'kuan	0
补缺选举	bu'que'xuan'ju	0
补贴与反补贴措施	bu'tie'yu'fan'bu'tie'cuo'shi	0
步行天桥	bu'xing'tian'qiao	0
不夜城	bu'ye'cheng	0
不正之风	bu'zheng'zhi'feng	0
不准打白条	bu'zhun'da'bai'tiao	0
擦边球	ca'bian'qiu	0
擦网球	ca'wang'qiu	0
采取高姿态	cai'qu'gao'zi'tai	0
采取市场多元化战略	cai'qu'shi'chang'duo'yuan'hua'zhan'lve	0
参政	can'zheng	0
仓储式超市	cang'chu'shi'chao'shi	0
沧海桑田	cang'hai'sang'tian	0
草根工业	cao'gen'gong'ye	0
层层转包和违法分保	ceng'ceng'zhuan'bao'he'wei'fa'fen'bao	0
茶道	cha'dao	0
差额投票	cha'e'tou'piao	0
差额选举	cha'e'xuan'ju	0
查房	cha'fang	0
拆东墙补西墙	chai'dong'qiang'bu'xi'qiang	0
拆迁户	chai'qian'hu	0
产粮大省	chan'liang'da'sheng	0
产品结构	chan'pin'jie'gou	0
产权明晰	chan'quan'ming'xi	0
产权制度	chan'quan'zhi'du	0
搀水股票	chan'shui'gu'piao	0
产销直接挂钩	chan'xiao'zhi'jie'gua'gou	0
产业的升级换代	chan'ye'de'sheng'ji'huan'dai	0
产业结构升级	chan'ye'jie'gou'sheng'ji	0
长二捆	chang'er'kun	0
唱高调	chang'gao'diao	0
长江三角洲	chang'jiang'san'jiao'zhou	0
长期共存	chang'qi'gong'cun	0
畅通工程	chang'tong'gong'cheng	0
长线产品	chang'xian'chan'pin	0
畅销产品	chang'xiao'chan'pin	0
厂长经理负责制	chang'zhang'jing'li'fu'ze'zhi	0
超高速巨型计算机	chao'gao'su'ju'xing'ji'suan'ji	0
超前消费	chao'qian'xiao'fei	0
城市规划	cheng'shi'gui'hua	0
城市中年雅皮士	cheng'shi'zhong'nian'ya'pi'shi	0
城乡信用社	cheng'xiang'xin'yong'she	0
吃大锅饭	chi'da'guo'fan	0
吃皇粮	chi'huang'liang	0
重复建设	chong'fu'jian'she	0
筹备委员会	chou'bei'wei'yuan'hui	0
抽杀成功	chou'sha'cheng'gong	0
出风头	chu'feng'tou	0
出家	chu'jia	0
出口创汇能力	chu'kou'chuang'hui'neng'li	0
出口加工区	chu'kou'jia'gong'qu	0
出口退税	chu'kou'tui'shui	0
出口退税制度	chu'kou'tui'shui'zhi'du	0
出口转内销	chu'kou'zhuan'nei'xiao	0
传销	chuan'xiao	0
创汇产品	chuang'hui'chan'pin	0
窗口行业	chuang'kou'hang'ye	0
创业园	chuang'ye'yuan	0
吹风会	chui'feng'hui	0
春蕾计划	chun'lei'ji'hua	0
春运	chun'yun	0
此地无银三百两	ci'di'wu'yin'san'bai'liang	0
刺激内需	ci'ji'nei'xu	0
辞旧迎新	ci'jiu'ying'xin	0
磁悬浮列车	ci'xuan'fu'lie'che	0
从粗放经济转变为集约经济	cong'cu'fang'jing'ji'zhuan'bian'wei'ji'yue'jing'ji	0
粗放式管理	cu'fang'shi'guan'li	0
促进富余人员合理流动	cu'jin'fu'yu'ren'yuan'he'li'liu'dong	0
促进全球经济一体化	cu'jin'quan'qiu'jing'ji'yi'ti'hua	0
促进住房商品化	cu'jin'zhu'fang'shang'pin'hua	0
打白条	da'bai'tiao	0
大包干	da'bao'gan	0
达标活动	da'biao'huo'dong	0
达到或接近国际先进水平	da'dao'huo'jie'jin'guo'ji'xian'jin'shui'ping	0
打黑	da'hei	0
大轰动	da'hong'dong	0
打假	da'jia	0
大开眼界	da'kai'yan'jie	0
大款	da'kuan	0
大力扣杀	da'li'kou'sha	0
大路货	da'lu'huo	0
大满贯	da'man'guan	0
大排挡	da'pai'dang	0
打破地区封锁和行业垄断	da'po'di'qu'feng'suo'he'hang'ye'long'duan	0
打破僵局	da'po'jiang'ju	0
大胜	da'sheng	0
大事化小	da'shi'hua'xiao	0
打顺手	da'shun'shou	0
大腕	da'wan	0
大卫教	da'wei'jiao	0
大型电视系列片	da'xing'dian'shi'xi'lie'pian	0
大学生创业	da'xue'sheng'chuang'ye	0
大要案	da'yao'an	0
大藏经	da'zang'jing	0
大专生	da'zhuan'sheng	0
大专文凭	da'zhuan'wen'ping	0
待岗	dai'gang	0
带薪分流	dai'xin'fen'liu	0
待业	dai'ye	0
呆帐与坏帐	dai'zhang'yu'huai'zhang	0
代职	dai'zhi	0
单刀赴会	dan'dao'fu'hui	0
单循环制	dan'xun'huan'zhi	0
党群关系	dang'qun'guan'xi	0
党政机关	dang'zheng'ji'guan	0
盗打电话	dao'da'dian'hua	0
倒计时	dao'ji'shi	0
捣浆糊	dao'jiang'hu	0
倒票	dao'piao	0
倒爷	dao'ye	0
盗用公款	dao'yong'gong'kuan	0
等外品	deng'wai'pin	0
邓小平外交思想	deng'xiao'ping'wai'jiao'si'xiang	0
低调	di'diao	0
地方保护主义	di'fang'bao'hu'zhu'yi	0
地方财政包干制	di'fang'cai'zheng'bao'gan'zhi	0
地球村	di'qiu'cun	0
地区差异	di'qu'cha'yi	0
地热资源	di're'zi'yuan	0
第三产业	di'san'chan'ye	0
第三代移动电话	di'san'dai'yi'dong'dian'hua	0
地市级城市	di'shi'ji'cheng'shi	0
第四产业	di'si'chan'ye	0
第一食品网	di'yi'shi'pin'wang	0
电话号码升位	dian'hua'hao'ma'sheng'wei	0
电话会议	dian'hua'hui'yi	0
电视直销	dian'shi'zhi'xiao	0
点子公司	dian'zi'gong'si	0
电子商务认证	dian'zi'shang'wu'ren'zheng	0
吊球	diao'qiu	0
吊销执照	diao'xiao'zhi'zhao	0
定向培训	ding'xiang'pei'xun	0
钉子户	ding'zi'hu	0
东方金钰	dong'fang'jin'yu	0
渡假外交	du'jia'wai'jiao	0
独立核算工业企业	du'li'he'suan'gong'ye'qi'ye	0
毒品走私	du'pin'zou'si	0
毒枭	du'xiao	0
断交信	duan'jiao'xin	0
短期债务	duan'qi'zhai'wu	0
短线振荡	duan'xian'zhen'dang	0
对冲基金	dui'chong'ji'jin	0
对外招商	dui'wai'zhao'shang	0
队长袖标	dui'zhang'xiu'biao	0
多单	duo'dan	0
多党合作制	duo'dang'he'zuo'zhi	0
夺冠	duo'guan	0
多任务小卫星	duo'ren'wu'xiao'wei'xing	0
厄尔尼诺	e'er'ni'nuo	0
恶性循环	e'xing'xun'huan	0
恶性肿瘤	e'xing'zhong'liu	0
遏制通货膨胀	e'zhi'tong'huo'peng'zhang	0
发行股票	fa'xing'gu'piao	0
发扬优良传统	fa'yang'you'liang'chuan'tong	0
发优惠券以促销	fa'you'hui'quan'yi'cu'xiao	0
发展文学艺术	fa'zhan'wen'xue'yi'shu	0
发展新兴产业和高技术产业	fa'zhan'xin'xing'chan'ye'he'gao'ji'shu'chan'ye	0
发展畜牧业	fa'zhan'xu'mu'ye	0
反抽	fan'chou	0
反对铺张浪费	fan'dui'pu'zhang'lang'fei	0
反倾销	fan'qing'xiao	0
防暴警察	fang'bao'jing'cha	0
防止国有资产流失	fang'zhi'guo'you'zi'chan'liu'shi	0
防止经济过热	fang'zhi'jing'ji'guo're	0
防止泡沫经济	fang'zhi'pao'mo'jing'ji	0
分流下岗人员争取再就业	fen'liu'xia'gang'ren'yuan'zheng'qu'zai'jiu'ye	0
扶贫	fu'pin	0
妇幼保健	fu'you'bao'jian	0
该公司股票已经上市	gai'gong'si'gu'piao'yi'jing'shang'shi	0
改进产业结构和产品结构	gai'jin'chan'ye'jie'gou'he'chan'pin'jie'gou	0
赶上或超过国际先进水平	gan'shang'huo'chao'guo'guo'ji'xian'jin'shui'ping	0
高举邓小平理论的伟大旗帜	gao'ju'deng'xiao'ping'li'lun'de'wei'da'qi'zhi	0
个人所得税	ge'ren'suo'de'shui	0
个体工商业者	ge'ti'gong'shang'ye'zhe	0
个体户	ge'ti'hu	0
各族人民	ge'zu'ren'min	0
公务员	gong'wu'yuan	0
工业企业	gong'ye'qi'ye	0
股份合作制	gu'fen'he'zuo'zhi	0
股份制	gu'fen'zhi	0
鼓励兼并	gu'li'jian'bing	0
股票热降温了	gu'piao're'jiang'wen'le	0
股市指数	gu'shi'zhi'shu	0
广州开发区	guang'zhou'kai'fa'qu	0
规模经济	gui'mo'jing'ji	0
国防科技	guo'fang'ke'ji	0
国际大都市	guo'ji'da'du'shi	0
国家公务员制度	guo'jia'gong'wu'yuan'zhi'du	0
国家指定考试	guo'jia'zhi'ding'kao'shi	0
国事访问	guo'shi'fang'wen	0
海川装饰	hai'chuan'zhuang'shi	0
和讯网	he'xun'wang	0
沪深两市	hu'shen'liang'shi	0
沪油	hu'you	0
华西期货	hua'xi'qi'huo	0
华阳集团	hua'yang'ji'tuan	0
获薄利	huo'bo'li	0
获厚利	huo'hou'li	0
获利了结	huo'li'liao'jie	0
杰威化工	jie'wei'hua'gong	0
金融界	jin'rong'jie	0
剧烈震荡	ju'lie'zhen'dang	0
连豆	lian'dou	0
龙口海川装饰	long'kou'hai'chuan'zhuang'shi	0
龙口市黄城海川装饰	long'kou'shi'huang'cheng'hai'chuan'zhuang'shi	0
农业工作	nong'ye'gong'zuo	0
十字星	shi'zi'xing	0
师宗县	shi'zong'xian	0
下调油价	xia'tiao'you'jia	0
异动股	yi'dong'gu	0
中财期货	zhong'cai'qi'huo	0
中环股份	zhong'huan'gu'fen	0
中石油	zhong'shi'you	0
中新网	zhong'xin'wang	0
最新考研经济生活词汇大全	zui'xin'kao'yan'jing'ji'sheng'huo'ci'hui'da'quan	0
