阿任	a'ren	0
阿鑫	a'xin	0
陈墨	chen'mo	0
东京新娘	dong'jing'xin'niang	0
海川	hai'chuan	0
互动营销	hu'dong'ying'xiao	0
口碑营销	kou'bei'ying'xiao	0
立二	li'er	0
离小柒	li'xiao'qi	0
络推客手	luo'tui'ke'shou	0
纳兰舆论营销	na'lan'yu'lun'ying'xiao	0
品牌舆论营销	pin'pai'yu'lun'ying'xiao	0
搜索引擎优化	sou'suo'yin'qing'you'hua	0
网络公关	wang'luo'gong'guan	0
网络红人	wang'luo'hong'ren	0
网络推网	wang'luo'tui'wang	0
网络营销策划师	wang'luo'ying'xiao'ce'hua'shi	0
网站优化	wang'zhan'you'hua	0
小百度	xiao'bai'du	0
舆论危机公关	yu'lun'wei'ji'gong'guan	0
舆论营销	yu'lun'ying'xiao	0
