安全门	an'quan'men	0
百米标	bai'mi'biao	0
宝带路	bao'dai'lu	0
宝带桥南	bao'dai'qiao'nan	0
保护动作	bao'hu'dong'zuo	0
爆裂	bao'lie	0
备车替开	bei'che'ti'kai	0
北港路	bei'gang'lu	0
北寺塔	bei'si'ta	0
备用车	bei'yong'che	0
闭合	bi'he	0
闭塞	bi'se	0
变压器故障	bian'ya'qi'gu'zhang	0
滨河路	bin'he'lu	0
差动	cha'dong	0
差动保护	cha'dong'bao'hu	0
察院场	cha'yuan'chang	0
长亭	chang'ting	0
超限车	chao'xian'che	0
车场	che'chang	0
车场线	che'chang'xian	0
车辆限界	che'liang'xian'jie	0
车门故障	che'men'gu'zhang	0
车站隧道	che'zhan'sui'dao	0
车组	che'zu	0
充电屏	chong'dian'ping	0
冲动	chong'dong	0
冲突	chong'tu	0
抽屉开关柜	chou'ti'kai'guan'gui	0
抽线	chou'xian	0
出场	chu'chang	0
处理措施	chu'li'cuo'shi	0
垂直电梯迫降	chui'zhi'dian'ti'po'jiang	0
存车线	cun'che'xian	0
大单边供电	da'dan'bian'gong'dian	0
大电流脱扣保护	da'dian'liu'tuo'kou'bao'hu	0
大双边供电	da'shuang'bian'gong'dian	0
大湾	da'wan	0
大系统	da'xi'tong	0
单边供电	dan'bian'gong'dian	0
道岔短闪	dao'cha'duan'shan	0
电池屏	dian'chi'ping	0
电动风阀	dian'dong'feng'fa	0
电抗器	dian'kang'qi	0
电缆	dian'lan	0
电力继电保护装置	dian'li'ji'dian'bao'hu'zhuang'zhi	0
电力通信装置	dian'li'tong'xin'zhuang'zhi	0
电流互感器	dian'liu'hu'gan'qi	0
电流速断保护	dian'liu'su'duan'bao'hu	0
电流增量保护	dian'liu'zeng'liang'bao'hu	0
电压波动	dian'ya'bo'dong	0
电压过流保护	dian'ya'guo'liu'bao'hu	0
电压互感器	dian'ya'hu'gan'qi	0
调车	diao'che	0
调车员	diao'che'yuan	0
调度台	diao'du'tai	0
吊悬	diao'xuan	0
东方之门	dong'fang'zhi'men	0
东环路	dong'huan'lu	0
动力变	dong'li'bian	0
动力变压器	dong'li'bian'ya'qi	0
东振路	dong'zhen'lu	0
独墅湖邻里中心	du'shu'hu'lin'li'zhong'xin	0
独墅湖南	du'shu'hu'nan	0
断路器	duan'lu'qi	0
断路器小车	duan'lu'qi'xiao'che	0
断路器小车隔离位	duan'lu'qi'xiao'che'ge'li'wei	0
断路器小车试验位	duan'lu'qi'xiao'che'shi'yan'wei	0
断路器小车运行位	duan'lu'qi'xiao'che'yun'xing'wei	0
二类负荷	er'lei'fu'he	0
反向运行	fan'xiang'yun'xing	0
防火阀	fang'huo'fa	0
防火卷帘门	fang'huo'juan'lian'men	0
防夹	fang'jia	0
放气勿入灯亮	fang'qi'wu'ru'deng'liang	0
方湾街	fang'wan'jie	0
防淹门	fang'yan'men	0
非消防电源	fei'xiao'fang'dian'yuan	0
汾湖路	fen'hu'lu	0
分路不良	fen'lu'bu'liang	0
丰和路	feng'he'lu	0
葑亭大道	feng'ting'da'dao	0
负荷切换	fu'he'qie'huan	0
扶梯	fu'ti	0
富翔路	fu'xiang'lu	0
富元路	fu'yuan'lu	0
辅助逆变器	fu'zhu'ni'bian'qi	0
辅助线	fu'zhu'xian	0
感温电缆	gan'wen'dian'lan	0
感温光纤	gan'wen'guang'xian	0
感温火灾探测器	gan'wen'huo'zai'tan'ce'qi	0
感烟火灾探测器	gan'yan'huo'zai'tan'ce'qi	0
钢轨	gang'gui	0
钢轨折断	gang'gui'zhe'duan	0
刚性接触网	gang'xing'jie'chu'wang	0
高铁苏州北	gao'tie'su'zhou'bei	0
隔离开关	ge'li'kai'guan	0
戈巷街	ge'xiang'jie	0
供电	gong'dian	0
公交接驳	gong'jiao'jie'bo	0
工器具	gong'qi'ju	0
弓网故障	gong'wang'gu'zhang	0
工作照明失电	gong'zuo'zhao'ming'shi'dian	0
顾家荡	gu'jia'dang	0
故障原因	gu'zhang'yuan'yin	0
关门车	guan'men'che	0
广济南路	guang'ji'nan'lu	0
轨道电路	gui'dao'dian'lu	0
过负荷保护	guo'fu'he'bao'hu	0
过线	guo'xian	0
郭巷	guo'xiang	0
郭苑路	guo'yuan'lu	0
何山路	he'shan'lu	0
横山	heng'shan	0
横塘	heng'tang	0
红光带	hong'guang'dai	0
红庄	hong'zhuang	0
后备保护	hou'bei'bao'hu	0
花港	hua'gang	0
环网开关	huan'wang'kai'guan	0
回场	hui'chang	0
惠昌路	hui'chang'lu	0
恢复	hui'fu	0
回排风机	hui'pai'feng'ji	0
活力岛	huo'li'dao	0
火灾模式	huo'zai'mo'shi	0
挤岔	ji'cha	0
架空地线	jia'kong'di'xian	0
驾驶模式	jia'shi'mo'shi	0
检修车	jian'xiu'che	0
建筑限界	jian'zhu'xian'jie	0
江陵西路	jiang'ling'xi'lu	0
江兴西路	jiang'xing'xi'lu	0
交路	jiao'lu	0
交路调整	jiao'lu'tiao'zheng	0
接触网	jie'chu'wang	0
接触网支持装置	jie'chu'wang'zhi'chi'zhuang'zhi	0
接地刀闸	jie'di'dao'zha	0
接地线	jie'di'xian	0
接发列车作业	jie'fa'lie'che'zuo'ye	0
金枫路	jin'feng'lu	0
金谷路	jin'gu'lu	0
紧急停车按钮	jin'ji'ting'che'an'niu	0
紧急制动	jin'ji'zhi'dong	0
紧急制动施加	jin'ji'zhi'dong'shi'jia	0
金尚路	jin'shang'lu	0
金厍桥	jin'she'qiao	0
进水总阀	jin'shui'zong'fa	0
进线失电	jin'xian'shi'dian	0
紧制	jin'zhi	0
警铃	jing'ling	0
可缓	ke'huan	0
客伤	ke'shang	0
空压机	kong'ya'ji	0
控制盘	kong'zhi'pan	0
控制屏	kong'zhi'ping	0
扣件	kou'jian	0
跨塘	kua'tang	0
框架保护	kuang'jia'bao'hu	0
劳动路	lao'dong'lu	0
乐桥	le'qiao	0
冷冻水泵	leng'dong'shui'beng	0
冷却水泵	leng'que'shui'beng	0
冷却塔	leng'que'ta	0
冷水机组	leng'shui'ji'zu	0
李公堤西	li'gong'di'xi	0
蠡口	li'kou	0
蠡墅	li'shu	0
笠泽路	li'ze'lu	0
联动	lian'dong	0
联锁	lian'suo	0
列车	lie'che	0
列车运行图	lie'che'yun'xing'tu	0
临顿路	lin'dun'lu	0
邻线	lin'xian	0
零序	ling'xu	0
零序电流保护	ling'xu'dian'liu'bao'hu	0
流虹路	liu'hong'lu	0
龙道浜	long'dao'bang	0
隆起	long'qi	0
陆慕	lu'mu	0
马运路	ma'yun'lu	0
门禁释放	men'jin'shi'fang	0
木渎	mu'du	0
木里	mu'li	0
母联	mu'lian	0
母排	mu'pai	0
母排隔离	mu'pai'ge'li	0
南门	nan'men	0
南施街	nan'shi'jie	0
倪浜	ni'bang	0
逆变器	ni'bian'qi	0
逆流保护	ni'liu'bao'hu	0
排风机	pai'feng'ji	0
排空	pai'kong	0
排空运行	pai'kong'yun'xing	0
排热风机	pai're'feng'ji	0
排烟防火阀	pai'yan'fang'huo'fa	0
排烟风机	pai'yan'feng'ji	0
盘蠡路	pan'li'lu	0
庞金路	pang'jin'lu	0
平河路	ping'he'lu	0
平泷路东	ping'long'lu'dong	0
平泷路西	ping'long'lu'xi	0
骑河	qi'he	0
气灭喷洒	qi'mie'pen'sa	0
气灭主机	qi'mie'zhu'ji	0
前发晚点	qian'fa'wan'dian	0
牵引	qian'yin	0
牵引回流线	qian'yin'hui'liu'xian	0
牵引逆变器	qian'yin'ni'bian'qi	0
牵引无效	qian'yin'wu'xiao	0
牵引系统	qian'yin'xi'tong	0
牵引运行	qian'yin'yun'xing	0
抢修	qiang'xiu	0
侵限	qin'xian	0
清客	qing'ke	0
清树湾	qing'shu'wan	0
清塘	qing'tang	0
清塘主变电所	qing'tang'zhu'bian'dian'suo	0
秋枫	qiu'feng	0
秋枫主变电所	qiu'feng'zhu'bian'dian'suo	0
区间蝶阀	qu'jian'die'fa	0
区间高水位	qu'jian'gao'shui'wei	0
区间火灾工况	qu'jian'huo'zai'gong'kuang	0
区间迫停	qu'jian'po'ting	0
区间阻塞	qu'jian'zu'se	0
区调	qu'tiao	0
区域站	qu'yu'zhan	0
人民桥南	ren'min'qiao'nan	0
柔性接触网	rou'xing'jie'chu'wang	0
三类负荷	san'lei'fu'he	0
三香广场	san'xiang'guang'chang	0
三元坊	san'yuan'fang	0
桑田岛	sang'tian'dao	0
沙金桥	sha'jin'qiao	0
山塘街	shan'tang'jie	0
赏湖	shang'hu	0
赏湖主变电所	shang'hu'zhu'bian'dian'suo	0
上下行均流线	shang'xia'xing'jun'liu'xian	0
上行	shang'xing	0
设备	she'bei	0
设备短路	she'bei'duan'lu	0
设备接地	she'bei'jie'di	0
设备限界	she'bei'xian'jie	0
射流风机	she'liu'feng'ji	0
声光报警器	sheng'guang'bao'jing'qi	0
生活水管	sheng'huo'shui'guan	0
时代广场	shi'dai'guang'chang	0
石湖北	shi'hu'bei	0
石湖东路	shi'hu'dong'lu	0
石湖莫舍	shi'hu'mo'she	0
施家	shi'jia	0
施家主变电所	shi'jia'zhu'bian'dian'suo	0
石路	shi'lu	0
狮山路	shi'shan'lu	0
市政总阀	shi'zheng'zong'fa	0
狮子山	shi'zi'shan	0
手动报警按钮	shou'dong'bao'jing'an'niu	0
墅浦路	shu'pu'lu	0
疏散平台	shu'san'ping'tai	0
疏散位	shu'san'wei	0
双边供电	shuang'bian'gong'dian	0
双边联跳保护	shuang'bian'lian'tiao'bao'hu	0
双马街	shuang'ma'jie	0
水喷淋	shui'pen'lin	0
水系统	shui'xi'tong	0
松陵大道	song'ling'da'dao	0
松涛街	song'tao'jie	0
苏锦	su'jin	0
苏州火车站	su'zhou'huo'che'zhan	0
苏州乐园	su'zhou'le'yuan	0
苏州乐园主变电所	su'zhou'le'yuan'zhu'bian'dian'suo	0
苏州湾北	su'zhou'wan'bei	0
苏州湾东	su'zhou'wan'dong	0
苏州新区火车站	su'zhou'xin'qu'huo'che'zhan	0
苏州园区火车站	su'zhou'yuan'qu'huo'che'zhan	0
隧道风机	sui'dao'feng'ji	0
隧道通风系统	sui'dao'tong'feng'xi'tong	0
孙武纪念园	sun'wu'ji'nian'yuan	0
塔园路	ta'yuan'lu	0
坍塌	tan'ta	0
唐庄	tang'zhuang	0
套跑	tao'pao	0
天鹅荡路	tian'e'dang'lu	0
调试车	tiao'shi'che	0
跳停	tiao'ting	0
跳闸	tiao'zha	0
停稳	ting'wen	0
铜墩	tong'dun	0
桐泾北路	tong'jing'bei'lu	0
桐泾公园	tong'jing'gong'yuan	0
同里	tong'li	0
通园	tong'yuan	0
通园路南	tong'yuan'lu'nan	0
通园主变电所	tong'yuan'zhu'bian'dian'suo	0
头端界	tou'duan'jie	0
突发大客流	tu'fa'da'ke'liu	0
团结桥	tuan'jie'qiao	0
推进	tui'jin	0
推手柄	tui'shou'bing	0
退行	tui'xing	0
脱轨	tuo'gui	0
拓扑着色	tuo'pu'zhuo'se	0
瓦斯保护	wa'si'bao'hu	0
晚点	wan'dian	0
尾端界	wei'duan'jie	0
唯亭	wei'ting	0
文昌路	wen'chang'lu	0
温度保护	wen'du'bao'hu	0
文化博览中心	wen'hua'bo'lan'zhong'xin	0
文溪路	wen'xi'lu	0
吴江汽车站	wu'jiang'qi'che'zhan	0
吴江人民广场	wu'jiang'ren'min'guang'chang	0
无载调压	wu'zai'tiao'ya	0
西环路	xi'huan'lu	0
西津桥	xi'jin'qiao	0
下行	xia'xing	0
现场负责人	xian'chang'fu'ze'ren	0
显红	xian'hong	0
显黄	xian'huang	0
限界	xian'jie	0
限制条件	xian'zhi'tiao'jian	0
相门	xiang'men	0
消防泵房	xiao'fang'beng'fang	0
消防泵房进水总阀	xiao'fang'beng'fang'jin'shui'zong'fa	0
消防电话	xiao'fang'dian'hua	0
消防广播	xiao'fang'guang'bo	0
消防水管	xiao'fang'shui'guan	0
消火栓报警按钮	xiao'huo'shuan'bao'jing'an'niu	0
消火栓泵起泵	xiao'huo'shuan'beng'qi'beng	0
小系统	xiao'xi'tong	0
消音器	xiao'yin'qi	0
新风机	xin'feng'ji	0
新郭	xin'guo	0
信号机前后方	xin'hao'ji'qian'hou'fang	0
新家桥	xin'jia'qiao	0
行车闭塞法	xing'che'bi'se'fa	0
行车凭证	xing'che'ping'zheng	0
星海广场	xing'hai'guang'chang	0
星湖街	xing'hu'jie	0
星塘主变电所	xing'tang'zhu'bian'dian'suo	0
胥江路	xu'jiang'lu	0
徐图港	xu'tu'gang	0
延误	yan'wu	0
烟雨桥	yan'yu'qiao	0
阳澄湖中路	yang'cheng'hu'zhong'lu	0
养育巷	yang'yu'xiang	0
姚祥	yao'xiang	0
一类负荷	yi'lei'fu'he	0
异物	yi'wu	0
异物侵限	yi'wu'qin'xian	0
引导接车	yin'dao'jie'che	0
引导员	yin'dao'yuan	0
尹山湖	yin'shan'hu	0
尹中路	yin'zhong'lu	0
迎春路	ying'chun'lu	0
友联	you'lian	0
有源滤波装置	you'yuan'lv'bo'zhuang'zhi	0
有载调压	you'zai'tiao'ya	0
玉山路	yu'shan'lu	0
远程控制盒	yuan'cheng'kong'zhi'he	0
月亮湾	yue'liang'wan	0
越溪	yue'xi	0
运营侧	yun'ying'ce	0
运营时刻表	yun'ying'shi'ke'biao	0
运用车	yun'yong'che	0
载客服务	zai'ke'fu'wu	0
闸机	zha'ji	0
闸机释放	zha'ji'shi'fang	0
站台公共区	zhan'tai'gong'gong'qu	0
站台门	zhan'tai'men	0
站厅公共区	zhan'ting'gong'gong'qu	0
胀轨	zhang'gui	0
胀轨跑道	zhang'gui'pao'dao	0
张庄	zhang'zhuang	0
折返线	zhe'fan'xian	0
正点率	zheng'dian'lv	0
整流变压器	zheng'liu'bian'ya'qi	0
整流机组	zheng'liu'ji'zu	0
整流器	zheng'liu'qi	0
正线	zheng'xian	0
制动	zhi'dong	0
制动不缓	zhi'dong'bu'huan	0
制动图标	zhi'dong'tu'biao	0
支援供电	zhi'yuan'gong'dian	0
钟南街	zhong'nan'jie	0
中央公园	zhong'yang'gong'yuan	0
终止	zhong'zhi	0
主变电所	zhu'bian'dian'suo	0
主变压器	zhu'bian'ya'qi	0
主机	zhu'ji	0
转轨	zhuan'gui	0
转线	zhuan'xian	0
自动重合闸	zi'dong'chong'he'zha	0
自动售票机	zi'dong'shou'piao'ji	0
紫光带	zi'guang'dai	0
组合式风阀	zu'he'shi'feng'fa	0
组合式空调器	zu'he'shi'kong'tiao'qi	0
