被老师遣送回家	bei'lao'shi'qian'song'hui'jia	0
被路过的一位老师当场捉住	bei'lu'guo'de'yi'wei'lao'shi'dang'chang'zhuo'zhu	0
便摆摆手说	bian'bai'bai'shou'shuo	0
并不知道打架的目的是什么	bing'bu'zhi'dao'da'jia'de'mu'di'shi'shen'me	0
才叹口气	cai'tan'kou'qi	0
打到别人都逃走了	da'dao'bie'ren'dou'tao'zou'le	0
带我去校长家	dai'wo'qu'xiao'zhang'jia	0
都提前支出来换成酒和茶叶	dou'ti'qian'zhi'chu'lai'huan'cheng'jiu'he'cha'ye	0
而校长	er'xiao'zhang	0
父亲已是一头大汗	fu'qin'yi'shi'yi'tou'da'han	0
会惊得他微微一怔	hui'jing'de'ta'wei'wei'yi'zheng	0
将给我攒好的下学期的所有费用	jiang'gei'wo'zan'hao'de'xia'xue'qi'de'suo'you'fei'yong	0
那年我读高二	na'nian'wo'du'gao'er	0
你回家去吧	ni'hui'jia'qu'ba	0
你在家先学习	ni'zai'jia'xian'xue'xi	0
扭送到校长室去	niu'song'dao'xiao'zhang'shi'qu	0
偶尔我轻咳一声	ou'er'wo'qing'ke'yi'sheng	0
平生从来没有求过人的父亲	ping'sheng'cong'lai'mei'you'qiu'guo'ren'de'fu'qin	0
却被父亲抬头叫住了	que'bei'fu'qin'tai'tou'jiao'zhu'le	0
确定没有人看到	que'ding'mei'you'ren'kan'dao	0
然后趁着夜色	ran'hou'chen'zhe'ye'se	0
使父亲走起路来愈加艰难	shi'fu'qin'zou'qi'lu'lai'yu'jia'jian'nan	0
随即瞥见低头缩在后面的我	sui'ji'pie'jian'di'tou'suo'zai'hou'mian'de'wo	0
随即小心翼翼地四下张望一番	sui'ji'xiao'xin'yi'yi'di'si'xia'zhang'wang'yi'fan	0
他才继续溜着墙根前行	ta'cai'ji'xu'liu'zhe'qiang'gen'qian'xing	0
他看了许久	ta'kan'le'xu'jiu	0
他明显有些紧张	ta'ming'xian'you'xie'jin'zhang	0
晚上跟我去校长家坐一坐	wan'shang'gen'wo'qu'xiao'zhang'jia'zuo'yi'zuo	0
我跟在父亲的身后	wo'gen'zai'fu'qin'de'shen'hou	0
我就这样神思恍惚地收拾了书包	wo'jiu'zhe'yang'shen'si'huang'hu'di'shou'shi'le'shu'bao	0
我突然想要逃掉	wo'tu'ran'xiang'yao'tao'diao	0
我无意中参与了一场群架	wo'wu'yi'zhong'can'yu'le'yi'chang'qun'jia	0
先是一愣	xian'shi'yi'leng	0
校长开门看到神情谦卑的父亲	xiao'zhang'kai'men'kan'dao'shen'qing'qian'bei'de'fu'qin	0
以后不必再来了	yi'hou'bu'bi'zai'lai'le	0
在昏暗的楼道里往上爬的时候	zai'hun'an'de'lou'dao'li'wang'shang'pa'de'shi'hou	0
在一次车祸中被撞瘸的右腿	zai'yi'ci'che'huo'zhong'bei'zhuang'que'de'you'tui	0
这才明白过来	zhe'cai'ming'bai'guo'lai	0
这是父亲第一次给人送礼	zhe'shi'fu'qin'di'yi'ci'gei'ren'song'li	0
正是需要加速的时候	zheng'shi'xu'yao'jia'su'de'shi'hou	0
只知道发泄似的冲上去乱打	zhi'zhi'dao'fa'xie'shi'de'chong'shang'qu'luan'da	0
终于敲开校长家门的时候	zhong'yu'qiao'kai'xiao'zhang'jia'men'de'shi'hou	0
走到门口的时候	zou'dao'men'kou'de'shi'hou	0
