阿鲁纳	a'lu'na	0
爱德华林	ai'de'hua'lin	0
埃菲莫娃	ai'fei'mo'wa	0
埃迈谢	ai'mai'xie	0
艾衍含	ai'yan'han	0
安家杰	an'jia'jie	0
安娜科拉卡奇	an'na'ke'la'ka'qi	0
奥古斯蒂安尼	ao'gu'si'di'an'ni	0
奥莱克西亚克	ao'lai'ke'xi'ya'ke	0
奥林匹克射击中心	ao'lin'pi'ke'she'ji'zhong'xin	0
奥林匹克体育场	ao'lin'pi'ke'ti'yu'chang	0
奥鲁约夫	ao'lu'yue'fu	0
巴拉奥林匹克公园	ba'la'ao'lin'pi'ke'gong'yuan	0
巴齐尔	ba'qi'er	0
巴特萨拉斯基纳	ba'te'sa'la'si'ji'na	0
巴西利亚	ba'xi'li'ya	0
巴震	ba'zhen	0
鲍迪亚	bao'di'ya	0
鲍语晴	bao'yu'qing	0
包壮	bao'zhuang	0
贝克	bei'ke	0
贝洛奥里藏特	bei'luo'ao'li'zang'te	0
本努瓦	ben'nu'wa	0
毕晓琳	bi'xiao'lin	0
卞卡	bian'ka	0
蔡家东	cai'jia'dong	0
蔡泽林	cai'ze'lin	0
蔡振华	cai'zhen'hua	0
曹慧	cao'hui	0
曹硕	cao'shuo	0
曹缘	cao'yuan	0
曹玥	cao'yue	0
柴彪	chai'biao	0
柴飚	chai'biao	0
炒鸡蛋	chao'ji'dan	0
超级丹	chao'ji'dan	0
陈艾森	chen'ai'sen	0
陈定	chen'ding	0
陈方灿	chen'fang'can	0
陈海威	chen'hai'wei	0
陈洁	chen'jie	0
陈金	chen'jin	0
谌龙	chen'long	0
陈璐怡	chen'lu'yi	0
陈其遒	chen'qi'qiu	0
陈若琳	chen'ruo'lin	0
陈欣怡	chen'xin'yi	0
陈扬	chen'yang	0
陈志宇	chen'zhi'yu	0
程训钊	cheng'xun'zhao	0
崔登荣	cui'deng'rong	0
达米拉诺	da'mi'la'nuo	0
达米耶伊洛桑斯	da'mi'ye'yi'luo'sang'si	0
戴利	dai'li	0
丹羽孝希	dan'yu'xiao'xi	0
德奥多鲁赛区青年体育馆	de'ao'duo'lu'sai'qu'qing'nian'ti'yu'guan	0
德奥多鲁体育中心	de'ao'duo'lu'ti'yu'zhong'xin	0
德蒂	de'di	0
德拉普	de'la'pu	0
邓爱民	deng'ai'min	0
邓书弟	deng'shu'di	0
邓薇	deng'wei	0
蒂奥多罗水上中心	di'ao'duo'luo'shui'shang'zhong'xin	0
蒂奥多罗体育场	di'ao'duo'luo'ti'yu'chang	0
迪拉多	di'la'duo	0
迪特克拉克	di'te'ke'la'ke	0
荻野公介	di'ye'gong'jie	0
丁宁	ding'ning	0
丁霞	ding'xia	0
丁彦雨航	ding'yan'yu'hang	0
董斌	dong'bin	0
董栋	dong'dong	0
董国建	dong'guo'jian	0
董洁	dong'jie	0
董力	dong'li	0
董廷江	dong'ting'jiang	0
杜迪安	du'di'an	0
杜丽	du'li	0
杜兆才	du'zhao'cai	0
多布杰	duo'bu'jie	0
范阿尔韦特	fan'a'er'wei'te	0
范戴克	fan'dai'ke	0
范德博格	fan'de'bo'ge	0
范德布莱根	fan'de'bu'lai'gen	0
范蒂赫特	fan'di'he'te	0
范阳	fan'yang	0
范忆琳	fan'yi'lin	0
菲尔普斯	fei'er'pu'si	0
费利佩阿尔梅达	fei'li'pei'a'er'mei'da	0
菲亚明戈	fei'ya'ming'ge	0
菲鱼	fei'yu	0
冯彬	feng'bin	0
冯树勇	feng'shu'yong	0
福格尔桑	fu'ge'er'sang	0
傅海峰	fu'hai'feng	0
福原爱	fu'yuan'ai	0
傅园慧	fu'yuan'hui	0
高蓓蓓	gao'bei'bei	0
高晨	gao'chen	0
高磊	gao'lei	0
高藤直寿	gao'teng'zhi'shou	0
高兴龙	gao'xing'long	0
高阳	gao'yang	0
高远直久	gao'yuan'zhi'jiu	0
高志丹	gao'zhi'dan	0
格罗夫斯	ge'luo'fu'si	0
葛曼棋	ge'man'qi	0
宫金杰	gong'jin'jie	0
巩立姣	gong'li'jiao	0
龚翔宇	gong'xiang'yu	0
古德菲洛	gu'de'fei'luo	0
顾雪宋	gu'xue'song	0
古雅沙	gu'ya'sha	0
郭艾伦	guo'ai'lun	0
郭磊	guo'lei	0
哈达巴特尔	ha'da'ba'te'er	0
哈尔姆扎耶夫	ha'er'mu'zha'ye'fu	0
海老沼匡	hai'lao'zhao'kuang	0
韩冰岩	han'bing'yan	0
韩建国	han'jian'guo	0
韩鹏	han'peng	0
韩玉成	han'yu'cheng	0
郝佳露	hao'jia'lu	0
何超	he'chao	0
何冲	he'chong	0
何健彬	he'jian'bin	0
何雯娜	he'wen'na	0
何新中	he'xin'zhong	0
何姿	he'zi	0
洪荒少女	hong'huang'shao'nv	0
洪荒之力	hong'huang'zhi'li	0
洪炜	hong'wei	0
洪玮	hong'wei	0
侯雅雯	hou'ya'wen	0
胡建关	hu'jian'guan	0
胡谦逊	hu'qian'xun	0
胡树森	hu'shu'sen	0
胡雅欢	hu'ya'huan	0
胡逸轩	hu'yi'xuan	0
华绍青	hua'shao'qing	0
华天	hua'tian	0
黄博凯	huang'bo'kai	0
黄常洲	huang'chang'zhou	0
黄春荣	huang'chun'rong	0
黄冬艳	huang'dong'yan	0
黄健民	huang'jian'min	0
黄勇	huang'yong	0
黄中华	huang'zhong'hua	0
惠若琪	hui'ruo'qi	0
霍顿	huo'dun	0
火亮	huo'liang	0
霍斯祖	huo'si'zu	0
基尼	ji'ni	0
加尔巴德拉卡	jia'er'ba'de'la'ka	0
贾蕾	jia'lei	0
加林查体育场	jia'lin'cha'ti'yu'chang	0
加罗佐	jia'luo'zuo	0
贾童	jia'tong	0
加西亚	jia'xi'ya	0
焦云龙	jiao'yun'long	0
金浩	jin'hao	0
近藤阿美	jin'teng'a'mei	0
金炜	jin'wei	0
敬亚莉	jing'ya'li	0
卡尔林	ka'er'lin	0
卡里奥卡竞技场	ka'li'ao'ka'jing'ji'chang	0
卡里茨	ka'li'ci	0
卡尼奥托	ka'ni'ao'tuo	0
凯尔曼第	kai'er'man'di	0
坎普里亚尼	kan'pu'li'ya'ni	0
康纳戴尔	kang'na'dai'er	0
克拉卡奇	ke'la'ka'qi	0
科林蒂安竞技场	ke'lin'di'an'jing'ji'chang	0
科林蒂安体育场	ke'lin'di'an'ti'yu'chang	0
科帕卡巴纳堡	ke'pa'ka'ba'na'bao	0
孔令微	kong'ling'wei	0
库利什	ku'li'shen	0
库兹乌缇娜	ku'zi'wu'ti'na	0
拉戈阿体育场	la'ge'a'ti'yu'chang	0
拉格维苏伦	la'ge'wei'su'lun	0
拉希莫夫	la'xi'mo'fu	0
莱德茨基	lai'de'ci'ji	0
莱德基	lai'de'ji	0
濑户大也	lai'hu'da'ye	0
来民	lai'min	0
兰德尔亨廷顿	lan'de'er'heng'ting'dun	0
郎平	lang'ping	0
乐慧林	le'hui'lin	0
勒克洛斯	le'ke'luo'si	0
雷声	lei'sheng	0
李丹	li'dan	0
李冬娜	li'dong'na	0
李根	li'gen	0
李广源	li'guang'yuan	0
李海钢	li'hai'gang	0
李玲	li'ling	0
李玲蔚	li'ling'wei	0
李慕豪	li'mu'hao	0
李频	li'pin	0
李倩	li'qian	0
李强	li'qiang	0
李全意	li'quan'yi	0
李世鑫	li'shi'xin	0
李婷	li'ting	0
李响	li'xiang	0
李小红	li'xiao'hong	0
李晓霞	li'xiao'xia	0
李雪刚	li'xue'gang	0
李雪芮	li'xue'rui	0
李岩	li'yan	0
李影	li'ying	0
李永波	li'yong'bo	0
李悦	li'yue	0
里约奥林匹克体育场	li'yue'ao'lin'pi'ke'ti'yu'chang	0
里约会展中心	li'yue'hui'zhan'zhong'xin	0
里约极限公园	li'yue'ji'xian'gong'yuan	0
里约青年竞技场	li'yue'qing'nian'jing'ji'chang	0
李忠谊	li'zhong'yi	0
李朱濠	li'zhu'hao	0
梁小静	liang'xiao'jing	0
林超攀	lin'chao'pan	0
林丹	lin'dan	0
林慧君	lin'hui'jun	0
林劲	lin'jin	0
林俊红	lin'jun'hong	0
林莉	lin'li	0
林永庆	lin'yong'qing	0
林跃	lin'yue	0
刘爱杰	liu'ai'jie	0
刘传扬	liu'chuan'yang	0
刘海萍	liu'hai'ping	0
刘海涛	liu'hai'tao	0
刘浩	liu'hao	0
刘虹	liu'hong	0
刘蕙瑕	liu'hui'xia	0
刘建勇	liu'jian'yong	0
刘鹏	liu'peng	0
刘杉杉	liu'shan'shan	0
刘诗雯	liu'shi'wen	0
刘诗颖	liu'shi'ying	0
刘婷婷	liu'ting'ting	0
刘伟	liu'wei	0
刘文斌	liu'wen'bin	0
刘希源	liu'xi'yuan	0
刘湘	liu'xiang	0
刘晓彤	liu'xiao'tong	0
柳雅欣	liu'ya'xin	0
刘洋	liu'yang	0
刘永	liu'yong	0
刘咏诗	liu'yong'shi	0
刘兆尘	liu'zhao'chen	0
龙清泉	long'qing'quan	0
娄佳惠	lou'jia'hui	0
陆一帆	lu'yi'fan	0
陆滢	lu'ying	0
罗切特	luo'qie'te	0
罗塞拉弗莱明戈	luo'sai'la'fu'lai'ming'ge	0
罗晓玲	luo'xiao'ling	0
骆赢	luo'ying	0
骆羽	luo'yu	0
罗玉通	luo'yu'tong	0
吕斌	lv'bin	0
吕会会	lv'hui'hui	0
吕其恩	lv'qi'en	0
吕森	lv'sen	0
吕小军	lv'xiao'jun	0
吕秀芝	lv'xiu'zhi	0
马剑飞	ma'jian'fei	0
马晋	ma'jin	0
马拉卡纳体育场	ma'la'ka'na'ti'yu'chang	0
玛丽娜格洛里	ma'li'na'ge'luo'li	0
玛丽亚伦克游泳中心	ma'li'ya'lun'ke'you'yong'zhong'xin	0
马龙	ma'long	0
马梦露	ma'meng'lu	0
玛瑙斯	ma'nao'si	0
马内加林查体育场	ma'nei'jia'lin'cha'ti'yu'chang	0
马青	ma'qing	0
马瑟	ma'se	0
马斯莱尼科夫	ma'si'lai'ni'ke'fu	0
马晓旭	ma'xiao'xu	0
马伊卡	ma'yi'ka	0
马云	ma'yun	0
毛飞廉	mao'fei'lian	0
毛艺	mao'yi	0
茅禕勋	mao'yi'xun	0
么正杰	me'zheng'jie	0
梅丽	mei'li	0
米勒	mi'le	0
米内罗体育场	mi'nei'luo'ti'yu'chang	0
默菲	mo'fei	0
莫妮卡卡斯奇	mo'ni'ka'ka'si'qi	0
莫有雪	mo'you'xue	0
穆德拉诺夫	mu'de'la'nuo'fu	0
纳西莫夫	na'xi'mo'fu	0
宁泽涛	ning'ze'tao	0
欧喜元	ou'xi'yuan	0
帕雷托	pa'lei'tuo	0
庞丰月	pang'feng'yue	0
庞伟	pang'wei	0
佩列洛	pei'lie'luo	0
蓬塔尔	peng'ta'er	0
蓬塔尔海滩	peng'ta'er'hai'tan	0
皮蒂	pi'di	0
普卢默	pu'lu'mo	0
朴尚永	pu'shang'yong	0
齐玉红	qi'yu'hong	0
切阳什姐	qie'yang'shen'jie	0
秦晨路	qin'chen'lu	0
秦凯	qin'kai	0
邱波	qiu'bo	0
邱子傲	qiu'zi'ao	0
任灿灿	ren'can'can	0
任梦茜	ren'meng'qian	0
任文君	ren'wen'jun	0
萨尔瓦多	sa'er'wa'duo	0
萨芬	sa'fen	0
三宅宏实	san'zhai'hong'shi	0
森巴竞技场	sen'ba'jing'ji'chang	0
沙超	sha'chao	0
沙夫达图阿什维利	sha'fu'da'tu'a'shi'wei'li	0
山俊	shan'jun	0
商春松	shang'chun'song	0
商科元	shang'ke'yuan	0
尚蓉	shang'rong	0
邵小军	shao'xiao'jun	0
舍斯特伦	she'si'te'lun	0
沈晨	shen'chen	0
沈铎	shen'duo	0
沈惠	shen'hui	0
沈洁	shen'jie	0
沈平安	shen'ping'an	0
施嘉洛	shi'jia'luo	0
史婧琳	shi'jing'lin	0
史密斯	shi'mi'si	0
施廷懋	shi'ting'mao	0
石智勇	shi'zhi'yong	0
舒思瑶	shu'si'yao	0
斯金纳	si'jin'na	0
司俊	si'jun	0
斯密斯	si'mi'si	0
斯密托夫	si'mi'tuo'fu	0
斯米托夫	si'mi'tuo'fu	0
斯约斯特罗姆	si'yue'si'te'luo'mu	0
苏炳添	su'bing'tian	0
苏拉特	su'la'te	0
苏欣悦	su'xin'yue	0
睢冉	sui'ran	0
孙海平	sun'hai'ping	0
孙荔安	sun'li'an	0
孙美晨	sun'mei'chen	0
孙伟	sun'wei	0
孙学才	sun'xue'cai	0
孙杨	sun'yang	0
孙一文	sun'yi'wen	0
孙玉洁	sun'yu'jie	0
孙知亦	sun'zhi'yi	0
索比罗夫	suo'bi'luo'fu	0
塔娜桑	ta'na'sang	0
塔纳桑	ta'na'sang	0
谭佳薪	tan'jia'xin	0
谭茹殷	tan'ru'yin	0
唐功臣	tang'gong'chen	0
汤星强	tang'xing'qiang	0
唐奕	tang'yi	0
唐雨婷	tang'yu'ting	0
唐渊渟	tang'yuan'ting	0
特尔斯泰尼亚克	te'er'si'tai'ni'ya'ke	0
田秉毅	tian'bing'yi	0
田渝陵	tian'yu'ling	0
王博	wang'bo	0
王博清	wang'bo'qing	0
王春雨	wang'chun'yu	0
王大鹏	wang'da'peng	0
王峰	wang'feng	0
王鸽	wang'ge	0
汪皓	wang'hao	0
王红	wang'hong	0
王嘉男	wang'jia'nan	0
王健全	wang'jian'quan	0
王凯华	wang'kai'hua	0
王路生	wang'lu'sheng	0
王楠	wang'nan	0
王日炜	wang'ri'wei	0
王珊珊	wang'shan'shan	0
王施佳	wang'shi'jia	0
王霜	wang'shuang	0
汪顺	wang'shun	0
王卫东	wang'wei'dong	0
王晓寅	wang'xiao'yin	0
王鑫	wang'xin	0
王宣庆	wang'xuan'qing	0
汪雪儿	wang'xue'er	0
王妍	wang'yan	0
王焱	wang'yan	0
王仪涵	wang'yi'han	0
王宇	wang'yu	0
王禹平	wang'yu'ping	0
王哲林	wang'zhe'lin	0
王祯	wang'zhen	0
王镇	wang'zhen	0
王振东	wang'zhen'dong	0
王峥	wang'zheng	0
王智伟	wang'zhi'wei	0
魏代顺	wei'dai'shun	0
魏秋月	wei'qiu'yue	0
维思拉舍	wei'si'la'she	0
魏新翼	wei'xin'yi	0
韦永丽	wei'yong'li	0
魏峥	wei'zheng	0
温文	wen'wen	0
沃尔默	wo'er'mo	0
沃斯	wo'si	0
吴海燕	wu'hai'yan	0
吴佳欣	wu'jia'xin	0
乌洛兹波夫	wu'luo'zi'bo'fu	0
乌罗兹博耶夫	wu'luo'zi'bo'ye'fu	0
吴敏霞	wu'min'xia	0
吴水娇	wu'shui'jiao	0
乌维霍恩	wu'wei'huo'en	0
邬伟培	wu'wei'pei	0
吴宇航	wu'yu'hang	0
席尔瓦	xi'er'wa	0
夏煊泽	xia'xuan'ze	0
向艳梅	xiang'yan'mei	0
肖恩	xiao'en	0
肖艳玲	xiao'yan'ling	0
小野	xiao'ye	0
谢敏豪	xie'min'hao	0
谢文骏	xie'wen'jun	0
谢震业	xie'zhen'ye	0
新水源竞技场	xin'shui'yuan'jing'ji'chang	0
新水源体育场	xin'shui'yuan'ti'yu'chang	0
辛鑫	xin'xin	0
邢宇	xing'yu	0
许安琪	xu'an'qi	0
徐超	xu'chao	0
徐晨	xu'chen	0
许国君	xu'guo'jun	0
徐国义	xu'guo'yi	0
徐嘉余	xu'jia'yu	0
徐莉佳	xu'li'jia	0
徐平	xu'ping	0
许琦	xu'qi	0
许淑净	xu'shu'jing	0
徐晓龙	xu'xiao'long	0
许学宁	xu'xue'ning	0
徐英明	xu'ying'ming	0
徐云丽	xu'yun'li	0
薛长锐	xue'chang'rui	0
薛超华	xue'chao'hua	0
薛嬌	xue'jiao	0
亚历山大	ya'li'shan'da	0
亚马逊竞技场	ya'ma'xun'jing'ji'chang	0
亚马逊体育馆	ya'ma'xun'ti'yu'guan	0
颜妮	yan'ni	0
盐浦慎理	yan'pu'shen'li	0
闫子贝	yan'zi'bei	0
杨方旭	yang'fang'xu	0
杨家玉	yang'jia'yu	0
杨丽	yang'li	0
杨曼	yang'man	0
杨善德	yang'shan'de	0
杨树安	yang'shu'an	0
杨晓强	yang'xiao'qiang	0
杨洋	yang'yang	0
杨晔	yang'ye	0
杨战旗	yang'zhan'qi	0
姚捷	yao'jie	0
姚平	yao'ping	0
叶冲	ye'chong	0
叶瑾	ye'jin	0
叶奎刚	ye'kui'gang	0
叶诗文	ye'shi'wen	0
易建联	yi'jian'lian	0
易思玲	yi'si'ling	0
尹军花	yin'jun'hua	0
尤浩	you'hao	0
于丰铠	yu'feng'kai	0
余贺新	yu'he'xin	0
于洪臣	yu'hong'chen	0
于静瑶	yu'jing'yao	0
余隆基	yu'long'ji	0
于伟	yu'wei	0
于洋	yu'yang	0
于垚辰	yu'yao'chen	0
袁国强	yuan'guo'qiang	0
袁琦琦	yuan'qi'qi	0
袁守龙	yuan'shou'long	0
袁心玥	yuan'xin'yue	0
岳超	yue'chao	0
约翰森	yue'han'sen	0
约塞普格拉斯诺维奇	yue'sai'pu'ge'la'si'nuo'wei'qi	0
藏獒张	zang'ao'zhang	0
翟晓川	zhai'xiao'chuan	0
占旭刚	zhan'xu'gang	0
张常宁	zhang'chang'ning	0
张成龙	zhang'cheng'long	0
张阜新	zhang'fu'xin	0
张国伟	zhang'guo'wei	0
张航	zhang'hang	0
张红真	zhang'hong'zhen	0
张继科	zhang'ji'ke	0
张家玮	zhang'jia'wei	0
张建华	zhang'jian'hua	0
张劲戈	zhang'jin'ge	0
张靖婧	zhang'jing'jing	0
张军	zhang'jun	0
张乐伟	zhang'le'wei	0
张玲	zhang'ling	0
张梦雪	zhang'meng'xue	0
张楠	zhang'nan	0
张培萌	zhang'pei'meng	0
张麒斌	zhang'qi'bin	0
张睿	zhang'rui	0
张松林	zhang'song'lin	0
张文秀	zhang'wen'xiu	0
张新	zhang'xin	0
张新华	zhang'xin'hua	0
张新艳	zhang'xin'yan	0
张馨予	zhang'xin'yu	0
张亚东	zhang'ya'dong	0
张雁	zhang'yan	0
张雁全	zhang'yan'quan	0
张怡宁	zhang'yi'ning	0
张雨霏	zhang'yu'fei	0
张雨涵	zhang'yu'han	0
张越	zhang'yue	0
赵宝芳	zhao'bao'fang	0
赵继伟	zhao'ji'wei	0
赵敬楠	zhao'jing'nan	0
赵丽娜	zhao'li'na	0
赵明刚	zhao'ming'gang	0
赵容	zhao'rong	0
赵云蕾	zhao'yun'lei	0
赵芸蕾	zhao'yun'lei	0
郑宝京	zheng'bao'jing	0
钟波	zhong'bo	0
中村美里	zhong'cun'mei'li	0
钟天使	zhong'tian'shi	0
周继红	zhou'ji'hong	0
周吕鑫	zhou'lv'xin	0
周敏	zhou'min	0
周鹏	zhou'peng	0
周琦	zhou'qi	0
周铁民	zhou'tie'min	0
周伟	zhou'wei	0
周羿霖	zhou'yi'lin	0
周玉	zhou'yu	0
朱弗里达	zhu'fu'li'da	0
朱梦惠	zhu'meng'hui	0
朱仁学	zhu'ren'xue	0
朱婷	zhu'ting	0
朱雨玲	zhu'yu'ling	0
朱志根	zhu'zhi'gen	0
朱志伟	zhu'zhi'wei	0
邹雨宸	zou'yu'chen	0
祖立军	zu'li'jun	0
