按钮开关	an'niu'kai'guan	0
伴热设备	ban're'she'bei	0
薄膜开关	bao'mo'kai'guan	0
变频器	bian'pin'qi	0
拨动开关	bo'dong'kai'guan	0
波段开关	bo'duan'kai'guan	0
补偿装置	bu'chang'zhuang'zhi	0
插头	cha'tou	0
插座	cha'zuo	0
柴油发电机组	chai'you'fa'dian'ji'zu	0
充电电池	chong'dian'dian'chi	0
充电机	chong'dian'ji	0
充电器	chong'dian'qi	0
冲击钻	chong'ji'zuan	0
触控产品	chu'kong'chan'pin	0
传感器	chuan'gan'qi	0
船型开关	chuan'xing'kai'guan	0
伺服定位系统	ci'fu'ding'wei'xi'tong	0
刀开关	dao'kai'guan	0
倒顺开关	dao'shun'kai'guan	0
低压电器	di'ya'dian'qi	0
低压断路器	di'ya'duan'lu'qi	0
低压接触器	di'ya'jie'chu'qi	0
低压开关柜	di'ya'kai'guan'gui	0
低压控制器	di'ya'kong'zhi'qi	0
低压熔断器	di'ya'rong'duan'qi	0
电刨	dian'bao	0
电池	dian'chi	0
电池充电器	dian'chi'chong'dian'qi	0
电池组配件	dian'chi'zu'pei'jian	0
电锤	dian'chui	0
电磁铁	dian'ci'tie	0
电磁线	dian'ci'xian	0
电动扳手	dian'dong'ban'shou	0
电动车充电器	dian'dong'che'chong'dian'qi	0
电动车用电动机	dian'dong'che'yong'dian'dong'ji	0
电动雕刻机	dian'dong'diao'ke'ji	0
电动工具	dian'dong'gong'ju	0
电动工具开关	dian'dong'gong'ju'kai'guan	0
电动工具用电动机	dian'dong'gong'ju'yong'dian'dong'ji	0
电动机	dian'dong'ji	0
电动机保护器	dian'dong'ji'bao'hu'qi	0
电动螺丝刀	dian'dong'luo'si'dao	0
电动坡口机	dian'dong'po'kou'ji	0
电动砂轮机	dian'dong'sha'lun'ji	0
电动套丝机	dian'dong'tao'si'ji	0
电工电气产品代理	dian'gong'dian'qi'chan'pin'dai'li	0
电工电气产品加工	dian'gong'dian'qi'chan'pin'jia'gong	0
电工电气项目合作	dian'gong'dian'qi'xiang'mu'he'zuo	0
电工胶带	dian'gong'jiao'dai	0
电工设备	dian'gong'she'bei	0
电工仪器仪表	dian'gong'yi'qi'yi'biao	0
电焊钳	dian'han'qian	0
电剪刀	dian'jian'dao	0
电锯	dian'ju	0
电抗器	dian'kang'qi	0
电缆	dian'lan	0
电缆连接器	dian'lan'lian'jie'qi	0
电力电缆	dian'li'dian'lan	0
电流测量仪表	dian'liu'ce'liang'yi'biao	0
电流互感器	dian'liu'hu'gan'qi	0
电磨	dian'mo	0
电脑连接器	dian'nao'lian'jie'qi	0
电能仪表	dian'neng'yi'biao	0
电气设备用电缆	dian'qi'she'bei'yong'dian'lan	0
电桥	dian'qiao	0
电热板	dian're'ban	0
电热带	dian're'dai	0
电热管	dian're'guan	0
电热膜	dian're'mo	0
电热盘	dian're'pan	0
电热片	dian're'pian	0
电热器	dian're'qi	0
电热圈	dian're'quan	0
电热设备	dian're'she'bei	0
电热丝	dian're'si	0
电热线	dian're'xian	0
电视天线	dian'shi'tian'xian	0
电刷	dian'shua	0
电位差计	dian'wei'cha'ji	0
电线	dian'xian	0
电压测量仪表	dian'ya'ce'liang'yi'biao	0
电压互感器	dian'ya'hu'gan'qi	0
电源柜	dian'yuan'gui	0
电源连接器	dian'yuan'lian'jie'qi	0
电子工业用助剂	dian'zi'gong'ye'yong'zhu'ji	0
电阻测量仪表	dian'zu'ce'liang'yi'biao	0
电阻箱	dian'zu'xiang	0
电钻	dian'zuan	0
端子	duan'zi	0
端子台	duan'zi'tai	0
鳄鱼夹	e'yu'jia	0
二手电工电气产品	er'shou'dian'gong'dian'qi'chan'pin	0
发电机	fa'dian'ji	0
发电机组	fa'dian'ji'zu	0
发电机组零部件	fa'dian'ji'zu'ling'bu'jian	0
发热管	fa're'guan	0
发热盘	fa're'pan	0
发热芯	fa're'xin	0
防静电产品	fang'jing'dian'chan'pin	0
防静电工具	fang'jing'dian'gong'ju	0
防静电用品	fang'jing'dian'yong'pin	0
防雷避雷产品	fang'lei'bi'lei'chan'pin	0
风力发电机组	feng'li'fa'dian'ji'zu	0
负荷开关	fu'he'kai'guan	0
浮球开关	fu'qiu'kai'guan	0
干电池	gan'dian'chi	0
高压成套电器	gao'ya'cheng'tao'dian'qi	0
高压电器	gao'ya'dian'qi	0
高压断路器	gao'ya'duan'lu'qi	0
高压接触器	gao'ya'jie'chu'qi	0
高压开关柜	gao'ya'kai'guan'gui	0
高压熔断器	gao'ya'rong'duan'qi	0
割炬	ge'ju	0
隔离开关	ge'li'kai'guan	0
工控系统及装备	gong'kong'xi'tong'ji'zhuang'bei	0
功率测量仪表	gong'lv'ce'liang'yi'biao	0
工业电炉	gong'ye'dian'lu	0
工业电气	gong'ye'dian'qi	0
工业计时器	gong'ye'ji'shi'qi	0
工业烤箱	gong'ye'kao'xiang	0
光电池	guang'dian'chi	0
光电开关	guang'dian'kai'guan	0
光饰机	guang'shi'ji	0
光纤连接器	guang'xian'lian'jie'qi	0
硅碳棒	gui'tan'bang	0
焊接材料与附件	han'jie'cai'liao'yu'fu'jian	0
焊炬	han'ju	0
焊条	han'tiao	0
焊锡丝	han'xi'si	0
继电器	ji'dian'qi	0
机械设备用电动机	ji'xie'she'bei'yong'dian'dong'ji	0
家电用电动机	jia'dian'yong'dian'dong'ji	0
角磨机	jiao'mo'ji	0
脚踏开关	jiao'ta'kai'guan	0
节电设备	jie'dian'she'bei	0
接近开关	jie'jin'kai'guan	0
接线板	jie'xian'ban	0
接线柱	jie'xian'zhu	0
接线座	jie'xian'zuo	0
矩形连接器	ju'xing'lian'jie'qi	0
绝缘板	jue'yuan'ban	0
绝缘材料	jue'yuan'cai'liao	0
绝缘带	jue'yuan'dai	0
绝缘导线	jue'yuan'dao'xian	0
绝缘垫片	jue'yuan'dian'pian	0
绝缘隔离柱	jue'yuan'ge'li'zhu	0
绝缘套管	jue'yuan'tao'guan	0
绝缘子	jue'yuan'zi	0
卡座	ka'zuo	0
开关	kai'guan	0
开关电源	kai'guan'dian'yuan	0
库存电工电气产品	ku'cun'dian'gong'dian'qi'chan'pin	0
烙铁咀	lao'tie'ju	0
烙铁头	lao'tie'tou	0
锂电池	li'dian'chi	0
离子风棒	li'zi'feng'bang	0
离子风机	li'zi'feng'ji	0
离子风枪	li'zi'feng'qiang	0
连接器	lian'jie'qi	0
两极电源插头	liang'ji'dian'yuan'cha'tou	0
两极电源插座	liang'ji'dian'yuan'cha'zuo	0
流量开关	liu'liang'kai'guan	0
裸电线	luo'dian'xian	0
磨光机	mo'guang'ji	0
磨抛光电动工具	mo'pao'guang'dian'dong'gong'ju	0
木工雕刻机	mu'gong'diao'ke'ji	0
木工修边机	mu'gong'xiu'bian'ji	0
镍镉电池	nie'ge'dian'chi	0
镍氢电池	nie'qing'dian'chi	0
纽扣电池	niu'kou'dian'chi	0
钮子开关	niu'zi'kai'guan	0
排母	pai'mu	0
排针	pai'zhen	0
抛光机	pao'guang'ji	0
配电变压器	pei'dian'bian'ya'qi	0
配电柜	pei'dian'gui	0
配电盘	pei'dian'pan	0
配电屏	pei'dian'ping	0
配电器	pei'dian'qi	0
配电输电设备	pei'dian'shu'dian'she'bei	0
配电箱	pei'dian'xiang	0
频率测量仪表	pin'lv'ce'liang'yi'biao	0
汽车连接器	qi'che'lian'jie'qi	0
汽车天线	qi'che'tian'xian	0
起动器	qi'dong'qi	0
其他插头	qi'ta'cha'tou	0
其他插座	qi'ta'cha'zuo	0
其他充电器	qi'ta'chong'dian'qi	0
其他低压电器	qi'ta'di'ya'dian'qi	0
其他电池	qi'ta'dian'chi	0
其他电动机	qi'ta'dian'dong'ji	0
其他电工仪器仪表	qi'ta'dian'gong'yi'qi'yi'biao	0
其他电热设备	qi'ta'dian're'she'bei	0
其他电线	qi'ta'dian'xian	0
其他发电机	qi'ta'fa'dian'ji	0
其他防静电产品	qi'ta'fang'jing'dian'chan'pin	0
其他高压电器	qi'ta'gao'ya'dian'qi	0
其他工控系统及装备	qi'ta'gong'kong'xi'tong'ji'zhuang'bei	0
其他焊接材料与附件	qi'ta'han'jie'cai'liao'yu'fu'jian	0
其他绝缘材料	qi'ta'jue'yuan'cai'liao	0
其他开关	qi'ta'kai'guan	0
其他连接器	qi'ta'lian'jie'qi	0
其他磨抛光电动工具	qi'ta'mo'pao'guang'dian'dong'gong'ju	0
其他配电输电设备	qi'ta'pei'dian'shu'dian'she'bei	0
其他切削电动工具	qi'ta'qie'xiao'dian'dong'gong'ju	0
其他天线	qi'ta'tian'xian	0
其他装配电动工具	qi'ta'zhuang'pei'dian'dong'gong'ju	0
汽油发电机组	qi'you'fa'dian'ji'zu	0
钳型表	qian'xing'biao	0
墙壁开关	qiang'bi'kai'guan	0
桥架	qiao'jia	0
切削电动工具	qie'xiao'dian'dong'gong'ju	0
燃料电池	ran'liao'dian'chi	0
燃煤发电机组	ran'mei'fa'dian'ji'zu	0
燃气发电机组	ran'qi'fa'dian'ji'zu	0
热电偶	re'dian'ou	0
热电阻	re'dian'zu	0
人机界面	ren'ji'jie'mian	0
熔锡炉	rong'xi'lu	0
三极电源插头	san'ji'dian'yuan'cha'tou	0
三极电源插座	san'ji'dian'yuan'cha'zuo	0
砂带机	sha'dai'ji	0
砂光机	sha'guang'ji	0
射频同轴连接器	she'pin'tong'zhou'lian'jie'qi	0
石材切割机	shi'cai'qie'ge'ji	0
视频插头	shi'pin'cha'tou	0
视频插座	shi'pin'cha'zuo	0
视频连接器	shi'pin'lian'jie'qi	0
视频线	shi'pin'xian	0
实验电炉	shi'yan'dian'lu	0
手机充电器	shou'ji'chong'dian'qi	0
手机电池	shou'ji'dian'chi	0
手机连接器	shou'ji'lian'jie'qi	0
手机天线	shou'ji'tian'xian	0
收音机天线	shou'yin'ji'tian'xian	0
水晶头	shui'jing'tou	0
水力发电机组	shui'li'fa'dian'ji'zu	0
太阳能电池	tai'yang'neng'dian'chi	0
太阳能发电机组	tai'yang'neng'fa'dian'ji'zu	0
台钻	tai'zuan	0
碳刷	tan'shua	0
套装电动工具	tao'zhuang'dian'dong'gong'ju	0
特殊电机	te'shu'dian'ji	0
天线	tian'xian	0
调速开关	tiao'su'kai'guan	0
条形连接器	tiao'xing'lian'jie'qi	0
同步发电机	tong'bu'fa'dian'ji	0
通信天线	tong'xin'tian'xian	0
通讯电缆	tong'xun'dian'lan	0
万用表	wan'yong'biao	0
微动开关	wei'dong'kai'guan	0
微型电动机	wei'xing'dian'dong'ji	0
卫星天线	wei'xing'tian'xian	0
温度控制调节器	wen'du'kong'zhi'tiao'jie'qi	0
温控开关	wen'kong'kai'guan	0
线槽	xian'cao	0
线束	xian'shu	0
限位开关	xian'wei'kai'guan	0
箱式变电站	xiang'shi'bian'dian'zhan	0
型材切割机	xing'cai'qie'ge'ji	0
行程开关	xing'cheng'kai'guan	0
蓄电池	xu'dian'chi	0
旋转开关	xuan'zhuan'kai'guan	0
压力开关	ya'li'kai'guan	0
遥控开关	yao'kong'kai'guan	0
异步发电机	yi'bu'fa'dian'ji	0
音频	yin'pin	0
音频线	yin'pin'xian	0
印刷板连接器	yin'shua'ban'lian'jie'qi	0
应急充电器	ying'ji'chong'dian'qi	0
圆形连接器	yuan'xing'lian'jie'qi	0
云母片	yun'mu'pian	0
振动盘	zhen'dong'pan	0
中频电源	zhong'pin'dian'yuan	0
主令电器	zhu'ling'dian'qi	0
转换插座	zhuan'huan'cha'zuo	0
转换开关	zhuan'huan'kai'guan	0
装配电动工具	zhuang'pei'dian'dong'gong'ju	0
组合开关	zu'he'kai'guan	0
座钻	zuo'zuan	0
