爱的呼唤	ai'de'hu'huan	0
爱你	ai'ni	0
爱如意	ai'ru'yi	0
爱现在的我	ai'xian'zai'de'wo	0
北京北京	bei'jing'bei'jing	0
背叛	bei'pan	0
别勉强	bie'mian'qiang	0
不存在的存在	bu'cun'zai'de'cun'zai	0
曹操	cao'cao	0
差不多的姑娘	cha'bu'duo'de'gu'niang	0
超能力	chao'neng'li	0
穿越火线	chuan'yue'huo'xian	0
春天里	chun'tian'li	0
存在	cun'zai	0
错过不错	cuo'guo'bu'cuo	0
单行的轨道	dan'xing'de'gui'dao	0
刀马旦	dao'ma'dan	0
倒数	dao'shu	0
等一个他	deng'yi'ge'ta	0
蝶恋花	die'lian'hua	0
毒苹果	du'ping'guo	0
多美丽	duo'mei'li	0
多远都要在一起	duo'yuan'dou'yao'zai'yi'qi	0
给你的歌	gei'ni'de'ge	0
孤独	gu'du	0
故乡的云	gu'xiang'de'yun	0
光年之外	guang'nian'zhi'wai	0
好想好想你	hao'xiang'hao'xiang'ni	0
很久以后	hen'jiu'yi'hou	0
红蔷薇白玫瑰	hong'qiang'wei'bai'mei'gui	0
后会无期	hou'hui'wu'qi	0
灰狼	hui'lang	0
回忆的沙漏	hui'yi'de'sha'lou	0
寂寞星球的玫瑰	ji'mo'xing'qiu'de'mei'gui	0
句号	ju'hao	0
来自天堂的魔鬼	lai'zi'tian'tang'de'mo'gui	0
另一个童话	ling'yi'ge'tong'hua	0
龙卷风	long'juan'feng	0
漫步人生路	man'bu'ren'sheng'lu	0
盲点	mang'dian	0
摩天动物园	mo'tian'dong'wu'yuan	0
那一夜	na'yi'ye	0
你把我灌醉	ni'ba'wo'guan'zui	0
你不是真正的快乐	ni'bu'shi'zhen'zheng'de'kuai'le	0
偶尔	ou'er	0
攀登	pan'deng	0
泡沫	pao'mo	0
朋友	peng'you	0
飘向北方	piao'xiang'bei'fang	0
平凡天使	ping'fan'tian'shi	0
平行世界	ping'xing'shi'jie	0
奇迹	qi'ji	0
情人	qing'ren	0
囚鸟	qiu'niao	0
热爱就一起	re'ai'jiu'yi'qi	0
如果没有你	ru'guo'mei'you'ni	0
盛夏光年	sheng'xia'guang'nian	0
是否	shi'fou	0
失恋无罪	shi'lian'wu'zui	0
手心的蔷薇	shou'xin'de'qiang'wei	0
睡公主	shui'gong'zhu	0
睡皇后	shui'huang'hou	0
瞬间	shun'jian	0
死了都要爱	si'le'dou'yao'ai	0
忐忑	tan'te	0
桃花诺	tao'hua'nuo	0
听海	ting'hai	0
透明	tou'ming	0
突然之间	tu'ran'zhi'jian	0
蜕变	tui'bian	0
万国觉醒	wan'guo'jue'xing	0
我不懂爱	wo'bu'dong'ai	0
我的秘密	wo'de'mi'mi	0
我们的爱	wo'men'de'ai	0
我说了算	wo'shuo'le'suan	0
我要我们在一起	wo'yao'wo'men'zai'yi'qi	0
喜欢你	xi'huan'ni	0
下一秒	xia'yi'miao	0
想讲你知	xiang'jiang'ni'zhi	0
笑看风云	xiao'kan'feng'yun	0
写不完的温柔	xie'bu'wan'de'wen'rou	0
新的心跳	xin'de'xin'tiao	0
心之焰	xin'zhi'yan	0
叙世	xu'shi	0
亚里亚蒂之歌	ya'li'ya'di'zhi'ge	0
岩石里的花	yan'shi'li'de'hua	0
夜空中最亮的星	ye'kong'zhong'zui'liang'de'xing	0
驿动的心	yi'dong'de'xin	0
一路逆风	yi'lu'ni'feng	0
依然睡公主	yi'ran'shui'gong'zhu	0
萤火	ying'huo	0
有多少爱可以重来	you'duo'shao'ai'ke'yi'chong'lai	0
有心人	you'xin'ren	0
雨蝶	yu'die	0
于是	yu'shi	0
原谅我不懂爱	yuan'liang'wo'bu'dong'ai	0
再见	zai'jian	0
真的英雄	zhen'de'ying'xiong	0
制作人	zhi'zuo'ren	0
