阿里图列	a'li'tu'lie	0
澳玛克思旗舰店	ao'ma'ke'si'qi'jian'dian	0
宝贝动态	bao'bei'dong'tai	0
宝贝分类管理	bao'bei'fen'lei'guan'li	0
宝贝管理	bao'bei'guan'li	0
菜鸟智能发货	cai'niao'zhi'neng'fa'huo	0
仓储管理	cang'chu'guan'li	0
仓库中的宝贝	cang'ku'zhong'de'bao'bei	0
查看淘宝店铺	cha'kan'tao'bao'dian'pu	0
车图	che'tu	0
橱窗推荐	chu'chuang'tui'jian	0
出售中的宝贝	chu'shou'zhong'de'bao'bei	0
店铺管理	dian'pu'guan'li	0
店铺过户	dian'pu'guo'hu	0
店铺基本设置	dian'pu'ji'ben'she'zhi	0
店铺经营许可	dian'pu'jing'ying'xu'ke	0
店铺品质管理	dian'pu'pin'zhi'guan'li	0
店铺升级	dian'pu'sheng'ji	0
店铺营销工具	dian'pu'ying'xiao'gong'ju	0
店铺云课堂	dian'pu'yun'ke'tang	0
店铺装修	dian'pu'zhuang'xiu	0
电子面单平台	dian'zi'mian'dan'ping'tai	0
定制服务	ding'zhi'fu'wu	0
发布宝贝	fa'bu'bao'bei	0
发货物流	fa'huo'wu'liu	0
分期管理	fen'qi'guan'li	0
分销管理	fen'xiao'guan'li	0
工具物流服务	gong'ju'wu'liu'fu'wu	0
购后链路	gou'hou'lian'lu	0
谷格旗舰店	gu'ge'qi'jian'dian	0
规蜜	gui'mi	0
还款	huan'kuan	0
活动报名	huo'dong'bao'ming	0
货源中心	huo'yuan'zhong'xin	0
基金	ji'jin	0
记录品牌查询	ji'lu'pin'pai'cha'xun	0
加价	jia'jia	0
加热破壁料理机	jia're'po'bi'liao'li'ji	0
交易管理	jiao'yi'guan'li	0
净化器	jing'hua'qi	0
竞争情报	jing'zheng'qing'bao	0
举报管理	ju'bao'guan'li	0
客户服务	ke'hu'fu'wu	0
客户运营平台	ke'hu'yun'ying'ping'tai	0
历史宝贝	li'shi'bao'bei	0
料理机	liao'li'ji	0
流量纵横	liu'liang'zong'heng	0
买家秀	mai'jia'xiu	0
农村淘宝签约	nong'cun'tao'bao'qian'yue	0
拼团	pin'tuan	0
评价管理	ping'jia'guan'li	0
破壁机	po'bi'ji	0
全自动	quan'zi'dong	0
软件服务	ruan'jian'fu'wu	0
商家保障	shang'jia'bao'zhang	0
商家短视频	shang'jia'duan'shi'pin	0
商家公益	shang'jia'gong'yi	0
商家素材中心	shang'jia'su'cai'zhong'xin	0
商家学院	shang'jia'xue'yuan	0
商品分析	shang'pin'fen'xi	0
上下架	shang'xia'jia	0
摄影服务	she'ying'fu'wu	0
申诉中心	shen'su'zhong'xin	0
生意参谋	sheng'yi'can'mou	0
市场行情	shi'chang'hang'qing	0
试用	shi'yong	0
手机淘宝店铺	shou'ji'tao'bao'dian'pu	0
数据学院	shu'ju'xue'yuan	0
数据中心	shu'ju'zhong'xin	0
数据作战室	shu'ju'zuo'zhan'shi	0
速卖通签约	su'mai'tong'qian'yue	0
淘宝	tao'bao	0
淘宝贷款	tao'bao'dai'kuan	0
淘宝服务	tao'bao'fu'wu	0
淘宝群	tao'bao'qun	0
淘宝认证	tao'bao'ren'zheng	0
淘宝直播	tao'bao'zhi'bo	0
淘金币	tao'jin'bi	0
淘客	tao'ke	0
淘抢购	tao'qiang'gou	0
体检中心	ti'jian'zhong'xin	0
提前收款	ti'qian'shou'kuan	0
天天特价	tian'tian'te'jia	0
投诉管理	tou'su'guan'li	0
图片空间	tu'pian'kong'jian	0
推广	tui'guang	0
退款管理	tui'kuan'guan'li	0
旺店宝	wang'dian'bao	0
违规记录	wei'gui'ji'lu	0
微淘内容管理	wei'tao'nei'rong'guan'li	0
问商友	wen'shang'you	0
我的产品库	wo'de'chan'pin'ku	0
我要订购	wo'yao'ding'gou	0
我要寄快递	wo'yao'ji'kuai'di	0
我要开票	wo'yao'kai'piao	0
我要推广	wo'yao'tui'guang	0
物流管理	wu'liu'guan'li	0
详情装修	xiang'qing'zhuang'xiu	0
消费者保障服务	xiao'fei'zhe'bao'zhang'fu'wu	0
业务专区	ye'wu'zhuan'qu	0
已卖出的宝贝	yi'mai'chu'de'bao'bei	0
音乐服务	yin'yue'fu'wu	0
营销中心	ying'xiao'zhong'xin	0
域名设置	yu'ming'she'zhi	0
原创保护	yuan'chuang'bao'hu	0
账房	zhang'fang	0
掌柜信用	zhang'gui'xin'yong	0
知识产权	zhi'shi'chan'quan	0
直通车	zhi'tong'che	0
众筹管理	zhong'chou'guan'li	0
转化率	zhuan'hua'lv	0
自动化运营	zi'dong'hua'yun'ying	0
自运营中心	zi'yun'ying'zhong'xin	0
子账号管理	zi'zhang'hao'guan'li	0
资质认证	zi'zhi'ren'zheng	0
钻图	zuan'tu	0
钻展	zuan'zhan	0
