阿鼻元珠	a'bi'yuan'zhu	0
阿怛含婆	a'da'han'po	0
阿尔卑斯	a'er'bei'si	0
阿鬟	a'huan	0
阿难剑	a'nan'jian	0
阿阇修利罗	a'she'xiu'li'luo	0
阿童	a'tong	0
阿屠钩	a'tu'gou	0
爱侣	ai'lv	0
矮叟	ai'sou	0
安乐岛	an'le'dao	0
庵主	an'zhu	0
八部天龙宝藏	ba'bu'tian'long'bao'zang	0
八反教	ba'fan'jiao	0
八姑	ba'gu	0
八卦玄门剑	ba'gua'xuan'men'jian	0
八魔	ba'mo	0
八手观音	ba'shou'guan'yin	0
百宝如意纯阳转心锁	bai'bao'ru'yi'chun'yang'zhuan'xin'suo	0
百草阳灵膏	bai'cao'yang'ling'gao	0
百毒金蚕蛊	bai'du'jin'can'gu	0
百毒烟岚连珠飞弩	bai'du'yan'lan'lian'zhu'fei'nu	0
白发龙女	bai'fa'long'nv	0
白骨禅师	bai'gu'chan'shi	0
白骨丧门箭	bai'gu'sang'men'jian	0
白骨神君	bai'gu'shen'jun	0
白骨神魔	bai'gu'shen'mo	0
白骨搜魂网	bai'gu'sou'hun'wang	0
白骨锁魂香	bai'gu'suo'hun'xiang	0
白骨锁心锤	bai'gu'suo'xin'chui	0
白谷逸	bai'gu'yi	0
白鬼脸	bai'gui'lian	0
白虹	bai'hong	0
白虹岛	bai'hong'dao	0
白虹钩	bai'hong'gou	0
百花岛	bai'hua'dao	0
百花仙	bai'hua'xian	0
白缙	bai'jin	0
白癞	bai'lai	0
百灵冲	bai'ling'chong	0
白菱礁	bai'ling'jiao	0
百灵斩仙剑	bai'ling'zhan'xian'jian	0
白龙庵	bai'long'an	0
白龙钩	bai'long'gou	0
白鹿洞	bai'lu'dong	0
白马坡	bai'ma'po	0
百蛮山	bai'man'shan	0
白眉	bai'mei	0
白眉禅师	bai'mei'chan'shi	0
白眉针	bai'mei'zhen	0
白明玉	bai'ming'yu	0
百魔道长	bai'mo'dao'chang	0
白琦	bai'qi	0
百禽道人	bai'qin'dao'ren	0
白雀洞	bai'que'dong	0
白首仙童	bai'shou'xian'tong	0
白水观	bai'shui'guan	0
白水真	bai'shui'zhen	0
白犀潭	bai'xi'tan	0
白侠	bai'xia	0
白阳山	bai'yang'shan	0
白幽女	bai'you'nv	0
百欲神魔	bai'yu'shen'mo	0
白云庵	bai'yun'an	0
白云大师	bai'yun'da'shi	0
白云大师元敬	bai'yun'da'shi'yuan'jing	0
白云诃	bai'yun'he	0
白竹涧	bai'zhu'jian	0
半边	ban'bian	0
半边老尼	ban'bian'lao'ni	0
半杨妃勾魂姹女	ban'yang'fei'gou'hun'cha'nv	0
宝城山	bao'cheng'shan	0
宝城仙主	bao'cheng'xian'zhu	0
报恩寺	bao'en'si	0
宝镜	bao'jing	0
宝相夫人	bao'xiang'fu'ren	0
北斗珠	bei'dou'zhu	0
北海	bei'hai	0
北极	bei'ji	0
北极海	bei'ji'hai	0
被困	bei'kun	0
北邙山	bei'mang'shan	0
北天山	bei'tian'shan	0
北岳	bei'yue	0
被逐	bei'zhu	0
本门	ben'men	0
毕半	bi'ban	0
碧火	bi'huo	0
碧筠庵	bi'jun'an	0
碧磷冲	bi'lin'chong	0
碧磷斧	bi'lin'fu	0
碧磷砂	bi'lin'sha	0
碧灵刀	bi'ling'dao	0
碧目天罗	bi'mu'tian'luo	0
碧雯仙子	bi'wen'xian'zi	0
碧蜈钩	bi'wu'gou	0
碧梧仙子	bi'wu'xian'zi	0
碧犀球	bi'xi'qiu	0
辟邪村	bi'xie'cun	0
碧斜钩	bi'xie'gou	0
辟邪古玉	bi'xie'gu'yu	0
辟邪神璧	bi'xie'shen'bi	0
辟邪仙裳	bi'xie'xian'shang	0
毕修	bi'xiu	0
碧血灭魂梭	bi'xue'mie'hun'suo	0
碧血神网	bi'xue'shen'wang	0
碧血神焰	bi'xue'shen'yan	0
碧血针	bi'xue'zhen	0
碧眼神佛	bi'yan'shen'fo	0
碧云盾	bi'yun'dun	0
碧云屏	bi'yun'ping	0
碧云绡	bi'yun'xiao	0
毕真真	bi'zhen'zhen	0
鼻祖	bi'zu	0
冰蚕	bing'can	0
兵解	bing'jie	0
丙灵梭	bing'ling'suo	0
冰魄神光剑	bing'po'shen'guang'jian	0
丙融	bing'rong	0
病维摩	bing'wei'mo	0
冰洋岛	bing'yang'dao	0
丙乙针	bing'yi'zhen	0
冰原灵山	bing'yuan'ling'shan	0
病钟离	bing'zhong'li	0
博克大坂	bo'ke'da'ban	0
波罗刀	bo'luo'dao	0
般若刀	bo're'dao	0
跛师	bo'shi	0
波旬婆	bo'xun'po	0
钵盂峰	bo'yu'feng	0
不坏金光护身法	bu'huai'jin'guang'hu'shen'fa	0
布鲁音加	bu'lu'yin'jia	0
卜天童	bu'tian'tong	0
步虚仙子	bu'xu'xian'zi	0
不夜城	bu'ye'cheng	0
不夜城主	bu'ye'cheng'zhu	0
彩霓练	cai'ni'lian	0
蔡三娘	cai'san'niang	0
采薇僧	cai'wei'seng	0
彩霞红云瘴	cai'xia'hong'yun'zhang	0
彩云瘴	cai'yun'zhang	0
残魂	can'hun	0
餐霞	can'xia	0
餐霞大师	can'xia'da'shi	0
餐霞大师诛杀	can'xia'da'shi'zhu'sha	0
沧浪羽士	cang'lang'yu'shi	0
藏灵子	cang'ling'zi	0
苍虚老人	cang'xu'lao'ren	0
仓真人	cang'zhen'ren	0
曹飞	cao'fei	0
曹枯竹	cao'ku'zhu	0
侧室	ce'shi	0
姹女旗	cha'nv'qi	0
查山五鬼	cha'shan'wu'gui	0
柴伯恭	chai'bo'gong	0
柴成	chai'cheng	0
柴达木河	chai'da'mu'he	0
禅经	chan'jing	0
禅师	chan'shi	0
长白山	chang'bai'shan	0
长臂金猱	chang'bi'jin'nao	0
长臂天魔	chang'bi'tian'mo	0
长春岩	chang'chun'yan	0
长狄洞	chang'di'dong	0
长风洞	chang'feng'dong	0
常鹤	chang'he	0
长眉真人	chang'mei'zhen'ren	0
长夜岛	chang'ye'dao	0
朝天观	chao'tian'guan	0
潮音小筑	chao'yin'xiao'zhu	0
彻地神针	che'di'shen'zhen	0
车青笠	che'qing'li	0
陈长泰	chen'chang'tai	0
陈太真	chen'tai'zhen	0
陈文玑	chen'wen'ji	0
陈圩	chen'xu	0
陈岩	chen'yan	0
成道	cheng'dao	0
程连	cheng'lian	0
承露峰	cheng'lu'feng	0
程明诚	cheng'ming'cheng	0
赤城仙障	chi'cheng'xian'zhang	0
赤城子	chi'cheng'zi	0
赤发峒主	chi'fa'dong'zhu	0
翅尖	chi'jian	0
叱利老佛	chi'li'lao'fo	0
赤隆儿爪	chi'long'er'zhao	0
池鲁	chi'lu	0
赤身洞	chi'shen'dong	0
赤身教	chi'shen'jiao	0
赤身教主	chi'shen'jiao'zhu	0
赤身寨	chi'shen'zhai	0
赤尸七煞神光	chi'shi'qi'sha'shen'guang	0
赤尸神君	chi'shi'shen'jun	0
赤手天尊	chi'shou'tian'zun	0
赤苏剑	chi'su'jian	0
赤霞神君	chi'xia'shen'jun	0
赤霞玄阴障	chi'xia'xuan'yin'zhang	0
赤焰道人	chi'yan'dao'ren	0
赤阴飞叉	chi'yin'fei'cha	0
赤阴球	chi'yin'qiu	0
蚩尤	chi'you	0
蚩尤九宫鉴	chi'you'jiu'gong'jian	0
蚩尤墓	chi'you'mu	0
赤玉杖	chi'yu'zhang	0
赤杖仙姥	chi'zhang'xian'lao	0
赤杖仙童	chi'zhang'xian'tong	0
赤杖真人	chi'zhang'zhen'ren	0
崇明岛	chong'ming'dao	0
崇韶	chong'shao	0
仇慧珠	chou'hui'zhu	0
丑魔王	chou'mo'wang	0
仇魄	chou'po	0
仇生明	chou'sheng'ming	0
愁鹰涧	chou'ying'jian	0
初凤	chu'feng	0
褚玲	chu'ling	0
楚鸣球	chu'ming'qiu	0
褚南川	chu'nan'chuan	0
储晴	chu'qing	0
楚青琴	chu'qing'qin	0
除邪九烟丸	chu'xie'jiu'yan'wan	0
穿心和尚	chuan'xin'he'shang	0
慈云寺	ci'yun'si	0
催光穿云法	cui'guang'chuan'yun'fa	0
崔海客	cui'hai'ke	0
崔黑女	cui'hei'nv	0
崔晋	cui'jin	0
翠练	cui'lian	0
翠螺洲	cui'luo'zhou	0
崔绮	cui'qi	0
崔树	cui'shu	0
崔天绶	cui'tian'shou	0
崔文和	cui'wen'he	0
崔芜	cui'wu	0
崔五姑	cui'wu'gu	0
崔瑶仙	cui'yao'xian	0
崔盈	cui'ying	0
大呆山人	da'dai'shan'ren	0
大方真人	da'fang'zhen'ren	0
大鼓浪山	da'gu'lang'shan	0
大荒	da'huang	0
大荒山	da'huang'shan	0
大咎山	da'jiu'shan	0
大雷音烈火神幡	da'lei'yin'lie'huo'shen'fan	0
大力法王	da'li'fa'wang	0
大力金刚	da'li'jin'gang	0
大力仙童	da'li'xian'tong	0
大麻山	da'ma'shan	0
大魅山	da'mei'shan	0
大魔	da'mo	0
大徒弟	da'tu'di	0
大熊岭	da'xiong'ling	0
大雄神僧	da'xiong'shen'seng	0
大须弥障	da'xu'mi'zhang	0
大雪山	da'xue'shan	0
大衍天机	da'yan'tian'ji	0
大有圈	da'you'quan	0
大智禅师	da'zhi'chan'shi	0
大竹子山	da'zhu'zi'shan	0
打坐	da'zuo	0
戴衡玉	dai'heng'yu	0
戴家场	dai'jia'chang	0
戴湘英	dai'xiang'ying	0
丹书	dan'shu	0
丹云嶂	dan'yun'zhang	0
道书	dao'shu	0
道童	dao'tong	0
得道	de'dao	0
邓八姑	deng'ba'gu	0
邓明	deng'ming	0
登萍仙子	deng'ping'xian'zi	0
邓清风	deng'qing'feng	0
邓隐	deng'yin	0
地残	di'can	0
涤尘老尼	di'chen'lao'ni	0
地遁	di'dun	0
地灵	di'ling	0
狄鸣岐	di'ming'qi	0
地缺	di'que	0
地阙金章	di'que'jin'zhang	0
地仙	di'xian	0
地行	di'xing	0
狄银儿	di'yin'er	0
弟子	di'zi	0
滇池	dian'chi	0
颠倒八门锁仙旗	dian'dao'ba'men'suo'xian'qi	0
颠倒八门镇仙旗	dian'dao'ba'men'zhen'xian'qi	0
颠倒迷仙五云网	dian'dao'mi'xian'wu'yun'wang	0
癫道人	dian'dao'ren	0
颠颠	dian'dian	0
癫和尚	dian'he'shang	0
癫和尚韦秃	dian'he'shang'wei'tu	0
丁嫦	ding'chang	0
丁甲幢	ding'jia'zhuang	0
丁汝林	ding'ru'lin	0
东方皓	dong'fang'hao	0
东海	dong'hai	0
东海三仙	dong'hai'san'xian	0
东海神山	dong'hai'shen'shan	0
东海双凶	dong'hai'shuang'xiong	0
东极	dong'ji	0
洞灵筝	dong'ling'zheng	0
董人瑜	dong'ren'yu	0
东神岛	dong'shen'dao	0
东天	dong'tian	0
董天孙	dong'tian'sun	0
东阳	dong'yang	0
峒主	dong'zhu	0
斗剑	dou'jian	0
兜率宝伞	dou'lv'bao'san	0
兜率火	dou'lv'huo	0
都天烈火神旗	dou'tian'lie'huo'shen'qi	0
都天神雷烈火旗门	dou'tian'shen'lei'lie'huo'qi'men	0
兜元仙	dou'yuan'xian	0
兜元仙史	dou'yuan'xian'shi	0
独臂韦护	du'bi'wei'hu	0
度厄	du'e	0
度厄仙衣	du'e'xian'yi	0
杜芳蘅	du'fang'heng	0
度化	du'hua	0
独角金刚	du'jiao'jin'gang	0
独角灵官	du'jiao'ling'guan	0
独角蟒	du'jiao'mang	0
度劫	du'jie	0
毒龙	du'long	0
毒龙香	du'long'xiang	0
毒龙尊者	du'long'zun'zhe	0
毒手	du'shou	0
毒手摩什	du'shou'mo'shen	0
独指	du'zhi	0
独指禅师	du'zhi'chan'shi	0
断金玦	duan'jin'jue	0
断玉钩	duan'yu'gou	0
遁法	dun'fa	0
遁形符	dun'xing'fu	0
夺宝	duo'bao	0
多宝真人	duo'bao'zhen'ren	0
多臂金刚	duo'bi'jin'gang	0
多臂熊	duo'bi'xiong	0
多目金刚	duo'mu'jin'gang	0
恶鬼师	e'gui'shi	0
恶鬼子	e'gui'zi	0
饿老鸦	e'lao'ya	0
峨眉	e'mei	0
峨眉斗剑	e'mei'dou'jian	0
恶弥勒	e'mi'le	0
二恶	er'e	0
二凤	er'feng	0
二行珠	er'hang'zhu	0
二魔	er'mo	0
二气环	er'qi'huan	0
而生	er'sheng	0
二相环	er'xiang'huan	0
法宝	fa'bao	0
法广	fa'guang	0
法华金刚轮	fa'hua'jin'gang'lun	0
发火	fa'huo	0
法胜	fa'sheng	0
法通	fa'tong	0
法元	fa'yuan	0
犯规	fan'gui	0
返魂香	fan'hun'xiang	0
樊量	fan'liang	0
反目	fan'mu	0
梵拿伽音二	fan'na'jia'yin'er	0
烦恼圈	fan'nao'quan	0
樊森	fan'sen	0
番僧	fan'seng	0
反舌神君	fan'she'shen'jun	0
方还	fang'hai	0
方良	fang'liang	0
芳淑	fang'shu	0
方瑛	fang'ying	0
方玉柔	fang'yu'rou	0
飞叉真人	fei'cha'zhen'ren	0
飞刀真人	fei'dao'zhen'ren	0
飞遁	fei'dun	0
飞虹涧	fei'hong'jian	0
飞剑	fei'jian	0
飞鲸岛	fei'jing'dao	0
飞来峰	fei'lai'feng	0
飞雷洞	fei'lei'dong	0
飞雷岭	fei'lei'ling	0
飞龙岛	fei'long'dao	0
飞龙岭	fei'long'ling	0
飞龙师太	fei'long'shi'tai	0
飞龙真人	fei'long'zhen'ren	0
飞娘	fei'niang	0
飞麒麟	fei'qi'lin	0
飞升	fei'sheng	0
飞天蜈蚣	fei'tian'wu'gong	0
飞天夜叉	fei'tian'ye'cha	0
粉孩儿	fen'hai'er	0
粉牡丹	fen'mu'dan	0
分水犀牛	fen'shui'xi'niu	0
芬陀	fen'tuo	0
芬陀大师	fen'tuo'da'shi	0
风火道人	feng'huo'dao'ren	0
封禁	feng'jin	0
风雷针	feng'lei'zhen	0
凤四姑	feng'si'gu	0
冯吾	feng'wu	0
风梧	feng'wu	0
风箱峡	feng'xiang'xia	0
佛火	fo'huo	0
佛家	fo'jia	0
佛奴	fo'nu	0
伏波崖	fu'bo'ya	0
伏瓜拔老神魔	fu'gua'ba'lao'shen'mo	0
伏魔金环	fu'mo'jin'huan	0
伏魔旗门	fu'mo'qi'men	0
伏魔真人	fu'mo'zhen'ren	0
伏牛岛	fu'niu'dao	0
芙蓉行者	fu'rong'xing'zhe	0
伏尸峡	fu'shi'xia	0
附体	fu'ti	0
伏羲镜	fu'xi'jing	0
福仙潭	fu'xian'tan	0
改邪归正	gai'xie'gui'zheng	0
甘碧梧	gan'bi'wu	0
干神蛛	gan'shen'zhu	0
甘象	gan'xiang	0
甘熊	gan'xiong	0
高丽贡	gao'li'gong	0
高黎贡山	gao'li'gong'shan	0
高僧	gao'seng	0
犵雕	ge'diao	0
戈符	ge'fu	0
根器	gen'qi	0
庚甲运化天芒神针	geng'jia'yun'hua'tian'mang'shen'zhen	0
耿鲲	geng'kun	0
功德	gong'de	0
宫琳	gong'lin	0
巩霜鬟	gong'shuang'huan	0
公孙道明	gong'sun'dao'ming	0
公孙武	gong'sun'wu	0
公冶黄	gong'ye'huang	0
勾魂姹女	gou'hun'cha'nv	0
勾显	gou'xian	0
谷辰	gu'chen	0
古陈仓	gu'chen'cang	0
蛊惑	gu'huo	0
姑婆岭	gu'po'ling	0
古铁令符	gu'tie'ling'fu	0
谷王峰	gu'wang'feng	0
固形丸	gu'xing'wan	0
古玉符	gu'yu'fu	0
古正	gu'zheng	0
怪叫花	guai'jiao'hua	0
乖僻	guai'pi	0
怪僻	guai'pi	0
怪蛇	guai'she	0
关帝庙	guan'di'miao	0
关临	guan'lin	0
贯明扬	guan'ming'yang	0
管青衣	guan'qing'yi	0
观在	guan'zai	0
广成子	guang'cheng'zi	0
广慧师太	guang'hui'shi'tai	0
光明境	guang'ming'jing	0
广明师太	guang'ming'shi'tai	0
归藏袋	gui'cang'dai	0
归大年	gui'da'nian	0
鬼道人	gui'dao'ren	0
桂花山	gui'hua'shan	0
鬼魂	gui'hun	0
鬼姥	gui'lao	0
鬼母	gui'mu	0
鬼母山	gui'mu'shan	0
鬼女	gui'nv	0
癸水雷珠	gui'shui'lei'zhu	0
鬼王	gui'wang	0
归吾	gui'wu	0
鬼眼毒针	gui'yan'du'zhen	0
鬼婴儿	gui'ying'er	0
归元箭	gui'yuan'jian	0
归元寺	gui'yuan'si	0
郭云璞	guo'yun'pu	0
哈葛尼布	ha'ge'ni'bu	0
哈哈	ha'ha	0
哈哈老祖	ha'ha'lao'zu	0
哈哈僧	ha'ha'seng	0
哈延	ha'yan	0
海仙洞	hai'xian'dong	0
海心礁二	hai'xin'jiao'er	0
寒碧	han'bi	0
寒碧剑	han'bi'jian	0
寒萼	han'e	0
寒光	han'guang	0
寒光道人	han'guang'dao'ren	0
寒琼仙子	han'qiong'xian'zi	0
寒山妖道	han'shan'yao'dao	0
韩松	han'song	0
寒犀照	han'xi'zhao	0
寒霞障	han'xia'zhang	0
韩仙子	han'xian'zi	0
韩玄	han'xuan	0
寒氤宝鼎	han'yin'bao'ding	0
寒月禅师	han'yue'chan'shi	0
郝敬	hao'jing	0
郝宽	hao'kuan	0
郝潜夫	hao'qian'fu	0
昊天鉴	hao'tian'jian	0
郝行健	hao'xing'jian	0
何焕	he'huan	0
合欢莲	he'huan'lian	0
贺萍子	he'ping'zi	0
喝泉崖	he'quan'ya	0
何渭	he'wei	0
何小山	he'xiao'shan	0
何兴	he'xing	0
何永亮	he'yong'liang	0
黑丑	hei'chou	0
黑狗钉	hei'gou'ding	0
黑海	hei'hai	0
黑孩儿	hei'hai'er	0
黑伽三童	hei'jia'san'tong	0
黑伽山	hei'jia'shan	0
黑蛮山	hei'man'shan	0
黑霉钉	hei'mei'ding	0
黑讫姥	hei'qi'lao	0
黑煞剑	hei'sha'jian	0
黑煞落魂砂	hei'sha'luo'hun'sha	0
黑煞丝	hei'sha'si	0
黑神女	hei'shen'nv	0
黑手仙长	hei'shou'xian'chang	0
黑猿	hei'yuan	0
恒山	heng'shan	0
恒山三凶	heng'shan'san'xiong	0
洪长豹	hong'chang'bao	0
洪大肚	hong'da'du	0
红发	hong'fa	0
红发老祖	hong'fa'lao'zu	0
红花	hong'hua	0
红花鬼母	hong'hua'gui'mu	0
红花和尚	hong'hua'he'shang	0
红花姥姥	hong'hua'lao'lao	0
红蛟剪	hong'jiao'jian	0
红菱磴	hong'ling'deng	0
红毛	hong'mao	0
虹霓剑	hong'ni'jian	0
红影	hong'ying	0
红欲袋	hong'yu'dai	0
宏愿	hong'yuan	0
红云大师	hong'yun'da'shi	0
红云针	hong'yun'zhen	0
洪真武	hong'zhen'wu	0
红蛛剑	hong'zhu'jian	0
侯曾	hou'ceng	0
后进	hou'jin	0
侯显	hou'xian	0
后羿射阳弩	hou'yi'she'yang'nu	0
呼侗	hu'dong	0
胡嘉	hu'jia	0
呼加卓图	hu'jia'zhuo'tu	0
胡览	hu'lan	0
虎面伽蓝	hu'mian'qie'lan	0
湖神观	hu'shen'guan	0
护神牌	hu'shen'pai	0
胡式	hu'shi	0
虎头禅师	hu'tou'chan'shi	0
虎爪山	hu'zhao'shan	0
花绿绮	hua'lv'qi	0
花奇	hua'qi	0
化去	hua'qu	0
化去天生异禀	hua'qu'tian'sheng'yi'bing	0
华山	hua'shan	0
华山派	hua'shan'pai	0
花无邪	hua'wu'xie	0
化血宝刀	hua'xue'bao'dao	0
化血神钉	hua'xue'shen'ding	0
华瑶崧	hua'yao'song	0
华岳仙童	hua'yue'xian'tong	0
花云崖	hua'yun'ya	0
幻波池	huan'bo'chi	0
欢喜神魔	huan'xi'shen'mo	0
桓玉	huan'yu	0
黄风	huang'feng	0
黄风道人	huang'feng'dao'ren	0
黄贡	huang'gong	0
黄精剑	huang'jing'jian	0
黄龙山	huang'long'shan	0
黄猛	huang'meng	0
黄人龙	huang'ren'long	0
黄人瑜	huang'ren'yu	0
黄山	huang'shan	0
黄石洞	huang'shi'dong	0
黄骕	huang'su	0
黄畹秋	huang'wan'qiu	0
黄玄极	huang'xuan'ji	0
黄鱼岛	huang'yu'dao	0
黄璋	huang'zhang	0
黄肿道人	huang'zhong'dao'ren	0
慧明	hui'ming	0
慧能	hui'neng	0
慧性	hui'xing	0
慧行	hui'xing	0
慧珠	hui'zhu	0
混元幡	hun'yuan'fan	0
混元老祖	hun'yuan'lao'zu	0
混元一气球	hun'yuan'yi'qi'qiu	0
混元终气套	hun'yuan'zhong'qi'tao	0
混元祖师	hun'yuan'zu'shi	0
火蝙蝠	huo'bian'fu	0
火德星君	huo'de'xing'jun	0
火法师	huo'fa'shi	0
火法真人	huo'fa'zhen'ren	0
火海	huo'hai	0
霍合	huo'he	0
火解	huo'jie	0
火龙钗	huo'long'chai	0
火龙礁	huo'long'jiao	0
火鲁齐	huo'lu'qi	0
火狮子	huo'shi'zi	0
火太岁	huo'tai'sui	0
火无害	huo'wu'hai	0
火无量	huo'wu'liang	0
火星	huo'xing	0
火行者	huo'xing'zhe	0
火修罗	huo'xiu'luo	0
火眼金狮	huo'yan'jin'shi	0
火殃神	huo'yang'shen	0
火翼金刚	huo'yi'jin'gang	0
火月	huo'yue	0
火云冲	huo'yun'chong	0
火云洞	huo'yun'dong	0
火云链	huo'yun'lian	0
火云岭	huo'yun'ling	0
火真经	huo'zhen'jing	0
火珠原	huo'zhu'yuan	0
几百年	ji'bai'nian	0
积翠崖	ji'cui'ya	0
纪登	ji'deng	0
姬繁	ji'fan	0
极光球	ji'guang'qiu	0
极乐真人	ji'le'zhen'ren	0
寂灭神钟	ji'mie'shen'zhong	0
记名弟子	ji'ming'di'zi	0
丌南公	ji'nan'gong	0
姬蜃	ji'shen	0
姬旋	ji'xuan	0
稽一鸥	ji'yi'ou	0
吉永	ji'yong	0
汲占	ji'zhan	0
伽难珠	jia'nan'zhu	0
迦叶金光镜	jia'ye'jin'guang'jing	0
甲子	jia'zi	0
简冰如	jian'bing'ru	0
健儿	jian'er	0
简清华	jian'qing'hua	0
剑仙	jian'xian	0
简瑶华	jian'yao'hua	0
蒋诚言	jiang'cheng'yan	0
蒋三姑	jiang'san'gu	0
姜庶	jiang'shu	0
江涛	jiang'tao	0
姜渭	jiang'wei	0
姜渭渔	jiang'wei'yu	0
蒋仙子	jiang'xian'zi	0
蒋诩	jiang'xu	0
绛雪	jiang'xue	0
姜雪君	jiang'xue'jun	0
绛云真人	jiang'yun'zhen'ren	0
姜真人	jiang'zhen'ren	0
江芷云	jiang'zhi'yun	0
鲛人岛	jiao'ren'dao	0
介道人	jie'dao'ren	0
介乎	jie'hu	0
借体重生	jie'ti'zhong'sheng	0
解脱庵	jie'tuo'an	0
芥子藏身法	jie'zi'cang'shen'fa	0
金贝叶	jin'bei'ye	0
金碧神锋	jin'bi'shen'feng	0
金臂行者	jin'bi'xing'zhe	0
金鞭崖	jin'bian'ya	0
金蝉	jin'chan	0
锦春谷	jin'chun'gu	0
金刀仙子	jin'dao'xian'zi	0
锦枫谷	jin'feng'gu	0
金风老人	jin'feng'lao'ren	0
金峰山	jin'feng'shan	0
金风寺	jin'feng'si	0
金佛寺	jin'fo'si	0
金蚨剑	jin'fu'jian	0
金凫仙子	jin'fu'xian'zi	0
金刚杵	jin'gang'chu	0
金刚护身之法	jin'gang'hu'shen'zhi'fa	0
金刚神火箭	jin'gang'shen'huo'jian	0
金刚神砂	jin'gang'shen'sha	0
金戈	jin'ge	0
金光大手	jin'guang'da'shou	0
金光鼎	jin'guang'ding	0
金光洞	jin'guang'dong	0
金光烈火剑	jin'guang'lie'huo'jian	0
金虹	jin'hong	0
金花	jin'hua	0
金花教主	jin'hua'jiao'zhu	0
金精神臂	jin'jing'shen'bi	0
金姥姥	jin'lao'lao	0
金姥姥罗紫烟	jin'lao'lao'luo'zi'yan	0
金莲神座	jin'lian'shen'zuo	0
金麟剑	jin'lin'jian	0
金龙梭	jin'long'suo	0
金萍	jin'ping	0
金菩提	jin'pu'ti	0
金神君	jin'shen'jun	0
金身罗汉	jin'shen'luo'han	0
金沈子	jin'shen'zi	0
金狮神佛	jin'shi'shen'fo	0
金石峡	jin'shi'xia	0
金姝	jin'shu	0
金泰	jin'tai	0
金庭山	jin'ting'shan	0
金头仙娘	jin'tou'xian'niang	0
金驼	jin'tuo	0
金鼍剑	jin'tuo'jian	0
金乌神火	jin'wu'shen'huo	0
金乌障	jin'wu'zhang	0
金犀剑	jin'xi'jian	0
金霞洞	jin'xia'dong	0
金线神姥	jin'xian'shen'lao	0
金须奴	jin'xu'nu	0
金燕	jin'yan	0
金眼狒狒	jin'yan'fei'fei	0
金银串	jin'yin'chuan	0
金银岛	jin'yin'dao	0
金银沙剑	jin'yin'sha'jian	0
金莺	jin'ying	0
金鸳神剪	jin'yuan'shen'jian	0
锦云兜	jin'yun'dou	0
锦云衣	jin'yun'yi	0
金针圣母	jin'zhen'sheng'mu	0
金钟岛	jin'zhong'dao	0
金钟岛主	jin'zhong'dao'zhu	0
镜波寺	jing'bo'si	0
镜澄	jing'cheng	0
警戒	jing'jie	0
荆门山	jing'men'shan	0
精气	jing'qi	0
镜天湖	jing'tian'hu	0
鲸涎锤	jing'xian'chui	0
静修	jing'xiu	0
九宫宝镜	jiu'gong'bao'jing	0
九宫环	jiu'gong'huan	0
九宫朱灵旗	jiu'gong'zhu'ling'qi	0
九还岭	jiu'hai'ling	0
九寒沙	jiu'han'sha	0
九华山	jiu'hua'shan	0
九戒仙幢	jiu'jie'xian'zhuang	0
九九修罗刀	jiu'jiu'xiu'luo'dao	0
九烈	jiu'lie	0
九烈神君	jiu'lie'shen'jun	0
九六宙灵梭	jiu'liu'zhou'ling'suo	0
九龙梭	jiu'long'suo	0
九龙真人	jiu'long'zhen'ren	0
鸠盘婆	jiu'pan'po	0
九曲柔丝	jiu'qu'rou'si	0
九世	jiu'shi	0
九天	jiu'tian	0
九天都罗神锋	jiu'tian'dou'luo'shen'feng	0
九天都篆阴魔大法	jiu'tian'dou'zhuan'yin'mo'da'fa	0
九天勾魂神君	jiu'tian'gou'hun'shen'jun	0
九天寒魄珠	jiu'tian'han'po'zhu	0
九天十地辟魔神梭	jiu'tian'shi'di'pi'mo'shen'suo	0
九天元阳尺	jiu'tian'yuan'yang'chi	0
九天云网	jiu'tian'yun'wang	0
九尾天狐	jiu'wei'tian'hu	0
九仙洞	jiu'xian'dong	0
九疑鼎	jiu'yi'ding	0
九疑鼎下	jiu'yi'ding'xia	0
九转百炼灵丹	jiu'zhuan'bai'lian'ling'dan	0
九转还金丹	jiu'zhuan'hai'jin'dan	0
九转轮	jiu'zhuan'lun	0
九子母阴魂剑	jiu'zi'mu'yin'hun'jian	0
九子母阴魔销魂大法	jiu'zi'mu'yin'mo'xiao'hun'da'fa	0
九子母元阳针	jiu'zi'mu'yuan'yang'zhen	0
巨洪	ju'hong	0
巨魁	ju'kui	0
聚奎剑	ju'kui'jian	0
居罗岛	ju'luo'dao	0
巨木神君	ju'mu'shen'jun	0
绝尘崖	jue'chen'ya	0
绝顶	jue'ding	0
绝尊者	jue'zun'zhe	0
喀音沙布	ka'yin'sha'bu	0
开府	kai'fu	0
开山祖师	kai'shan'zu'shi	0
开元寺	kai'yuan'si	0
坎离丹	kan'li'dan	0
坎离梭	kan'li'suo	0
坎离真	kan'li'zhen	0
坎离真人	kan'li'zhen'ren	0
可一子	ke'yi'zi	0
孔凌霄	kong'ling'xiao	0
孔灵子	kong'ling'zi	0
崆峒派	kong'tong'pai	0
空陀神僧	kong'tuo'shen'seng	0
苦孩儿	ku'hai'er	0
苦炼	ku'lian	0
苦铁长老	ku'tie'zhang'lao	0
苦行头陀	ku'xing'tou'tuo	0
苦修	ku'xiu	0
枯竹	ku'zhu	0
枯竹庵	ku'zhu'an	0
苦竹庵	ku'zhu'an	0
枯竹老人	ku'zhu'lao'ren	0
苦竹峡	ku'zhu'xia	0
快活村	kuai'huo'cun	0
葵香	kui'xiang	0
坤灵针	kun'ling'zhen	0
困龙珠	kun'long'zhu	0
昆仑	kun'lun	0
昆仑三友	kun'lun'san'you	0
括苍山	kuo'cang'shan	0
拉蛮	la'man	0
癞姑	lai'gu	0
蓝敕令	lan'chi'ling	0
蓝二龙	lan'er'long	0
蓝佬石	lan'lao'shi	0
蓝老铁	lan'lao'tie	0
蓝髯客	lan'ran'ke	0
蓝天狗	lan'tian'gou	0
郎飞	lang'fei	0
琅缳秘笈	lang'huan'mi'ji	0
琅嬛天府	lang'huan'tian'fu	0
老蚌	lao'bang	0
老疙疽	lao'ge'ju	0
姥姥	lao'lao	0
老魔	lao'mo	0
崂山	lao'shan	0
乐三官	le'san'guan	0
乐众	le'zhong	0
雷二娘	lei'er'niang	0
雷火	lei'huo	0
雷起龙	lei'qi'long	0
雷去恶	lei'qu'e	0
雷音	lei'yin	0
雷音椎	lei'yin'zhui	0
雷泽神剑	lei'ze'shen'jian	0
雷泽神砂	lei'ze'shen'sha	0
雷抓子	lei'zhua'zi	0
冷蝉沙	leng'chan'sha	0
冷光珠	leng'guang'zhu	0
冷魂峪	leng'hun'yu	0
冷焰寒雷	leng'yan'han'lei	0
冷焰九寒针	leng'yan'jiu'han'zhen	0
冷云丹	leng'yun'dan	0
冷云仙子	leng'yun'xian'zi	0
黎半风	li'ban'feng	0
黎成	li'cheng	0
离垢钟	li'gou'zhong	0
利害	li'hai	0
离合神光	li'he'shen'guang	0
离合五云圭	li'he'wu'yun'gui	0
李洪	li'hong	0
厉吼	li'hou	0
李厚	li'hou	0
李健	li'jian	0
李静虚	li'jing'xu	0
李昆吾	li'kun'wu	0
黎母岭	li'mu'ling	0
黎母真传	li'mu'zhen'chuan	0
李宁	li'ning	0
李如烟	li'ru'yan	0
丽山	li'shan	0
丽山七老	li'shan'qi'lao	0
黎绍	li'shao	0
李四姑	li'si'gu	0
黎望	li'wang	0
李文衎	li'wen'kan	0
离依岛	li'yi'dao	0
李英琼	li'ying'qiong	0
李玉玉	li'yu'yu	0
李元化	li'yuan'hua	0
郦芸	li'yun	0
李震川	li'zhen'chuan	0
离珠宫	li'zhu'gong	0
炼刚柔	lian'gang'rou	0
廉红药	lian'hong'yao	0
炼化	lian'hua	0
莲花峰	lian'hua'feng	0
炼就	lian'jiu	0
炼魔神针	lian'mo'shen'zhen	0
连山大师	lian'shan'da'shi	0
两翅	liang'chi	0
两极圈	liang'ji'quan	0
两极宙光盘	liang'ji'zhou'guang'pan	0
两界牌	liang'jie'pai	0
梁武帝	liang'wu'di	0
两仪幡	liang'yi'fan	0
两仪分光锉	liang'yi'fen'guang'cuo	0
两仪天昙镜	liang'yi'tian'tan'jing	0
辽东二魔	liao'dong'er'mo	0
了了和尚	liao'liao'he'shang	0
了一	liao'yi	0
列霸多	lie'ba'duo	0
烈火	lie'huo	0
烈火雷音剑	lie'huo'lei'yin'jian	0
烈火毛虫	lie'huo'mao'chong	0
烈火神珠	lie'huo'shen'zhu	0
烈火祖师	lie'huo'zu'shi	0
列缺双钩	lie'que'shuang'gou	0
林成祖	lin'cheng'zu	0
林寒	lin'han	0
林鹤	lin'he	0
林驾	lin'jia	0
林绿华	lin'lv'hua	0
林明淑	lin'ming'shu	0
林秋水	lin'qiu'shui	0
林瑞	lin'rui	0
林素娥	lin'su'e	0
林映雪	lin'ying'xue	0
林渊	lin'yuan	0
林总	lin'zong	0
凌操	ling'cao	0
灵光驭	ling'guang'yu	0
令狐畹兰	ling'hu'wan'lan	0
凌浑	ling'hun	0
灵空仙界	ling'kong'xian'jie	0
灵灵子	ling'ling'zi	0
灵奇	ling'qi	0
灵旗烈焰	ling'qi'lie'yan	0
灵峤宫	ling'qiao'gong	0
灵石剑	ling'shi'jian	0
灵石真火	ling'shi'zhen'huo	0
灵威叟	ling'wei'sou	0
灵雾障	ling'wu'zhang	0
羚峡仙府	ling'xia'xian'fu	0
凌虚子	ling'xu'zi	0
凌虚子崔海客	ling'xu'zi'cui'hai'ke	0
凌雪鸿	ling'xue'hong	0
灵羊峰	ling'yang'feng	0
灵药	ling'yao	0
灵玉膏	ling'yu'gao	0
灵玉岩	ling'yu'yan	0
凌云凤	ling'yun'feng	0
灵蛛丝	ling'zhu'si	0
刘超	liu'chao	0
刘独	liu'du	0
刘根座	liu'gen'zuo	0
柳和	liu'he	0
硫磺迷魂砂	liu'huang'mi'hun'sha	0
六甲分光轮	liu'jia'fen'guang'lun	0
六甲金光幛	liu'jia'jin'guang'zhang	0
六魔	liu'mo	0
留骈	liu'pian	0
柳青	liu'qing	0
刘泉	liu'quan	0
留人峒	liu'ren'dong	0
柳如花	liu'ru'hua	0
六戊潜行之法	liu'wu'qian'xing'zhi'fa	0
刘霞台	liu'xia'tai	0
柳雄飞	liu'xiong'fei	0
柳雪翁	liu'xue'weng	0
柳燕娘	liu'yan'niang	0
六阳定风幡	liu'yang'ding'feng'fan	0
六阳换骨琼浆	liu'yang'huan'gu'qiong'jiang	0
六阳烈火柱	liu'yang'lie'huo'zhu	0
六阳青灵辟魔铠	liu'yang'qing'ling'pi'mo'kai	0
六阳神火鉴	liu'yang'shen'huo'jian	0
刘裕安	liu'yu'an	0
六贼无形针	liu'zei'wu'xing'zhen	0
六贼阴魂圈	liu'zei'yin'hun'quan	0
柳宗潜	liu'zong'qian	0
龙飞	long'fei	0
龙化	long'hua	0
龙力子	long'li'zi	0
龙猛	long'meng	0
龙湫山樵	long'qiu'shan'qiao	0
龙雀环	long'que'huan	0
龙山双艳	long'shan'shuang'yan	0
龙玄	long'xuan	0
聋哑僧	long'ya'seng	0
龙珠	long'zhu	0
楼沧洲	lou'cang'zhou	0
漏网	lou'wang	0
陆沉混元幡	lu'chen'hun'yuan'fan	0
陆成	lu'cheng	0
陆大虎	lu'da'hu	0
陆地金龙	lu'di'jin'long	0
陆地金仙	lu'di'jin'xian	0
鹿革岛	lu'ge'dao	0
六合微尘仙阵	lu'he'wei'chen'xian'zhen	0
陆虎	lu'hu	0
戮魂针	lu'hun'zhen	0
陆敏	lu'min	0
路平遥	lu'ping'yao	0
鹿清	lu'qing	0
陆蓉波	lu'rong'bo	0
庐山	lu'shan	0
陆巽	lu'xun	0
卢妪	lu'yu	0
孪生姊妹	luan'sheng'zi'mei	0
罗刹金刀	luo'cha'jin'dao	0
罗刹仙	luo'cha'xian	0
罗刹阴风网	luo'cha'yin'feng'wang	0
落凤山	luo'feng'shan	0
落魂岛	luo'hun'dao	0
落魂谷	luo'hun'gu	0
罗锦春	luo'jin'chun	0
罗九	luo'jiu	0
罗袅	luo'niao	0
落神坊	luo'shen'fang	0
落神岭	luo'shen'ling	0
罗文林	luo'wen'lin	0
罗新	luo'xin	0
落雁山	luo'yan'shan	0
罗茵	luo'yin	0
罗紫烟	luo'zi'yan	0
绿鬓仙娘	lv'bin'xian'niang	0
吕村	lv'cun	0
吕璟	lv'jing	0
绿毛真人	lv'mao'zhen'ren	0
绿毛真人刘根	lv'mao'zhen'ren'liu'gen	0
绿袍	lv'pao	0
绿袍老祖	lv'pao'lao'zu	0
吕宪明	lv'xian'ming	0
绿玉杖	lv'yu'zhang	0
吕元子	lv'yuan'zi	0
绿云仙席	lv'yun'xian'xi	0
绿云瘴	lv'yun'zhang	0
马庚仙	ma'geng'xian	0
麻冠道人	ma'guan'dao'ren	0
马觉	ma'jue	0
马龙娃	ma'long'wa	0
麻头鬼王	ma'tou'gui'wang	0
马湘	ma'xiang	0
马雄	ma'xiong	0
莽苍山	mang'cang'shan	0
芒砀山	mang'dang'shan	0
氓牛岭	mang'niu'ling	0
莽头陀	mang'tou'tuo	0
毛太	mao'tai	0
毛萧	mao'xiao	0
毛霄	mao'xiao	0
茅壮	mao'zhuang	0
梅花仙子	mei'hua'xian'zi	0
美嫫母	mei'mo'mu	0
美髯仙童	mei'ran'xian'tong	0
美少年	mei'shao'nian	0
美仙娃	mei'xian'wa	0
门徒	men'tu	0
弥尘幡	mi'chen'fan	0
米和	mi'he	0
秘籍	mi'ji	0
米明娘	mi'ming'niang	0
秘魔	mi'mo	0
秘魔神音	mi'mo'shen'yin	0
秘魔神装	mi'mo'shen'zhuang	0
米佘	mi'she	0
米鼍	mi'tuo	0
弥陀珠	mi'tuo'zhu	0
迷阳毒草	mi'yang'du'cao	0
迷阳针	mi'yang'zhen	0
密音环	mi'yin'huan	0
面壁	mian'bi	0
苗楚芳	miao'chu'fang	0
眇姑	miao'gu	0
妙化真人	miao'hua'zhen'ren	0
苗酋	miao'qiu	0
苗山四凶	miao'shan'si'xiong	0
妙一	miao'yi	0
妙一夫人	miao'yi'fu'ren	0
妙一真人	miao'yi'zhen'ren	0
妙音寺	miao'yin'si	0
妙真观	miao'zhen'guan	0
灭魔宝箓	mie'mo'bao'lu	0
灭魔弹月弩	mie'mo'dan'yue'nu	0
岷山	min'shan	0
岷山三女	min'shan'san'nv	0
闵乌能	min'wu'neng	0
闵湘娃	min'xiang'wa	0
闵姓道姑	min'xing'dao'gu	0
明河	ming'he	0
冥圣	ming'sheng	0
明姝	ming'shu	0
明霞谷	ming'xia'gu	0
明霞神君	ming'xia'shen'jun	0
明夷子	ming'yi'zi	0
明悦大师	ming'yue'da'shi	0
明月珮	ming'yue'pei	0
明珠禅师	ming'zhu'chan'shi	0
摩耳崖	mo'er'ya	0
魔法	mo'fa	0
墨凤凰	mo'feng'huang	0
魔宫	mo'gong	0
摩诃尊	mo'he'zun	0
摩诃尊者	mo'he'zun'zhe	0
魔火金幢	mo'huo'jin'zhuang	0
摩伽仙子	mo'jia'xian'zi	0
魔教	mo'jiao	0
魔经	mo'jing	0
莫釐峰	mo'li'feng	0
墨龙神剑	mo'long'shen'jian	0
魔母	mo'mu	0
魔母温良	mo'mu'wen'liang	0
莫逆	mo'ni	0
魔女	mo'nv	0
磨球岛	mo'qiu'dao	0
魔泉幡	mo'quan'fan	0
魔头	mo'tou	0
摩云岭	mo'yun'ling	0
牟尼散光丸	mou'ni'san'guang'wan	0
牟尼珠	mou'ni'zhu	0
沐垓	mu'gai	0
沐红羽	mu'hong'yu	0
木鸡	mu'ji	0
沐圮	mu'pi	0
慕容贤	mu'rong'xian	0
慕容昭	mu'rong'zhao	0
沐尚	mu'shang	0
木石潜踪	mu'shi'qian'zong	0
纳芥环	na'jie'huan	0
南海	nan'hai	0
南海双童	nan'hai'shuang'tong	0
南疆	nan'jiang	0
南明离火剑	nan'ming'li'huo'jian	0
南星原	nan'xing'yuan	0
闹海银龙	nao'hai'yin'long	0
内景元宗	nei'jing'yuan'zong	0
倪不疑	ni'bu'yi	0
倪芳贤	ni'fang'xian	0
尼姑	ni'gu	0
倪均	ni'jun	0
倪兰心	ni'lan'xin	0
泥犁落魂幡	ni'li'luo'hun'fan	0
泥犁旗	ni'li'qi	0
泥犁玄阴轮	ni'li'xuan'yin'lun	0
泥犁珠	ni'li'zhu	0
尼尼	ni'ni	0
鸟语	niao'yu	0
孽龙岛	nie'long'dao	0
孽徒	nie'tu	0
宁一子	ning'yi'zi	0
凝玉峰	ning'yu'feng	0
牛肝峡	niu'gan'xia	0
牛清玄	niu'qing'xuan	0
农家姊妹	nong'jia'zi'mei	0
女大鹏	nv'da'peng	0
女弟子	nv'di'zi	0
女飞熊	nv'fei'xiong	0
女空空	nv'kong'kong	0
女昆仑	nv'kun'lun	0
女魔王	nv'mo'wang	0
女神童	nv'shen'tong	0
女神婴	nv'shen'ying	0
女徒弟	nv'tu'di	0
女韦护	nv'wei'hu	0
女仙	nv'xian	0
女枭神	nv'xiao'shen	0
女殃神	nv'yang'shen	0
女殃神邓八姑	nv'yang'shen'deng'ba'gu	0
沤浮	ou'fu	0
沤浮子	ou'fu'zi	0
欧阳宏	ou'yang'hong	0
欧阳鸿	ou'yang'hong	0
欧阳霜	ou'yang'shuang	0
潘芳	pan'fang	0
潘六婆	pan'liu'po	0
盘荦	pan'luo	0
叛师	pan'shi	0
潘硎	pan'xing	0
潘绣虎	pan'xiu'hu	0
庞化	pang'hua	0
庞化成	pang'hua'cheng	0
旁门	pang'men	0
旁门左道	pang'men'zuo'dao	0
裴娥	pei'e	0
裴懿	pei'yi	0
彭格	peng'ge	0
澎湖岛	peng'hu'dao	0
彭妪	peng'yu	0
披发狻猊	pi'fa'suan'ni	0
霹雳凿	pi'li'zao	0
辟魔符玦	pi'mo'fu'jue	0
辟魔神光罩	pi'mo'shen'guang'zhao	0
毗那神刀	pi'na'shen'dao	0
枇杷村	pi'pa'cun	0
瓢媪	piao'ao	0
缥缈儿	piao'miao'er	0
缥缈儿石明珠	piao'miao'er'shi'ming'zhu	0
平凉	ping'liang	0
破头和尚	po'tou'he'shang	0
鄱阳湖	po'yang'hu	0
蒲和	pu'he	0
普化	pu'hua	0
蒲妙妙	pu'miao'miao	0
菩提钉	pu'ti'ding	0
七矮	qi'ai	0
七宝金幢	qi'bao'jin'zhuang	0
七宝紫晶瓶	qi'bao'zi'jing'ping	0
齐承基	qi'cheng'ji	0
七二秘魔元命神幡	qi'er'mi'mo'yuan'ming'shen'fan	0
骑鲸客	qi'jing'ke	0
七老	qi'lao	0
旗里烟岚	qi'li'yan'lan	0
祁连山	qi'lian'shan	0
琪琳宫	qi'lin'gong	0
齐灵云	qi'ling'yun	0
齐鲁三英	qi'lu'san'ying	0
齐名	qi'ming	0
七魔	qi'mo	0
七禽神术	qi'qin'shen'shu	0
七禽五遁	qi'qin'wu'dun	0
七情网	qi'qing'wang	0
七煞幡	qi'sha'fan	0
七煞黑眚丝	qi'sha'hei'sheng'si	0
七煞手	qi'sha'shou	0
七煞乌灵刀	qi'sha'wu'ling'dao	0
七刹玄阴天幕	qi'sha'xuan'yin'tian'mu	0
七煞玄阴天幕	qi'sha'xuan'yin'tian'mu	0
七手夜叉	qi'shou'ye'cha	0
齐漱溟	qi'shu'ming	0
齐霞儿	qi'xia'er	0
七星	qi'xing	0
七星手	qi'xing'shou	0
漆章	qi'zhang	0
七指	qi'zhi	0
七指龙母	qi'zhi'long'mu	0
七指神魔	qi'zhi'shen'mo	0
前辈	qian'bei	0
乾罡神火	qian'gang'shen'huo	0
乾罡神火罩	qian'gang'shen'huo'zhao	0
千斤铊	qian'jin'ta	0
钱康	qian'kang	0
乾坤布袋	qian'kun'bu'dai	0
乾坤针	qian'kun'zhen	0
乾坤正气	qian'kun'zheng'qi	0
乾坤转变潜形旗	qian'kun'zhuan'bian'qian'xing'qi	0
乾坤转变潜行旗	qian'kun'zhuan'bian'qian'xing'qi	0
钱莱	qian'lai	0
千里户庭囊中缩影之法	qian'li'hu'ting'nang'zhong'suo'ying'zhi'fa	0
千里腾光法	qian'li'teng'guang'fa	0
乾明离火	qian'ming'li'huo	0
钱青选	qian'qing'xuan	0
前生	qian'sheng	0
千尸洞	qian'shi'dong	0
千石帆	qian'shi'fan	0
千手娘子	qian'shou'niang'zi	0
乾天罡煞之气	qian'tian'gang'sha'zhi'qi	0
乾天混元珠	qian'tian'hun'yuan'zhu	0
乾天火灵珠	qian'tian'huo'ling'zhu	0
乾天烈火	qian'tian'lie'huo	0
乾天灵火	qian'tian'ling'huo	0
乾天一元霹雳子	qian'tian'yi'yuan'pi'li'zi	0
千晓	qian'xiao	0
潜行挪移大法	qian'xing'nuo'yi'da'fa	0
千叶神雷冲	qian'ye'shen'lei'chong	0
千余年	qian'yu'nian	0
前知	qian'zhi	0
乔纪	qiao'ji	0
桥陵	qiao'ling	0
乔乔	qiao'qiao	0
翘翘	qiao'qiao	0
乔瘦滕	qiao'shou'teng	0
伽蓝珠	qie'lan'zhu	0
秦迟	qin'chi	0
秦寒萼	qin'han'e	0
琴和	qin'he	0
秦瑚	qin'hu	0
秦家姐妹	qin'jia'jie'mei	0
秦玠	qin'jie	0
秦朗	qin'lang	0
秦雷	qin'lei	0
秦礼	qin'li	0
秦岭	qin'ling	0
秦嫫	qin'mo	0
秦氏姐妹	qin'shi'jie'mei	0
秦魋	qin'tui	0
秦渔	qin'yu	0
秦紫玲	qin'zi'ling	0
清波上人	qing'bo'shang'ren	0
青城	qing'cheng	0
青城派	qing'cheng'pai	0
青帝	qing'di	0
青蛾仙童	qing'e'xian'tong	0
青儿	qing'er	0
清风散人	qing'feng'san'ren	0
青玕谷	qing'gan'gu	0
青罡剑	qing'gang'jian	0
青海	qing'hai	0
青海二恶	qing'hai'er'e	0
青海派	qing'hai'pai	0
青海派教祖	qing'hai'pai'jiao'zu	0
青荷岛	qing'he'dao	0
清江浦	qing'jiang'pu	0
青晶壑	qing'jing'he	0
青雷子	qing'lei'zi	0
青麟囊	qing'lin'nang	0
青灵丹	qing'ling'dan	0
青灵剑	qing'ling'jian	0
青灵髓	qing'ling'sui	0
青螺	qing'luo	0
青门岛	qing'men'dao	0
青门岛主	qing'men'dao'zhu	0
青冥剑	qing'ming'jian	0
青囊仙子	qing'nang'xian'zi	0
青囊仙子华瑶崧	qing'nang'xian'zi'hua'yao'song	0
青霓剑	qing'ni'jian	0
清宁宝扇	qing'ning'bao'shan	0
青牛剑	qing'niu'jian	0
青蜃瓶	qing'shen'ping	0
青索剑	qing'suo'jian	0
青羊老祖	qing'yang'lao'zu	0
青阳轮	qing'yang'lun	0
青阳神锋	qing'yang'shen'feng	0
青阳柱	qing'yang'zhu	0
青瑶锁	qing'yao'suo	0
青乙神镜	qing'yi'shen'jing	0
青玉环	qing'yu'huan	0
轻云	qing'yun	0
轻重	qing'zhong	0
穹窿山	qiong'long'shan	0
穷奇	qiong'qi	0
穷神	qiong'shen	0
邱林	qiu'lin	0
邱舲	qiu'ling	0
裘芷仙	qiu'zhi'xian	0
躯体	qu'ti	0
全绍	quan'shao	0
全真洞	quan'zhen'dong	0
泉州	quan'zhou	0
冉春	ran'chun	0
髯仙	ran'xian	0
燃脂头陀	ran'zhi'tou'tuo	0
任春	ren'chun	0
忍大师	ren'da'shi	0
仞利仙子	ren'li'xian'zi	0
人皮袋	ren'pi'dai	0
日月轮	ri'yue'lun	0
日月僧	ri'yue'seng	0
日月五星	ri'yue'wu'xing	0
日月五星轮	ri'yue'wu'xing'lun	0
日月崖	ri'yue'ya	0
戎敦	rong'dun	0
肉身	rou'shen	0
茹黄沙	ru'huang'sha	0
如来	ru'lai	0
如意金钩	ru'yi'jin'gou	0
如意金连环	ru'yi'jin'lian'huan	0
如意魔珠	ru'yi'mo'zhu	0
如意七情障	ru'yi'qi'qing'zhang	0
如意神矛	ru'yi'shen'mao	0
如意水烟罗	ru'yi'shui'yan'luo	0
如意五云罗	ru'yi'wu'yun'luo	0
软红砂	ruan'hong'sha	0
阮纠	ruan'jiu	0
阮征	ruan'zheng	0
阮征号	ruan'zheng'hao	0
若兰	ruo'lan	0
萨尔温山	sa'er'wen'shan	0
萨若耶	sa'ruo'ye	0
赛阿环	sai'a'huan	0
赛达摩	sai'da'mo	0
赛飞琼	sai'fei'qiong	0
三百六十手	san'bai'liu'shi'shou	0
三才火云环	san'cai'huo'yun'huan	0
三才清宁圈	san'cai'qing'ning'quan	0
三才尊者	san'cai'zun'zhe	0
三凤	san'feng	0
三怪	san'guai	0
三光杵	san'guang'chu	0
散花道长	san'hua'dao'zhang	0
散花檠	san'hua'qing	0
三花神梭	san'hua'shen'suo	0
三化真人	san'hua'zhen'ren	0
三棱戮魔刺	san'leng'lu'mo'ci	0
三棱铁针	san'leng'tie'zhen	0
三棱心如剑	san'leng'xin'ru'jian	0
三连袋	san'lian'dai	0
三魔	san'mo	0
三女	san'nv	0
三盘经	san'pan'jing	0
三七轮	san'qi'lun	0
三尸元神	san'shi'yuan'shen	0
三手仙郎	san'shou'xian'lang	0
三仙	san'xian	0
散仙	san'xian	0
三湘贫女	san'xiang'pin'nv	0
三凶	san'xiong	0
三眼红猊	san'yan'hong'ni	0
三阳一气剑	san'yang'yi'qi'jian	0
三英二云	san'ying'er'yun	0
三影神君	san'ying'shen'jun	0
三游洞	san'you'dong	0
三元秘笈	san'yuan'mi'ji	0
三元一体坎离化身之法	san'yuan'yi'ti'kan'li'hua'shen'zhi'fa	0
丧门钉	sang'men'ding	0
丧门剑	sang'men'jian	0
丧门箭	sang'men'jian	0
丧门锏	sang'men'jian	0
桑仙姥	sang'xian'lao	0
沙红燕	sha'hong'yan	0
杀戒	sha'jie	0
沙亮	sha'liang	0
杀孽	sha'nie	0
沙佘	sha'she	0
沙神童子	sha'shen'tong'zi	0
善法大师	shan'fa'da'shi	0
珊瑚窝	shan'hu'wo	0
善化	shan'hua	0
善化大侠	shan'hua'da'xia	0
善卷洞	shan'juan'dong	0
山峡	shan'xia	0
山魈	shan'xiao	0
善缘	shan'yuan	0
上方山	shang'fang'shan	0
商风子	shang'feng'zi	0
上古三苗	shang'gu'san'miao	0
上古四凶	shang'gu'si'xiong	0
上官红	shang'guan'hong	0
尚和阳	shang'he'yang	0
商弘	shang'hong	0
商建初	shang'jian'chu	0
商栗商梧之	shang'li'shang'wu'zhi	0
商嫫	shang'mo	0
商梧	shang'wu	0
上元宫	shang'yuan'gong	0
商壮	shang'zhuang	0
邵冬秀	shao'dong'xiu	0
少阳神君	shao'yang'shen'jun	0
摄去	she'qu	0
摄心镜	she'xin'jing	0
摄心铃	she'xin'ling	0
射阳神箭	she'yang'shen'jian	0
神鳌岭	shen'ao'ling	0
神雕	shen'diao	0
神风使者	shen'feng'shi'zhe	0
神符	shen'fu	0
神光洞	shen'guang'dong	0
神剑峰	shen'jian'feng	0
神雷	shen'lei	0
神雷金光錾	shen'lei'jin'guang'zan	0
申鸾	shen'luan	0
神魔洞	shen'mo'dong	0
神木宫	shen'mu'gong	0
神木剑	shen'mu'jian	0
神目天尊	shen'mu'tian'zun	0
神尼	shen'ni	0
神尼心如	shen'ni'xin'ru	0
神尼优昙	shen'ni'you'tan	0
申若兰	shen'ruo'lan	0
神鲨刺	shen'sha'ci	0
神山	shen'shan	0
神手比丘	shen'shou'bi'qiu	0
神手比邱	shen'shou'bi'qiu	0
神坛	shen'tan	0
沈腾	shen'teng	0
沈通	shen'tong	0
神通广大	shen'tong'guang'da	0
申屠宏	shen'tu'hong	0
神驼	shen'tuo	0
神驼乙休	shen'tuo'yi'xiu	0
沈薇	shen'wei	0
申武	shen'wu	0
申无垢	shen'wu'gou	0
神行头陀	shen'xing'tou'tuo	0
沈绣	shen'xiu	0
神眼邱林	shen'yan'qiu'lin	0
神禹令	shen'yu'ling	0
圣姑	sheng'gu	0
圣姑伽因	sheng'gu'jia'yin	0
生魂	sheng'hun	0
生肌固魂之法	sheng'ji'gu'hun'zhi'fa	0
史春娥	shi'chun'e	0
石道人	shi'dao'ren	0
十二都天神熬	shi'er'dou'tian'shen'ao	0
十二花煞神罡	shi'er'hua'sha'shen'gang	0
师傅	shi'fu	0
史涵虚	shi'han'xu	0
石虎山	shi'hu'shan	0
石慧	shi'hui	0
石火袋	shi'huo'dai	0
石火神	shi'huo'shen	0
石火神雷	shi'huo'shen'lei	0
史家泉	shi'jia'quan	0
尸解	shi'jie	0
施林	shi'lin	0
施龙姑	shi'long'gu	0
石明珠	shi'ming'zhu	0
史南溪	shi'nan'xi	0
侍女	shi'nv	0
石女	shi'nv	0
尸毗	shi'pi	0
尸毗老人	shi'pi'lao'ren	0
尸毗七绝魔针	shi'pi'qi'jue'mo'zhen	0
石奇	shi'qi	0
狮僧	shi'seng	0
石生	shi'sheng	0
石完	shi'wan	0
师文恭	shi'wen'gong	0
石仙王	shi'xian'wang	0
史邢曼	shi'xing'man	0
师兄弟	shi'xiong'di	0
石玉珠	shi'yu'zhu	0
石元真	shi'yuan'zhen	0
侍者	shi'zhe	0
师真童	shi'zhen'tong	0
师侄	shi'zhi	0
史准	shi'zhun	0
狮子洞	shi'zi'dong	0
守洞神兽	shou'dong'shen'shou	0
兽化人	shou'hua'ren	0
守缺大师	shou'que'da'shi	0
霜镡剑	shuang'chan'jian	0
霜华仙子	shuang'hua'xian'zi	0
霜蛟剑	shuang'jiao'jian	0
霜角剑	shuang'jiao'jian	0
双龙剪	shuang'long'jian	0
双身教	shuang'shen'jiao	0
双身教主	shuang'shen'jiao'zhu	0
双翼	shuang'yi	0
水镜道人	shui'jing'dao'ren	0
水晶球	shui'jing'qiu	0
水晶子	shui'jing'zi	0
水母	shui'mu	0
水母宫	shui'mu'gong	0
水母姬旋	shui'mu'ji'xuan	0
水母剑	shui'mu'jian	0
水母玄阴镜	shui'mu'xuan'yin'jing	0
水阙	shui'que	0
水云子	shui'yun'zi	0
四大女弟子	si'da'nv'di'zi	0
四恶神网	si'e'shen'wang	0
四金刚	si'jin'gang	0
司空虎	si'kong'hu	0
司空兰	si'kong'lan	0
司空玄	si'kong'xuan	0
司空湛	si'kong'zhan	0
司马寿	si'ma'shou	0
四妙仙娘	si'miao'xian'niang	0
四魔	si'mo	0
司青璜	si'qing'huang	0
四十六岛	si'shi'liu'dao	0
四十七岛	si'shi'qi'dao	0
四首神君	si'shou'shen'jun	0
四手天尊	si'shou'tian'zun	0
司太虚	si'tai'xu	0
司徒平	si'tu'ping	0
司徒兴明	si'tu'xing'ming	0
嵩山二老	song'shan'er'lao	0
宋香娃	song'xiang'wa	0
苏莲	su'lian	0
苏曼	su'man	0
夙孽	su'nie	0
苏宪祥	su'xian'xiang	0
素因	su'yin	0
随精精	sui'jing'jing	0
燧人钻	sui'ren'zuan	0
随心一	sui'xin'yi	0
随引	sui'yin	0
孙侗	sun'dong	0
孙洞玄	sun'dong'xuan	0
孙福	sun'fu	0
孙凌波	sun'ling'bo	0
孙南	sun'nan	0
孙询	sun'xun	0
孙毓桐	sun'yu'tong	0
桫椤灵符	suo'luo'ling'fu	0
锁心神索	suo'xin'shen'suo	0
锁阳钩	suo'yang'gou	0
锁阴神带	suo'yin'shen'dai	0
索影晶盘	suo'ying'jing'pan	0
太白	tai'bai	0
太白刺	tai'bai'ci	0
太白分光剑	tai'bai'fen'guang'jian	0
太白金刀	tai'bai'jin'dao	0
太白山	tai'bai'shan	0
太白仙姥	tai'bai'xian'lao	0
太白针等	tai'bai'zhen'deng	0
太行山	tai'hang'shan	0
太皓戈	tai'hao'ge	0
太皓钩	tai'hao'gou	0
太阳神光	tai'yang'shen'guang	0
太阳神针	tai'yang'shen'zhen	0
太阳真火	tai'yang'zhen'huo	0
太乙分光剑	tai'yi'fen'guang'jian	0
太乙混元祖师	tai'yi'hun'yuan'zu'shi	0
太乙金鳞舟	tai'yi'jin'lin'zhou	0
太乙青灵箭	tai'yi'qing'ling'jian	0
太乙青灵旗门	tai'yi'qing'ling'qi'men	0
太乙青灵神光	tai'yi'qing'ling'shen'guang	0
太乙青灵销	tai'yi'qing'ling'xiao	0
太乙青灵竹叶神符	tai'yi'qing'ling'zhu'ye'shen'fu	0
太乙圈	tai'yi'quan	0
太乙天罡剑	tai'yi'tian'gang'jian	0
太乙五烟罗	tai'yi'wu'yan'luo	0
太乙玄戈	tai'yi'xuan'ge	0
太阴鬼箓	tai'yin'gui'lu	0
太阴潜行之法	tai'yin'qian'xing'zhi'fa	0
太阴如意仙索	tai'yin'ru'yi'xian'suo	0
太阴玄经	tai'yin'xuan'jing	0
太阴元磁神雷	tai'yin'yuan'ci'shen'lei	0
谈飞	tan'fei	0
谈无尘	tan'wu'chen	0
谈嘻	tan'xi	0
汤成	tang'cheng	0
唐寰	tang'huan	0
唐家婆	tang'jia'po	0
唐铿	tang'keng	0
唐双影	tang'shuang'ying	0
唐西	tang'xi	0
陶昌	tao'chang	0
逃遁	tao'dun	0
陶和	tao'he	0
桃花飞刀	tao'hua'fei'dao	0
桃花七煞剑桃花七煞销魂网	tao'hua'qi'sha'jian'tao'hua'qi'sha'xiao'hun'wang	0
桃花七刹销魂网	tao'hua'qi'sha'xiao'hun'wang	0
桃花仙尼	tao'hua'xian'ni	0
桃花仙子	tao'hua'xian'zi	0
陶钧	tao'jun	0
桃木剑	tao'mu'jian	0
陶泉	tao'quan	0
陶西	tao'xi	0
腾蛇环	teng'she'huan	0
腾柱	teng'zhu	0
替身	ti'shen	0
天残	tian'can	0
天残地缺	tian'can'di'que	0
天蚕神网	tian'can'shen'wang	0
天蚕丝	tian'can'si	0
天蝉灵叶	tian'chan'ling'ye	0
天躔密魔神钉	tian'chan'mi'mo'shen'ding	0
天尘	tian'chen	0
天痴	tian'chi	0
天赤剑	tian'chi'jian	0
天池上人	tian'chi'shang'ren	0
天痴上人	tian'chi'shang'ren	0
天地	tian'di	0
天都	tian'du	0
天遁镜	tian'dun'jing	0
天恶真人	tian'e'zhen'ren	0
天浮杯	tian'fu'bei	0
天府晶镜	tian'fu'jing'jing	0
天府神箭	tian'fu'shen'jian	0
天罡雷珠	tian'gang'lei'zhu	0
天罡灵火	tian'gang'ling'huo	0
天罡珠	tian'gang'zhu	0
天狗崖	tian'gou'ya	0
天垢珠	tian'gou'zhu	0
天狐	tian'hu	0
天黄正气珠	tian'huang'zheng'qi'zhu	0
天慧剑	tian'hui'jian	0
天劫	tian'jie	0
天蓝神砂	tian'lan'shen'sha	0
天狼钉	tian'lang'ding	0
天龙伏魔剑	tian'long'fu'mo'jian	0
天龙剑	tian'long'jian	0
天龙剪	tian'long'jian	0
天聋老女	tian'long'lao'nv	0
天漏洞	tian'lou'dong	0
天芒刺	tian'mang'ci	0
天门神君	tian'men'shen'jun	0
天蒙	tian'meng	0
天苗岭	tian'miao'ling	0
天魔钉	tian'mo'ding	0
天魔解体大法	tian'mo'jie'ti'da'fa	0
天魔聚毒幡	tian'mo'ju'du'fan	0
天魔裂形大法	tian'mo'lie'xing'da'fa	0
天魔阴火幡	tian'mo'yin'huo'fan	0
天魔诛仙剑	tian'mo'zhu'xian'jian	0
天目山	tian'mu'shan	0
天木神针	tian'mu'shen'zhen	0
天宁珠	tian'ning'zhu	0
天蓬山	tian'peng'shan	0
天平山	tian'ping'shan	0
天破真人	tian'po'zhen'ren	0
田琪	tian'qi	0
天乾山	tian'qian'shan	0
天乾山小男	tian'qian'shan'xiao'nan	0
天缺	tian'que	0
天缺大师	tian'que'da'shi	0
天煞真人	tian'sha'zhen'ren	0
天山	tian'shan	0
田氏兄弟	tian'shi'xiong'di	0
天孙锦	tian'sun'jin	0
天孙锦仙衣	tian'sun'jin'xian'yi	0
天台	tian'tai	0
天瘟球	tian'wen'qiu	0
天仙	tian'xian	0
天象	tian'xiang	0
天象剑	tian'xiang'jian	0
天啸剑	tian'xiao'jian	0
天辛飞剑	tian'xin'fei'jian	0
天心环下	tian'xin'huan'xia	0
天心双环	tian'xin'shuang'huan	0
天心阳环	tian'xin'yang'huan	0
天心阴环	tian'xin'yin'huan	0
天刑刃	tian'xing'ren	0
天玄屏	tian'xuan'ping	0
天璇神砂	tian'xuan'shen'sha	0
田瑶	tian'yao	0
天一玄冰	tian'yi'xuan'bing	0
天一玄阴真气	tian'yi'xuan'yin'zhen'qi	0
天淫教	tian'yin'jiao	0
天淫娘子	tian'yin'niang'zi	0
天游子	tian'you'zi	0
天诛	tian'zhu	0
铁城山	tie'cheng'shan	0
铁刀峡	tie'dao'xia	0
铁笛仙	tie'di'xian	0
铁鼓吏	tie'gu'li	0
铁花坞	tie'hua'wu	0
铁面天僧	tie'mian'tian'seng	0
铁皮洞	tie'pi'dong	0
铁伞	tie'san	0
铁伞道人	tie'san'dao'ren	0
铁沙弥	tie'sha'mi	0
铁姝	tie'shu	0
铁蓑道人	tie'suo'dao'ren	0
铁掌僧	tie'zhang'seng	0
铁钟道人	tie'zhong'dao'ren	0
通臂神猿	tong'bi'shen'yuan	0
童么凤	tong'me'feng	0
同门	tong'men	0
童斯	tong'si	0
铜椰岛主	tong'ye'dao'zhu	0
佟元奇	tong'yuan'qi	0
透雾分光宝镜	tou'wu'fen'guang'bao'jing	0
偷袭	tou'xi	0
屠霸	tu'ba	0
兔儿神	tu'er'shen	0
土精	tu'jing	0
屠龙	tu'long	0
屠龙刀	tu'long'dao	0
屠龙师太	tu'long'shi'tai	0
屠媚	tu'mei	0
土木岛	tu'mu'dao	0
土木岛主	tu'mu'dao'zhu	0
土木晶砂	tu'mu'jing'sha	0
土木晶砂等	tu'mu'jing'sha'deng	0
屠三彪	tu'san'biao	0
屠沙	tu'sha	0
秃神君	tu'shen'jun	0
屠神子	tu'shen'zi	0
团沙岛	tuan'sha'dao	0
脱困而出	tuo'kun'er'chu	0
脱神解体之法	tuo'shen'jie'ti'zhi'fa	0
脱脱大师	tuo'tuo'da'shi	0
娲皇戈	wa'huang'ge	0
娲皇针	wa'huang'zhen	0
万蚕金钵	wan'can'jin'bo	0
万谷子	wan'gu'zi	0
万类	wan'lei	0
万里飞虹	wan'li'fei'hong	0
万灵童子	wan'ling'tong'zi	0
万妙仙姑	wan'miao'xian'gu	0
万目和尚	wan'mu'he'shang	0
万年温玉	wan'nian'wen'yu	0
万年续断	wan'nian'xu'duan	0
宛如珠	wan'ru'zhu	0
顽石大师	wan'shi'da'shi	0
万松岭	wan'song'ling	0
万秀山	wan'xiu'shan	0
万珍	wan'zhen	0
王娟娟	wang'juan'juan	0
王龙娥	wang'long'e	0
王母剪	wang'mu'jian	0
忘年之交	wang'nian'zhi'jiao	0
王森	wang'sen	0
王玉儿	wang'yu'er	0
魏八	wei'ba	0
韦八公	wei'ba'gong	0
韦标	wei'biao	0
魏枫娘	wei'feng'niang	0
卫寒樵	wei'han'qiao	0
未还	wei'huan	0
韦蛟	wei'jiao	0
韦居	wei'ju	0
未明神尼	wei'ming'shen'ni	0
为奴	wei'nu	0
魏七	wei'qi	0
魏青	wei'qing	0
韦青青	wei'qing'qing	0
韦容	wei'rong	0
韦少少	wei'shao'shao	0
魏说	wei'shuo	0
韦秃	wei'tu	0
卫仙客	wei'xian'ke	0
魏瑶芝	wei'yao'zhi	0
韦云和	wei'yun'he	0
文笔峰	wen'bi'feng	0
文成	wen'cheng	0
温娇	wen'jiao	0
文瑾	wen'jin	0
温良	wen'liang	0
温良玉	wen'liang'yu	0
温如花	wen'ru'hua	0
温三妹	wen'san'mei	0
温香教主	wen'xiang'jiao'zhu	0
文又方	wen'you'fang	0
我佛	wo'fo	0
卧眉峰	wo'mei'feng	0
卧云村	wo'yun'cun	0
仵备	wu'bei	0
五彩赤氛旗	wu'cai'chi'fen'qi	0
伍常山	wu'chang'shan	0
吴诚	wu'cheng	0
武当七女	wu'dang'qi'nv	0
武当掌门	wu'dang'zhang'men	0
无敌金刚	wu'di'jin'gang	0
五丁斧	wu'ding'fu	0
吴蝀	wu'dong	0
五毒剑	wu'du'jian	0
五毒天王	wu'du'tian'wang	0
五毒追魂红云砂	wu'du'zhui'hun'hong'yun'sha	0
五遁神桩	wu'dun'shen'zhuang	0
无发仙	wu'fa'xian	0
吴藩	wu'fan	0
吴凤	wu'feng	0
乌风道长	wu'feng'dao'chang	0
五福仙子	wu'fu'xian'zi	0
吴宫	wu'gong	0
五官	wu'guan	0
五鬼天王	wu'gui'tian'wang	0
五鬼天王尚和阳	wu'gui'tian'wang'shang'he'yang	0
五花蜂	wu'hua'feng	0
无华氏	wu'hua'shi	0
五火赤氛旗	wu'huo'chi'fen'qi	0
五火乾坤罗	wu'huo'qian'kun'luo	0
五火神雷	wu'huo'shen'lei	0
五火须弥针	wu'huo'xu'mi'zhen	0
仵江	wu'jiang	0
乌角	wu'jiao	0
乌金芒	wu'jin'mang	0
无咎上人	wu'jiu'shang'ren	0
五雷观	wu'lei'guan	0
五雷神锋	wu'lei'shen'feng	0
五雷神火弹	wu'lei'shen'huo'dan	0
五雷天方錾	wu'lei'tian'fang'zan	0
五雷真人	wu'lei'zhen'ren	0
吴立	wu'li	0
伍良	wu'liang	0
乌灵剑	wu'ling'jian	0
乌灵珠	wu'ling'zhu	0
乌龙剪	wu'long'jian	0
乌蛮	wu'man	0
吴玫	wu'mei	0
无明	wu'ming	0
无名和尚	wu'ming'he'shang	0
无名老尼	wu'ming'lao'ni	0
五魔	wu'mo	0
五木鬼师	wu'mu'gui'shi	0
巫拿阿	wu'na'a	0
巫启明	wu'qi'ming	0
邬勤	wu'qin	0
吴青心	wu'qing'xin	0
仵人龙	wu'ren'long	0
乌萨齐	wu'sa'qi	0
五色灵气	wu'se'ling'qi	0
巫山	wu'shan	0
巫山峡	wu'shan'xia	0
物神	wu'shen	0
伍神师	wu'shen'shi	0
乌神叟	wu'shen'sou	0
仵盛	wu'sheng	0
仵氏兄弟	wu'shi'xiong'di	0
吴讼	wu'song	0
五台	wu'tai	0
乌头婆	wu'tou'po	0
戊土真气	wu'tu'zhen'qi	0
吴文琪	wu'wen'qi	0
吴霄	wu'xiao	0
五泄山	wu'xie'shan	0
五行	wu'xing	0
无形长老曹枯竹	wu'xing'chang'lao'cao'ku'zhu	0
无形剑	wu'xing'jian	0
无形魔障	wu'xing'mo'zhang	0
无行魔障	wu'xing'mo'zhang	0
五行挪移迷魔障	wu'xing'nuo'yi'mi'mo'zhang	0
五行神火针	wu'xing'shen'huo'zhen	0
五行神炉	wu'xing'shen'lu	0
五行神线	wu'xing'shen'xian	0
五星神钺	wu'xing'shen'yue	0
无形长老	wu'xing'zhang'lao	0
无形诸天魔网	wu'xing'zhu'tian'mo'wang	0
无行尊者	wu'xing'zun'zhe	0
悟修	wu'xiu	0
乌牙洞	wu'ya'dong	0
吴燕	wu'yan	0
五叶飓母车	wu'ye'ju'mu'che	0
武夷山	wu'yi'shan	0
五阴毒雷	wu'yin'du'lei	0
五淫呼血兜	wu'yin'hu'xue'dou	0
五淫仙子	wu'yin'xian'zi	0
五淫尊者	wu'yin'zun'zhe	0
无影道士	wu'ying'dao'shi	0
无忧洞	wu'you'dong	0
乌鱼岛	wu'yu'dao	0
吴元智	wu'yuan'zhi	0
五岳行者	wu'yue'xing'zhe	0
五云步	wu'yun'bu	0
乌云神鲛网	wu'yun'shen'jiao'wang	0
五云石	wu'yun'shi	0
五云锁仙屏	wu'yun'suo'xian'ping	0
五云桃花毒瘴	wu'yun'tao'hua'du'zhang	0
五云桃花瘴	wu'yun'tao'hua'zhang	0
误斩	wu'zhan	0
乌鸩刺	wu'zhen'ci	0
五指山	wu'zhi'shan	0
五指神峰	wu'zhi'shen'feng	0
无终岭	wu'zhong'ling	0
五铢神女	wu'zhu'shen'nv	0
西川八魔	xi'chuan'ba'mo	0
西洞庭	xi'dong'ting	0
西方野佛	xi'fang'ye'fo	0
西海	xi'hai	0
膝角	xi'jiao	0
西崆峒	xi'kong'tong	0
西昆仑	xi'kun'lun	0
西昆山	xi'kun'shan	0
西来	xi'lai	0
西溟岛	xi'ming'dao	0
西神剑	xi'shen'jian	0
郗涛	xi'tao	0
吸星球	xi'xing'qiu	0
吸星神簪	xi'xing'shen'zan	0
细腰仙娘	xi'yao'xian'niang	0
西藏魔教	xi'zang'mo'jiao	0
夏三娘	xia'san'niang	0
侠僧	xia'seng	0
侠僧轶凡	xia'seng'yi'fan	0
夏寅	xia'yin	0
仙草	xian'cao	0
仙都	xian'du	0
仙都二女	xian'du'er'nv	0
陷空	xian'kong	0
陷空岛	xian'kong'dao	0
陷空老祖	xian'kong'lao'zu	0
陷身	xian'shen	0
先师	xian'shi	0
仙桃嶂	xian'tao'zhang	0
先天大衍神术	xian'tian'da'yan'shen'shu	0
先天神术	xian'tian'shen'shu	0
先天水母坎金丸	xian'tian'shui'mu'kan'jin'wan	0
仙霞岭	xian'xia'ling	0
冼盈	xian'ying	0
仙掌雷	xian'zhang'lei	0
香城娘	xiang'cheng'niang	0
香城娘子	xiang'cheng'niang'zi	0
向芳淑	xiang'fang'shu	0
项纪	xiang'ji	0
湘江	xiang'jiang	0
香兰	xiang'lan	0
香兰渚	xiang'lan'zhu	0
相貌奇丑	xiang'mao'qi'chou	0
降魔	xiang'mo	0
降魔锡杖	xiang'mo'xi'zhang	0
香泉谷	xiang'quan'gu	0
向善	xiang'shan	0
香雾真人	xiang'wu'zhen'ren	0
香雪洞	xiang'xue'dong	0
向义	xiang'yi	0
香云宝盖	xiang'yun'bao'gai	0
小阿修罗法	xiao'a'xiu'luo'fa	0
萧宝娘	xiao'bao'niang	0
萧成捷	xiao'cheng'jie	0
萧玢	xiao'fen	0
小寒山	xiao'han'shan	0
笑和尚	xiao'he'shang	0
销魂鉴	xiao'hun'jian	0
小火神	xiao'huo'shen	0
小金女	xiao'jin'nv	0
萧琏	xiao'lian	0
小灵猴	xiao'ling'hou	0
小菱洲	xiao'ling'zhou	0
小流沙	xiao'liu'sha	0
小螺洲	xiao'luo'zhou	0
萧勉	xiao'mian	0
小男	xiao'nan	0
小南极	xiao'nan'ji	0
小南极磁光子午线	xiao'nan'ji'ci'guang'zi'wu'xian	0
小哪吒	xiao'ne'zha	0
小蓬莱	xiao'peng'lai	0
萧清	xiao'qing	0
削去	xiao'qu	0
小髯客	xiao'ran'ke	0
小人国	xiao'ren'guo	0
小杀星	xiao'sha'xing	0
枭神娘	xiao'shen'niang	0
小神僧	xiao'shen'seng	0
萧十九妹	xiao'shi'jiu'mei	0
萧泰	xiao'tai	0
萧武	xiao'wu	0
小仙童子	xiao'xian'tong'zi	0
小仙源	xiao'xian'yuan	0
萧琇	xiao'xiu	0
萧璇	xiao'xuan	0
小衍神数	xiao'yan'shen'shu	0
小瑶宫	xiao'yao'gong	0
萧野	xiao'ye	0
小夜叉	xiao'ye'cha	0
萧逸	xiao'yi	0
萧玉	xiao'yu	0
萧元	xiao'yuan	0
晓月	xiao'yue	0
晓月禅师	xiao'yue'chan'shi	0
小云山	xiao'yun'shan	0
萧泽长	xiao'ze'chang	0
萧璋	xiao'zhang	0
萧珍	xiao'zhen	0
萧真人	xiao'zhen'ren	0
邪法	xie'fa	0
谢芳霞	xie'fang'xia	0
谢琳	xie'lin	0
邪气	xie'qi	0
谢山	xie'shan	0
谢无化	xie'wu'hua	0
谢璎	xie'ying	0
邪正之间	xie'zheng'zhi'jian	0
蝎尊者	xie'zun'zhe	0
心爱	xin'ai	0
辛辰子	xin'chen'zi	0
心灯	xin'deng	0
新疆	xin'jiang	0
辛金剑煞	xin'jin'jian'sha	0
心灵剑	xin'ling'jian	0
心灵相合	xin'ling'xiang'he	0
辛凌霄	xin'ling'xiao	0
心明神尼	xin'ming'shen'ni	0
辛青	xin'qing	0
心如	xin'ru	0
心如神尼	xin'ru'shen'ni	0
邢馄	xing'hun	0
邢开甲	xing'kai'jia	0
邢曼	xing'man	0
性情古怪	xing'qing'gu'guai	0
形神皆灭	xing'shen'jie'mie	0
邢天和	xing'tian'he	0
邢天相	xing'tian'xiang	0
星宿海	xing'xiu'hai	0
凶魂	xiong'hun	0
熊曼娘	xiong'man'niang	0
雄狮岭	xiong'shi'ling	0
熊血儿	xiong'xue'er	0
修炼	xiu'lian	0
修罗刀	xiu'luo'dao	0
修罗幡	xiu'luo'fan	0
修罗雷珠	xiu'luo'lei'zhu	0
修罗神钉	xiu'luo'shen'ding	0
修罗网	xiu'luo'wang	0
修罗錾	xiu'luo'zan	0
许超	xu'chao	0
许芳	xu'fang	0
许飞娘	xu'fei'niang	0
须弥神光	xu'mi'shen'guang	0
徐全	xu'quan	0
徐神君	xu'shen'jun	0
许陶	xu'tao	0
徐通	xu'tong	0
徐完	xu'wan	0
徐祥鹅	xu'xiang'e	0
吁吁	xu'xu	0
许元通	xu'yuan'tong	0
徐岳	xu'yue	0
许钺	xu'yue	0
玄都剑	xuan'du'jian	0
玄都羽士	xuan'du'yu'shi	0
玄儿	xuan'er	0
玄功	xuan'gong	0
玄功变化	xuan'gong'bian'hua	0
璇光尺	xuan'guang'chi	0
玄龟剑	xuan'gui'jian	0
玄金	xuan'jin	0
玄女庙住持	xuan'nv'miao'zhu'chi	0
玄女针	xuan'nv'zhen	0
玄牝	xuan'pin	0
玄牝珠	xuan'pin'zhu	0
玄殊仙子	xuan'shu'xian'zi	0
玄天姥姥	xuan'tian'lao'lao	0
玄武乌煞罗喉血焰神罡	xuan'wu'wu'sha'luo'hou'xue'yan'shen'gang	0
玄阴峒	xuan'yin'dong	0
玄阴洞	xuan'yin'dong	0
玄阴二五斩魂刀	xuan'yin'er'wu'zhan'hun'dao	0
玄阴简	xuan'yin'jian	0
玄阴聚兽幡	xuan'yin'ju'shou'fan	0
玄阴神幕	xuan'yin'shen'mu	0
玄阴神煞	xuan'yin'shen'sha	0
玄阴真煞	xuan'yin'zhen'sha	0
玄英剑	xuan'ying'jian	0
玄玉	xuan'yu	0
轩辕	xuan'yuan	0
轩辕老怪	xuan'yuan'lao'guai	0
轩辕墓	xuan'yuan'mu	0
玄真子	xuan'zhen'zi	0
血光护神之法	xue'guang'hu'shen'zhi'fa	0
血河仙娘	xue'he'xian'niang	0
血花神刀	xue'hua'shen'dao	0
雪魂珠	xue'hun'zhu	0
雪窟	xue'ku	0
雪浪岛	xue'lang'dao	0
雪浪山	xue'lang'shan	0
血莲	xue'lian	0
薛蟒	xue'mang	0
薛萍	xue'ping	0
血刹幡	xue'sha'fan	0
雪山	xue'shan	0
雪山老魅	xue'shan'lao'mei	0
雪山派	xue'shan'pai	0
血神经	xue'shen'jing	0
血神子	xue'shen'zi	0
雪叟	xue'sou	0
雪雪老人	xue'xue'lao'ren	0
血焰叉血焰金刀	xue'yan'cha'xue'yan'jin'dao	0
血焰针	xue'yan'zhen	0
血影	xue'ying	0
巽地风雷	xun'di'feng'lei	0
荀兰因	xun'lan'yin	0
巽灵珠	xun'ling'zhu	0
哑道人	ya'dao'ren	0
崖洞	ya'dong	0
雅各达	ya'ge'da	0
丫鬟	ya'huan	0
鸦利	ya'li	0
鸦林砦	ya'lin'zhai	0
严梦生	yan'meng'sheng	0
鄢妮	yan'ni	0
阎耆珠	yan'qi'zhu	0
严人英	yan'ren'ying	0
鄢什	yan'shen	0
艳尸	yan'shi	0
艳尸崔盈	yan'shi'cui'ying	0
严师婆	yan'shi'po	0
鄢望	yan'wang	0
严媖姆	yan'ying'mu	0
阳阿老人	yang'a'lao'ren	0
杨成志	yang'cheng'zhi	0
杨达	yang'da	0
杨姑婆	yang'gu'po	0
杨厚	yang'hou	0
杨花	yang'hua	0
阳健	yang'jian	0
羊角岭	yang'jiao'ling	0
杨瑾	yang'jin	0
阳九七星环	yang'jiu'qi'xing'huan	0
杨鲤	yang'li	0
阳魄剑	yang'po'jian	0
阳乌球	yang'wu'qiu	0
杨孝	yang'xiao	0
杨玉龙	yang'yu'long	0
杨珍	yang'zhen	0
妖道	yao'dao	0
妖幡	yao'fan	0
妖妇	yao'fu	0
姚海翁	yao'hai'weng	0
姚开江	yao'kai'jiang	0
妖窟	yao'ku	0
妖人	yao'ren	0
姚瑟	yao'se	0
妖僧	yao'seng	0
妖尸	yao'shi	0
妖童	yao'tong	0
妖仙	yao'xian	0
妖蚿	yao'xian	0
叶缤	ye'bin	0
耶迦宝相轮	ye'jia'bao'xiang'lun	0
野人山	ye'ren'shan	0
一尘禅师	yi'chen'chan'shi	0
一代弟	yi'dai'di	0
翼道人	yi'dao'ren	0
一灯上人	yi'deng'shang'ren	0
易鼎	yi'ding	0
轶凡	yi'fan	0
乙光剑	yi'guang'jian	0
伊红樱	yi'hong'ying	0
依环岭	yi'huan'ling	0
一甲子	yi'jia'zi	0
易静	yi'jing	0
乙木精灵	yi'mu'jing'ling	0
乙木神丹	yi'mu'shen'dan	0
乙木天罗	yi'mu'tian'luo	0
异派	yi'pai	0
伊佩章	yi'pei'zhang	0
移山缩地法	yi'shan'suo'di'fa	0
易晟	yi'sheng	0
易氏弟兄	yi'shi'di'xiong	0
异兽	yi'shou	0
乙休	yi'xiu	0
一音	yi'yin	0
一元妙用	yi'yuan'miao'yong	0
易震	yi'zhen	0
一真上人	yi'zhen'shang'ren	0
易周	yi'zhou	0
一子七真	yi'zi'qi'zhen	0
淫毒	yin'du	0
阴风八卦幡	yin'feng'ba'gua'fan	0
阴风洞	yin'feng'dong	0
银河剑	yin'he'jian	0
阴绝尘崖	yin'jue'chen'ya	0
因空师太	yin'kong'shi'tai	0
阴雷珠	yin'lei'zhu	0
阴磷火箭	yin'lin'huo'jian	0
阴磷神火珠	yin'lin'shen'huo'zhu	0
阴灵幡	yin'ling'fan	0
阴灵牌	yin'ling'pai	0
阴魔迷箓	yin'mo'mi'lu	0
阴魔网	yin'mo'wang	0
银泥岛	yin'ni'dao	0
银姝	yin'shu	0
阴四娘	yin'si'niang	0
尹松云	yin'song'yun	0
阴素棠	yin'su'tang	0
淫娃	yin'wa	0
隐形法	yin'xing'fa	0
隐行幡	yin'xing'fan	0
银须叟	yin'xu'sou	0
阴阳	yin'yang	0
阴阳两形幡	yin'yang'liang'xing'fan	0
阴阳叟	yin'yang'sou	0
媖姆	ying'mu	0
瑛姆	ying'mu	0
英男	ying'nan	0
英琼	ying'qiong	0
尤鳌	you'ao	0
右臂	you'bi	0
有根禅师	you'gen'chan'shi	0
幽灵碧焰梭	you'ling'bi'yan'suo	0
游龙子	you'long'zi	0
尤太真	you'tai'zhen	0
优昙	you'tan	0
幼童	you'tong	0
有形无质	you'xing'wu'zhi	0
尤于冰	you'yu'bing	0
有缘人	you'yuan'ren	0
玉版峡	yu'ban'xia	0
玉螭宫	yu'chi'gong	0
尉迟火	yu'chi'huo	0
尉迟元	yu'chi'yuan	0
郁次谷	yu'ci'gu	0
俞德	yu'de	0
禹鼎	yu'ding	0
玉洞真人	yu'dong'zhen'ren	0
玉洞真人岳韫	yu'dong'zhen'ren'yue'yun	0
于端	yu'duan	0
郁芳蘅	yu'fang'heng	0
玉飞来	yu'fei'lai	0
玉杆真人	yu'gan'zhen'ren	0
余恭	yu'gong	0
于亨	yu'heng	0
玉虎	yu'hu	0
玉虎剑	yu'hu'jian	0
羽化	yu'hua	0
雨花崖	yu'hua'ya	0
玉环	yu'huan	0
于建	yu'jian	0
俞利	yu'li	0
鱼龙幻光球	yu'long'huan'guang'qiu	0
玉龙剑	yu'long'jian	0
玉龙铡	yu'long'zha	0
俞峦	yu'luan	0
玉罗刹	yu'luo'cha	0
玉面吼	yu'mian'hou	0
玉娘子	yu'niang'zi	0
余孽	yu'nie	0
于潜琉璃	yu'qian'liu'li	0
玉清	yu'qing	0
玉清师太	yu'qing'shi'tai	0
玉泉洞	yu'quan'dong	0
渔人	yu'ren	0
鱼仁	yu'ren	0
玉神君	yu'shen'jun	0
玉绳仙子	yu'sheng'xian'zi	0
虞舜农	yu'shun'nong	0
余娲	yu'wa	0
禹王鉴	yu'wang'jian	0
玉匣	yu'xia	0
玉仙童	yu'xian'tong	0
于湘竹	yu'xiang'zhu	0
虞孝	yu'xiao	0
玉虚峰	yu'xu'feng	0
余珣姑	yu'xun'gu	0
余莹姑	yu'ying'gu	0
余英男	yu'ying'nan	0
俞允中	yu'yun'zhong	0
余暂公	yu'zan'gong	0
余中	yu'zhong	0
虞重	yu'zhong	0
宇宙六怪	yu'zhou'liu'guai	0
玉柱洞	yu'zhu'dong	0
元达	yuan'da	0
元凡	yuan'fan	0
元癸神剑	yuan'gui'shen'jian	0
元皓	yuan'hao	0
猿猴	yuan'hou	0
袁化	yuan'hua	0
圆寂	yuan'ji	0
元江	yuan'jiang	0
元江夺宝	yuan'jiang'duo'bao	0
元敬	yuan'jing	0
元觉禅师	yuan'jue'chan'shi	0
元灵	yuan'ling	0
袁灵	yuan'ling	0
圆满	yuan'man	0
袁三娘	yuan'san'niang	0
元神	yuan'shen	0
元胎	yuan'tai	0
元象圈	yuan'xiang'quan	0
袁星	yuan'xing	0
鸳鸯霹雳剑	yuan'yang'pi'li'jian	0
元元大师	yuan'yuan'da'shi	0
元运球	yuan'yun'qiu	0
猿长老	yuan'zhang'lao	0
越城岭	yue'cheng'ling	0
岳大鹏	yue'da'peng	0
月儿岛	yue'er'dao	0
越女	yue'nv	0
越女剑诀	yue'nv'jian'jue	0
越女经	yue'nv'jing	0
岳琴滨	yue'qin'bin	0
岳雯	yue'wen	0
岳韫	yue'yun	0
云凤	yun'feng	0
云梗窝	yun'geng'wo	0
云九姑	yun'jiu'gu	0
云雷仙网	yun'lei'xian'wang	0
云雷真人	yun'lei'zhen'ren	0
云灵山	yun'ling'shan	0
云萝娘	yun'luo'niang	0
云梦山	yun'meng'shan	0
云南	yun'nan	0
云雾幡	yun'wu'fan	0
云雾山	yun'wu'shan	0
云翼	yun'yi	0
云紫绡	yun'zi'xiao	0
再传徒孙	zai'chuan'tu'sun	0
曾孙	zeng'sun	0
翟度	zhai'du	0
斩断	zhan'duan	0
斩断一臂	zhan'duan'yi'bi	0
旃檀佛火	zhan'tan'fo'huo	0
张春桃	zhang'chun'tao	0
章虎儿	zhang'hu'er	0
掌教	zhang'jiao	0
张锦雯	zhang'jin'wen	0
张老四	zhang'lao'si	0
章狸	zhang'li	0
张亮	zhang'liang	0
章勉	zhang'mian	0
章南姑	zhang'nan'gu	0
张琪	zhang'qi	0
张三姑姑	zhang'san'gu'gu	0
张瑶青	zhang'yao'qing	0
张玉	zhang'yu	0
张玉珍	zhang'yu'zhen	0
张则	zhang'ze	0
章彰	zhang'zhang	0
赵长素	zhao'chang'su	0
召富	zhao'fu	0
赵光斗	zhao'guang'dou	0
赵蕙	zhao'hui	0
赵金珍	zhao'jin'zhen	0
赵铁娘	zhao'tie'niang	0
赵心源	zhao'xin'yuan	0
赵燕儿	zhao'yan'er	0
昭远寺	zhao'yuan'si	0
真谛	zhen'di	0
甄兑	zhen'dui	0
甄艮	zhen'gen	0
甄海	zhen'hai	0
真人	zhen'ren	0
真如剪	zhen'ru'jian	0
震岳宫	zhen'yue'gong	0
震岳神君	zhen'yue'shen'jun	0
郑颠仙	zheng'dian'xian	0
正果	zheng'guo	0
正派剑仙	zheng'pai'jian'xian	0
正修庵	zheng'xiu'an	0
郑元规	zheng'yuan'gui	0
知非禅师	zhi'fei'chan'shi	0
智公	zhi'gong	0
智公禅师	zhi'gong'chan'shi	0
至交	zhi'jiao	0
之精	zhi'jing	0
知客僧	zhi'ke'seng	0
之妙	zhi'miao	0
智能	zhi'neng	0
之气	zhi'qi	0
智通和尚	zhi'tong'he'shang	0
钟昂	zhong'ang	0
钟敢	zhong'gan	0
钟量	zhong'liang	0
终南派	zhong'nan'pai	0
终南山	zhong'nan'shan	0
众生环	zhong'sheng'huan	0
中条山	zhong'tiao'shan	0
中土	zhong'tu	0
钟先生	zhong'xian'sheng	0
钟在	zhong'zai	0
周淳	zhou'chun	0
周琅	zhou'lang	0
周轻云	zhou'qing'yun	0
周身	zhou'shen	0
周云从	zhou'yun'cong	0
周中汇	zhou'zhong'hui	0
朱百灵	zhu'bai'ling	0
朱赤午	zhu'chi'wu	0
逐出门墙	zhu'chu'men'qiang	0
祝鹗	zhu'e	0
诸葛警我	zhu'ge'jing'wo	0
诸葛英	zhu'ge'ying	0
朱合	zhu'he	0
朱洪	zhu'hong	0
朱红	zhu'hong	0
朱灵	zhu'ling	0
珠灵涧	zhu'ling'jian	0
朱鸾	zhu'luan	0
朱梅	zhu'mei	0
朱苹	zhu'ping	0
朱柔	zhu'rou	0
诛杀	zhu'sha	0
朱砂吼	zhu'sha'hou	0
竹山教	zhu'shan'jiao	0
竺声	zhu'sheng	0
竺生	zhu'sheng	0
竺笙	zhu'sheng	0
竺氏三姐弟	zhu'shi'san'jie'di	0
诸天宝鉴	zhu'tian'bao'jian	0
诸天挪移大法	zhu'tian'nuo'yi'da'fa	0
诸天摄形镜	zhu'tian'she'xing'jing	0
诸天神魔化血飞身大法	zhu'tian'shen'mo'hua'xue'fei'shen'da'fa	0
诸天五淫丝	zhu'tian'wu'yin'si	0
诸天星辰秘魔七绝乌梭	zhu'tian'xing'chen'mi'mo'qi'jue'wu'suo	0
诸天欲魔五淫脂魔法	zhu'tian'yu'mo'wu'yin'zhi'mo'fa	0
朱文	zhu'wen	0
朱逍遥	zhu'xiao'yao	0
诛邪刀	zhu'xie'dao	0
朱樱	zhu'ying	0
诸有功	zhu'you'gong	0
朱由穆	zhu'you'mu	0
转轮钵	zhuan'lun'bo	0
转世	zhuan'shi	0
庄易	zhuang'yi	0
追魂娘子	zhui'hun'niang'zi	0
追魂五毒砂	zhui'hun'wu'du'sha	0
追云叟	zhui'yun'sou	0
卓远峰	zhuo'yuan'feng	0
紫府迷笈	zi'fu'mi'ji	0
紫光指甲	zi'guang'zhi'jia	0
紫河魔焰	zi'he'mo'yan	0
紫金钵盂	zi'jin'bo'yu	0
紫金冠	zi'jin'guan	0
紫金泷	zi'jin'long	0
紫金梭	zi'jin'suo	0
紫面伽蓝	zi'mian'qie'lan	0
子母传音针	zi'mu'chuan'yin'zhen	0
子母戮魂珠	zi'mu'lu'hun'zhu	0
子母三才降魔针	zi'mu'san'cai'xiang'mo'zhen	0
子母针	zi'mu'zhen	0
紫青双剑	zi'qing'shuang'jian	0
紫清玉女	zi'qing'yu'nv	0
紫霆珠	zi'ting'zhu	0
子午火云针	zi'wu'huo'yun'zhen	0
紫烟锄	zi'yan'chu	0
紫郢	zi'ying	0
紫郢剑	zi'ying'jian	0
紫云	zi'yun	0
紫云宫	zi'yun'gong	0
紫云障	zi'yun'zhang	0
宗德	zong'de	0
醉道人	zui'dao'ren	0
尊胜禅师	zun'sheng'chan'shi	0
尊者	zun'zhe	0
左道	zuo'dao	0
坐化	zuo'hua	0
左清虚	zuo'qing'xu	0
座下	zuo'xia	0
左心	zuo'xin	0
