阿长与山海经	a'chang'yu'shan'hai'jing	0
爱莲说	ai'lian'shuo	0
陈太丘与友期行	chen'tai'qiu'yu'you'qi'xing	0
春夜洛城闻笛	chun'ye'luo'cheng'wen'di	0
次北固山下	ci'bei'gu'shan'xia	0
从百草园到三味书屋	cong'bai'cao'yuan'dao'san'wei'shu'wu	0
带上她的眼睛	dai'shang'ta'de'yan'jing	0
登飞来峰	deng'fei'lai'feng	0
邓稼先	deng'jia'xian	0
登幽州台歌	deng'you'zhou'tai'ge	0
动物笑谈	dong'wu'xiao'tan	0
峨眉山月歌	e'mei'shan'yue'ge	0
逢入京使	feng'ru'jing'shi	0
观沧海	guan'cang'hai	0
赫尔墨斯和雕像者	he'er'mo'si'he'diao'xiang'zhe	0
荷叶母亲	he'ye'mu'qin	0
皇帝的新装	huang'di'de'xin'zhuang	0
黄河颂	huang'he'song	0
回忆鲁迅先生	hui'yi'lu'xun'xian'sheng	0
己亥杂诗	ji'hai'za'shi	0
济南的冬天	ji'nan'de'dong'tian	0
纪念白求恩	ji'nian'bai'qiu'en	0
假如生活欺骗了你	jia'ru'sheng'huo'qi'pian'le'ni	0
江南逢李龟年	jiang'nan'feng'li'gui'nian	0
诫子书	jie'zi'shu	0
金色花	jin'se'hua	0
老山界	lao'shan'jie	0
老王	lao'wang	0
陋室铭	lou'shi'ming	0
论语十二章	lun'yu'shi'er'zhang	0
卖油翁	mai'you'weng	0
木兰诗	mu'lan'shi	0
女娲造人	nv'wa'zao'ren	0
秋天的怀念	qiu'tian'de'huai'nian	0
散步	san'bu	0
说和做记闻一多先生言行片段	shuo'he'zuo'ji'wen'yi'duo'xian'sheng'yan'xing'pian'duan	0
孙权劝学	sun'quan'quan'xue	0
台阶	tai'jie	0
太空一日	tai'kong'yi'ri	0
天净沙秋思	tian'jing'sha'qiu'si	0
天上的街市	tian'shang'de'jie'shi	0
土地的誓言	tu'di'de'shi'yan	0
晚春	wan'chun	0
望岳	wang'yue	0
伟大的悲剧	wei'da'de'bei'ju	0
未选择的路	wei'xuan'ze'de'lu	0
闻王昌龄左迁龙标遥有此寄	wen'wang'chang'ling'zuo'qian'long'biao'yao'you'ci'ji	0
蚊子和狮子	wen'zi'he'shi'zi	0
行军九日思长安故园	xing'jun'jiu'ri'si'chang'an'gu'yuan	0
夜上受降城闻笛	ye'shang'shou'xiang'cheng'wen'di	0
叶圣陶先生二三事	ye'sheng'tao'xian'sheng'er'san'shi	0
一颗小桃树	yi'ke'xiao'tao'shu	0
驿路梨花	yi'lu'li'hua	0
咏雪	yong'xue	0
游山西村	you'shan'xi'cun	0
雨的四季	yu'de'si'ji	0
再塑生命的人	zai'su'sheng'ming'de'ren	0
植树的牧羊人	zhi'shu'de'mu'yang'ren	0
竹里馆	zhu'li'guan	0
紫藤萝瀑布	zi'teng'luo'pu'bu	0
走一步再走一步	zou'yi'bu'zai'zou'yi'bu	0
最苦与最乐	zui'ku'yu'zui'le	0
