百香	bai'xiang	0
百香御	bai'xiang'yu	0
百香御湿	bai'xiang'yu'shi	0
百香御湿贴	bai'xiang'yu'shi'tie	0
柏榆	bai'yu	0
苍植	cang'zhi	0
苍植通渊	cang'zhi'tong'yuan	0
婵君堂康茵宁	chan'jun'tang'kang'yin'ning	0
婵君堂坤淑康茵宁	chan'jun'tang'kun'shu'kang'yin'ning	0
抚痕	fu'hen	0
抚痕膏	fu'hen'gao	0
抚痕焕肤	fu'hen'huan'fu	0
抚痕焕肤膏	fu'hen'huan'fu'gao	0
肛舒	gang'shu	0
肛舒宁	gang'shu'ning	0
肛舒宁菊	gang'shu'ning'ju	0
肛舒宁菊安膏	gang'shu'ning'ju'an'gao	0
荷梅	he'mei	0
荷梅轻畅	he'mei'qing'chang	0
荷梅轻畅膏	he'mei'qing'chang'gao	0
虎元	hu'yuan	0
虎元贴	hu'yuan'tie	0
化痔	hua'zhi	0
化痔康	hua'zhi'kang	0
槐柏	huai'bai	0
槐柏化痔康	huai'bai'hua'zhi'kang	0
槐连	huai'lian	0
槐连柏	huai'lian'bai	0
槐连柏榆	huai'lian'bai'yu	0
槐连柏榆化痔康	huai'lian'bai'yu'hua'zhi'kang	0
槐连化痔康	huai'lian'hua'zhi'kang	0
焕肤	huan'fu	0
焕肤膏	huan'fu'gao	0
金桂	jin'gui	0
金桂宁	jin'gui'ning	0
金桂宁酸	jin'gui'ning'suan	0
金桂宁酸舒风贴	jin'gui'ning'suan'shu'feng'tie	0
金桂宁酸贴	jin'gui'ning'suan'tie	0
金桂舒风	jin'gui'shu'feng	0
金桂舒风贴	jin'gui'shu'feng'tie	0
九珍贴	jiu'zhen'tie	0
菊安	ju'an	0
菊安膏	ju'an'gao	0
康茵	kang'yin	0
康茵宁	kang'yin'ning	0
坤淑	kun'shu	0
坤淑康	kun'shu'kang	0
坤淑康茵	kun'shu'kang'yin	0
坤淑康茵宁	kun'shu'kang'yin'ning	0
鹿参	lu'can	0
鹿参虎元	lu'can'hu'yuan	0
鹿参虎元贴	lu'can'hu'yuan'tie	0
鹿参培阳	lu'can'pei'yang	0
鹿参培阳虎元贴	lu'can'pei'yang'hu'yuan'tie	0
鹿参培阳贴	lu'can'pei'yang'tie	0
鹿阳	lu'yang	0
鹿阳贴	lu'yang'tie	0
迷迭香人参眼膜	mi'die'xiang'ren'shen'yan'mo	0
明时通乾阳贴	ming'shi'tong'qian'yang'tie	0
明时通参茸贴	ming'shi'tong'shen'rong'tie	0
沐小白	mu'xiao'bai	0
沐小白荷梅轻畅膏	mu'xiao'bai'he'mei'qing'chang'gao	0
沐小百乾元片	mu'xiao'bai'qian'yuan'pian	0
沐小白轻畅膏	mu'xiao'bai'qing'chang'gao	0
沐小百三鞭乾元片	mu'xiao'bai'san'bian'qian'yuan'pian	0
宁菊安	ning'ju'an	0
宁酸	ning'suan	0
宁酸舒风	ning'suan'shu'feng	0
宁酸舒风贴	ning'suan'shu'feng'tie	0
培阳	pei'yang	0
培阳虎元	pei'yang'hu'yuan	0
培阳虎元贴	pei'yang'hu'yuan'tie	0
平创	ping'chuang	0
平创抚痕	ping'chuang'fu'hen	0
平创抚痕膏	ping'chuang'fu'hen'gao	0
平创抚痕焕肤膏	ping'chuang'fu'hen'huan'fu'gao	0
平创焕肤	ping'chuang'huan'fu	0
平创焕肤膏	ping'chuang'huan'fu'gao	0
乾烈	qian'lie	0
乾烈膏	qian'lie'gao	0
乾烈贴	qian'lie'tie	0
乾阳	qian'yang	0
乾阳贴	qian'yang'tie	0
乾元	qian'yuan	0
乾元片	qian'yuan'pian	0
轻畅	qing'chang	0
轻畅膏	qing'chang'gao	0
青罗	qing'luo	0
青罗记	qing'luo'ji	0
青罗记迷迭香人参眼膜	qing'luo'ji'mi'die'xiang'ren'shen'yan'mo	0
青罗记迷迭香眼膜	qing'luo'ji'mi'die'xiang'yan'mo	0
青罗记人参眼膜	qing'luo'ji'ren'shen'yan'mo	0
青罗记眼膜	qing'luo'ji'yan'mo	0
清湿	qing'shi	0
清湿贴	qing'shi'tie	0
三鞭	san'bian	0
三鞭乾	san'bian'qian	0
三鞭乾元	san'bian'qian'yuan	0
三鞭乾元片	san'bian'qian'yuan'pian	0
三花	san'hua	0
三花乾烈	san'hua'qian'lie	0
三花乾烈膏	san'hua'qian'lie'gao	0
参茸	shen'rong	0
参茸乾阳	shen'rong'qian'yang	0
参茸乾阳贴	shen'rong'qian'yang'tie	0
参茸雄元	shen'rong'xiong'yuan	0
参茸雄元乾阳贴	shen'rong'xiong'yuan'qian'yang'tie	0
参茸雄元贴	shen'rong'xiong'yuan'tie	0
十味	shi'wei	0
十味益骨	shi'wei'yi'gu	0
十味益骨贴	shi'wei'yi'gu'tie	0
十味致高	shi'wei'zhi'gao	0
十味致高贴	shi'wei'zhi'gao'tie	0
十味致高益骨贴	shi'wei'zhi'gao'yi'gu'tie	0
舒风	shu'feng	0
舒风贴	shu'feng'tie	0
泰致	tai'zhi	0
泰致逍	tai'zhi'xiao	0
泰致逍九珍贴	tai'zhi'xiao'jiu'zhen'tie	0
天香	tian'xiang	0
天香清	tian'xiang'qing	0
天香清湿	tian'xiang'qing'shi	0
天香清湿贴	tian'xiang'qing'shi'tie	0
通渊	tong'yuan	0
通渊膏	tong'yuan'gao	0
万养	wan'yang	0
万养堂	wan'yang'tang	0
万养堂荷梅轻畅膏	wan'yang'tang'he'mei'qing'chang'gao	0
万养堂乾烈膏	wan'yang'tang'qian'lie'gao	0
万养堂乾元片	wan'yang'tang'qian'yuan'pian	0
万养堂轻畅膏	wan'yang'tang'qing'chang'gao	0
万养堂三鞭乾元片	wan'yang'tang'san'bian'qian'yuan'pian	0
万养堂三花膏	wan'yang'tang'san'hua'gao	0
万养堂三花乾烈膏	wan'yang'tang'san'hua'qian'lie'gao	0
肖氏乾烈膏	xiao'shi'qian'lie'gao	0
肖氏轻畅膏	xiao'shi'qing'chang'gao	0
肖氏三花膏	xiao'shi'san'hua'gao	0
肖氏三花乾烈膏	xiao'shi'san'hua'qian'lie'gao	0
辛白	xin'bai	0
辛白苍	xin'bai'cang	0
辛白苍植	xin'bai'cang'zhi	0
辛白苍植膏	xin'bai'cang'zhi'gao	0
辛白苍植通渊膏	xin'bai'cang'zhi'tong'yuan'gao	0
辛白通渊	xin'bai'tong'yuan	0
辛白通渊膏	xin'bai'tong'yuan'gao	0
雄元	xiong'yuan	0
雄元乾阳	xiong'yuan'qian'yang	0
雄元乾阳贴	xiong'yuan'qian'yang'tie	0
益骨	yi'gu	0
益骨贴	yi'gu'tie	0
益康	yi'kang	0
亿康百香御湿贴	yi'kang'bai'xiang'yu'shi'tie	0
亿康抚痕膏	yi'kang'fu'hen'gao	0
亿康抚痕焕肤膏	yi'kang'fu'hen'huan'fu'gao	0
亿康肛舒宁菊安膏	yi'kang'gang'shu'ning'ju'an'gao	0
亿康虎元贴	yi'kang'hu'yuan'tie	0
亿康槐柏化痔康	yi'kang'huai'bai'hua'zhi'kang	0
亿康槐连化痔康	yi'kang'huai'lian'hua'zhi'kang	0
亿康焕肤膏	yi'kang'huan'fu'gao	0
亿康金桂宁酸舒风贴	yi'kang'jin'gui'ning'suan'shu'feng'tie	0
亿康金桂宁酸贴	yi'kang'jin'gui'ning'suan'tie	0
亿康金桂舒风贴	yi'kang'jin'gui'shu'feng'tie	0
亿康金桂贴	yi'kang'jin'gui'tie	0
亿康菊安膏	yi'kang'ju'an'gao	0
亿康康茵宁	yi'kang'kang'yin'ning	0
亿康坤淑康茵宁	yi'kang'kun'shu'kang'yin'ning	0
益康鹿	yi'kang'lu	0
亿康鹿参虎元贴	yi'kang'lu'can'hu'yuan'tie	0
亿康鹿参培阳虎元贴	yi'kang'lu'can'pei'yang'hu'yuan'tie	0
亿康鹿参培阳贴	yi'kang'lu'can'pei'yang'tie	0
亿康鹿参贴	yi'kang'lu'can'tie	0
益康鹿阳	yi'kang'lu'yang	0
亿康鹿阳贴	yi'kang'lu'yang'tie	0
益康鹿阳贴	yi'kang'lu'yang'tie	0
亿康迷迭香眼膜	yi'kang'mi'die'xiang'yan'mo	0
亿康宁酸舒风贴	yi'kang'ning'suan'shu'feng'tie	0
亿康宁酸贴	yi'kang'ning'suan'tie	0
亿康培阳虎元贴	yi'kang'pei'yang'hu'yuan'tie	0
亿康培阳贴	yi'kang'pei'yang'tie	0
亿康平创抚痕膏	yi'kang'ping'chuang'fu'hen'gao	0
亿康平创抚痕焕肤膏	yi'kang'ping'chuang'fu'hen'huan'fu'gao	0
亿康平创焕肤膏	yi'kang'ping'chuang'huan'fu'gao	0
益康乾	yi'kang'qian	0
益康乾烈	yi'kang'qian'lie	0
亿康乾烈贴	yi'kang'qian'lie'tie	0
益康乾烈贴	yi'kang'qian'lie'tie	0
亿康乾阳贴	yi'kang'qian'yang'tie	0
亿康青罗记人参眼膜	yi'kang'qing'luo'ji'ren'shen'yan'mo	0
亿康青罗记眼膜	yi'kang'qing'luo'ji'yan'mo	0
亿康清湿贴	yi'kang'qing'shi'tie	0
亿康参茸贴	yi'kang'shen'rong'tie	0
亿康十味益骨贴	yi'kang'shi'wei'yi'gu'tie	0
亿康十味致高贴	yi'kang'shi'wei'zhi'gao'tie	0
亿康十味致高益骨贴	yi'kang'shi'wei'zhi'gao'yi'gu'tie	0
亿康舒风贴	yi'kang'shu'feng'tie	0
亿康天香清湿贴	yi'kang'tian'xiang'qing'shi'tie	0
亿康辛白苍植膏	yi'kang'xin'bai'cang'zhi'gao	0
亿康辛白通渊膏	yi'kang'xin'bai'tong'yuan'gao	0
亿康御湿贴	yi'kang'yu'shi'tie	0
亿康致高益骨贴	yi'kang'zhi'gao'yi'gu'tie	0
御湿	yu'shi	0
御湿贴	yu'shi'tie	0
致高	zhi'gao	0
致高益骨	zhi'gao'yi'gu	0
致高益骨贴	zhi'gao'yi'gu'tie	0
知坤	zhi'kun	0
知坤堂	zhi'kun'tang	0
知坤堂荷梅轻畅膏	zhi'kun'tang'he'mei'qing'chang'gao	0
知坤堂乾烈膏	zhi'kun'tang'qian'lie'gao	0
知坤堂乾元片	zhi'kun'tang'qian'yuan'pian	0
知坤堂轻畅膏	zhi'kun'tang'qing'chang'gao	0
知坤堂三鞭乾元片	zhi'kun'tang'san'bian'qian'yuan'pian	0
知坤堂三花膏	zhi'kun'tang'san'hua'gao	0
知坤堂三花乾烈膏	zhi'kun'tang'san'hua'qian'lie'gao	0
