阿里山小鲵	a'li'shan'xiao'ni	0
安徽疣螈	an'hui'you'yuan	0
安吉小鲵	an'ji'xiao'ni	0
巴鲵属	ba'ni'shu	0
北鲵属	bei'ni'shu	0
秉志肥螈	bing'zhi'fei'yuan	0
蔡氏疣螈	cai'shi'you'yuan	0
潮汕蝾螈	chao'shan'rong'yuan	0
呈贡蝾螈	cheng'gong'rong'yuan	0
橙脊瘰螈	cheng'ji'luo'yuan	0
楚南小鲵	chu'nan'xiao'ni	0
川南疣螈	chuan'nan'you'yuan	0
大别疣螈	da'bie'you'yuan	0
大凉疣螈	da'liang'you'yuan	0
大鲵属	da'ni'shu	0
稻城山溪鲵	dao'cheng'shan'xi'ni	0
德氏瘰螈	de'shi'luo'yuan	0
滇南疣螈	dian'nan'you'yuan	0
滇螈	dian'yuan	0
东北小鲵	dong'bei'xiao'ni	0
东方蝾螈	dong'fang'rong'yuan	0
肥鲵属	fei'ni'shu	0
费氏肥螈	fei'shi'fei'yuan	0
肥螈属	fei'yuan'shu	0
福鼎蝾螈	fu'ding'rong'yuan	0
富钟瘰螈	fu'zhong'luo'yuan	0
高山棘螈	gao'shan'ji'yuan	0
弓斑肥螈	gong'ban'fei'yuan	0
挂榜山小鲵	gua'bang'shan'xiao'ni	0
观雾小鲵	guan'wu'xiao'ni	0
广西瘰螈	guang'xi'luo'yuan	0
贵州拟小鲵	gui'zhou'ni'xiao'ni	0
贵州疣螈	gui'zhou'you'yuan	0
海南疣螈	hai'nan'you'yuan	0
黑斑肥螈	hei'ban'fei'yuan	0
红瘰疣螈	hong'luo'you'yuan	0
华南大鲵	hua'nan'da'ni	0
黄斑肥螈	huang'ban'fei'yuan	0
黄斑拟小鲵	huang'ban'ni'xiao'ni	0
灰蓝蝾螈	hui'lan'rong'yuan	0
极北鲵	ji'bei'ni	0
极北鲵属	ji'bei'ni'shu	0
吉林爪鲵	ji'lin'zhao'ni	0
棘螈属	ji'yuan'shu	0
金佛拟小鲵	jin'fo'ni'xiao'ni	0
宽脊疣螈	kuan'ji'you'yuan	0
宽阔水拟小鲵	kuan'kuo'shui'ni'xiao'ni	0
蓝尾蝾螈	lan'wei'rong'yuan	0
辽宁爪鲵	liao'ning'zhao'ni	0
琉球棘螈	liu'qiu'ji'yuan	0
浏阳疣螈	liu'yang'you'yuan	0
龙洞山溪鲵	long'dong'shan'xi'ni	0
龙里瘰螈	long'li'luo'yuan	0
瘰螈属	luo'yuan'shu	0
莽山疣螈	mang'shan'you'yuan	0
猫儿山小鲵	mao'er'shan'xiao'ni	0
茂兰瘰螈	mao'lan'luo'yuan	0
莫氏肥螈	mo'shi'fei'yuan	0
南方肥螈	nan'fang'fei'yuan	0
南湖小鲵	nan'hu'xiao'ni	0
拟小鲵属	ni'xiao'ni'shu	0
普雄拟小鲵	pu'xiong'ni'xiao'ni	0
七溪岭瘰螈	qi'xi'ling'luo'yuan	0
秦巴巴鲵	qin'ba'ba'ni	0
蝾螈科	rong'yuan'ke	0
蝾螈属	rong'yuan'shu	0
山溪鲵	shan'xi'ni	0
山溪鲵属	shan'xi'ni'shu	0
商城肥鲵	shang'cheng'fei'ni	0
水城拟小鲵	shui'cheng'ni'xiao'ni	0
太白山溪鲵	tai'bai'shan'xi'ni	0
台湾小鲵	tai'wan'xiao'ni	0
尾斑瘰螈	wei'ban'luo'yuan	0
文县疣螈	wen'xian'you'yuan	0
无斑瘰螈	wu'ban'luo'yuan	0
无斑山溪鲵	wu'ban'shan'xi'ni	0
武陵瘰螈	wu'ling'luo'yuan	0
巫山巴鲵	wu'shan'ba'ni	0
吴氏肥螈	wu'shi'fei'yuan	0
西藏山溪鲵	xi'zang'shan'xi'ni	0
细痣疣螈	xi'zhi'you'yuan	0
香港瘰螈	xiang'gang'luo'yuan	0
小鲵科	xiao'ni'ke	0
小鲵属	xiao'ni'shu	0
新疆北鲵	xin'jiang'bei'ni	0
盐源山溪鲵	yan'yuan'shan'xi'ni	0
瑶山肥螈	yao'shan'fei'yuan	0
义乌小鲵	yi'wu'xiao'ni	0
隐鳃鲵科	yin'sai'ni'ke	0
有尾目	you'wei'mu	0
疣螈属	you'yuan'shu	0
远东极北鲵	yuan'dong'ji'bei'ni	0
云雾瘰螈	yun'wu'luo'yuan	0
张氏肥螈	zhang'shi'fei'yuan	0
爪鲵属	zhao'ni'shu	0
镇海棘螈	zhen'hai'ji'yuan	0
织金瘰螈	zhi'jin'luo'yuan	0
中国大鲵	zhong'guo'da'ni	0
中国瘰螈	zhong'guo'luo'yuan	0
中国小鲵	zhong'guo'xiao'ni	0
棕黑疣螈	zong'hei'you'yuan	0
