阿尔卡赖	a'er'ka'lai	0
阿吉拉	a'ji'la	0
阿里叶	a'li'ye	0
阿耶哈	a'ye'ha	0
艾哈瓦勒舍赫绥耶	ai'ha'wa'le'she'he'sui'ye	0
安拉的法度	an'la'de'fa'du	0
保留休妻	bao'liu'xiu'qi	0
被告	bei'gao	0
比达阿	bi'da'a	0
比论	bi'lun	0
鞭刑	bian'xing	0
标新立异	biao'xin'li'yi	0
不可分割财产	bu'ke'fen'ge'cai'chan	0
不可靠的圣训	bu'ke'kao'de'sheng'xun	0
不正常的休妻	bu'zheng'chang'de'xiu'qi	0
不正常婚姻	bu'zheng'chang'hun'yin	0
财产监护	cai'chan'jian'hu	0
常住	chang'zhu	0
传述世系	chuan'shu'shi'xi	0
传述线索	chuan'shu'xian'suo	0
传统主义注释	chuan'tong'zhu'yi'zhu'shi	0
传闻注释	chuan'wen'zhu'shi	0
创制	chuang'zhi	0
创制之门关闭说	chuang'zhi'zhi'men'guan'bi'shuo	0
大象之家判例	da'xiang'zhi'jia'pan'li	0
大藏	da'zang	0
待婚期	dai'hun'qi	0
代位继承	dai'wei'ji'cheng	0
担保契约	dan'bao'qi'yue	0
单传圣训	dan'chuan'sheng'xun	0
抵押契约	di'ya'qi'yue	0
独立判断	du'li'pan'duan	0
断肢刑	duan'zhi'xing	0
法谛哈	fa'di'ha	0
法定继承	fa'ding'ji'cheng	0
法理学	fa'li'xue	0
法律拟制	fa'lv'ni'zhi	0
法斯赫	fa'si'he	0
法特瓦	fa'te'wa	0
斐格海	fei'ge'hai	0
非连续的圣训	fei'lian'xu'de'sheng'xun	0
非约定聘礼	fei'yue'ding'pin'li	0
非赞许的休妻	fei'zan'xu'de'xiu'qi	0
份额继承人	fen'e'ji'cheng'ren	0
福尔刚	fu'er'gang	0
福鲁阿	fu'lu'a	0
父系继承人	fu'xi'ji'cheng'ren	0
格亚斯	ge'ya'si	0
公议	gong'yi	0
公益	gong'yi	0
公益瓦克夫	gong'yi'wa'ke'fu	0
共有财产	gong'you'cai'chan	0
固定刑	gu'ding'xing	0
古兰经继承人	gu'lan'jing'ji'cheng'ren	0
古兰经律例	gu'lan'jing'lv'li	0
雇佣或租赁契约	gu'yong'huo'zu'lin'qi'yue	0
寡妇留置权	gua'fu'liu'zhi'quan	0
光节	guang'jie	0
归还	gui'huan	0
国家继承人	guo'jia'ji'cheng'ren	0
哈伯斯	ha'bo'si	0
哈底斯	ha'di'si	0
哈拉姆	ha'la'mu	0
哈里发学说	ha'li'fa'xue'shuo	0
合法子女	he'fa'zi'nv	0
合伙契约	he'huo'qi'yue	0
侯杜德	hou'du'de	0
胡尔	hu'er	0
婚姻对等	hun'yin'dui'deng	0
婚姻监护	hun'yin'jian'hu	0
婚姻障碍	hun'yin'zhang'ai	0
婚约	hun'yue	0
继承法	ji'cheng'fa	0
继承顺序	ji'cheng'shun'xu	0
继承障碍	ji'cheng'zhang'ai	0
基督教式注释	ji'du'jiao'shi'zhu'shi	0
吉哈尔	ji'ha'er	0
基沙斯	ji'sha'si	0
家庭法	jia'ting'fa	0
家庭瓦克夫	jia'ting'wa'ke'fu	0
家语	jia'yu	0
检查官法庭	jian'cha'guan'fa'ting	0
教法根源学	jiao'fa'gen'yuan'xue	0
教法学	jiao'fa'xue	0
教法渊源学	jiao'fa'yuan'yuan'xue	0
教律学	jiao'lv'xue	0
绞刑	jiao'xing	0
经训不悖说	jing'xun'bu'bei'shuo	0
经注学	jing'zhu'xue	0
净资产	jing'zi'chan	0
卡迪法庭	ka'di'fa'ting	0
卡农	ka'nong	0
可分割财产	ke'fen'ge'cai'chan	0
库德西圣训	ku'de'xi'sheng'xun	0
类比	lei'bi	0
里安	li'an	0
利息禁令	li'xi'jin'ling	0
离仪	li'yi	0
连续的圣训	lian'xu'de'sheng'xun	0
连续性	lian'xu'xing	0
良好的圣训	liang'hao'de'sheng'xun	0
临时婚姻	lin'shi'hun'yin	0
六大圣训集	liu'da'sheng'xun'ji	0
六奴隶判例	liu'nu'li'pan'li	0
律例	lv'li	0
驴判例	lv'pan'li	0
麦地那篇章	mai'di'na'pian'zhang	0
麦加篇章	mai'jia'pian'zhang	0
麦克鲁海	mai'ke'lu'hai	0
卖空权	mai'kong'quan	0
买卖契约	mai'mai'qi'yue	0
曼杜伯	man'du'bo	0
曼吉尔	man'ji'er	0
明意	ming'yi	0
穆阿麦俩特	mu'a'mai'liang'te	0
穆巴哈	mu'ba'ha	0
穆巴拉	mu'ba'la	0
穆罕默德法	mu'han'mo'de'fa	0
穆罕默德言行录	mu'han'mo'de'yan'xing'lu	0
穆合凯姆	mu'he'kai'mu	0
穆斯林法	mu'si'lin'fa	0
穆塔尔	mu'ta'er	0
穆太沙比哈	mu'tai'sha'bi'ha	0
穆札巴纳	mu'zha'ba'na	0
尼札米亚法庭	ni'zha'mi'ya'fa'ting	0
欧杜尔	ou'du'er	0
欧古巴特	ou'gu'ba'te	0
排除原则	pai'chu'yuan'ze	0
叛教罪	pan'jiao'zui	0
拼凑法	pin'cou'fa	0
聘礼	pin'li	0
契约继承人	qi'yue'ji'cheng'ren	0
佥议	qian'yi	0
抢劫罪	qiang'jie'zui	0
青春期选择	qing'chun'qi'xuan'ze	0
清真寺判例	qing'zhen'si'pan'li	0
认亲继承人	ren'qin'ji'cheng'ren	0
人身监护	ren'shen'jian'hu	0
赛阿德判例	sai'a'de'pan'li	0
沙里亚	sha'li'ya	0
沙里亚法	sha'li'ya'fa	0
沙里亚法庭	sha'li'ya'fa'ting	0
商法	shang'fa	0
舍里阿	she'li'a	0
涉嫌	she'xian	0
神秘主义注释	shen'mi'zhu'yi'zhu'shi	0
生前处分财产	sheng'qian'chu'fen'cai'chan	0
圣训	sheng'xun	0
圣训废止说	sheng'xun'fei'zhi'shuo	0
圣训集	sheng'xun'ji	0
圣训经	sheng'xun'jing	0
圣训律例	sheng'xun'lv'li	0
圣训实录	sheng'xun'shi'lu	0
圣训学	sheng'xun'xue	0
誓言保证	shi'yan'bao'zheng	0
十叶派继承法	shi'ye'pai'ji'cheng'fa	0
受赠人	shou'zeng'ren	0
双重买卖	shuang'chong'mai'mai	0
死后处分财产	si'hou'chu'fen'cai'chan	0
私人身份法	si'ren'shen'fen'fa	0
私人瓦克夫	si'ren'wa'ke'fu	0
四圣书	si'sheng'shu	0
私通罪	si'tong'zui	0
苏拉	su'la	0
塔格利德	ta'ge'li'de	0
塔拉格	ta'la'ge	0
太甫绥鲁	tai'fu'sui'lu	0
太兹伊尔	tai'zi'yi'er	0
停经	ting'jing	0
听诉法庭	ting'su'fa'ting	0
同态复仇	tong'tai'fu'chou	0
偷盗罪	tou'dao'zui	0
推定守寡	tui'ding'shou'gua	0
推定死亡	tui'ding'si'wang	0
瓦吉布	wa'ji'bu	0
瓦克夫	wa'ke'fu	0
瓦克夫法	wa'ke'fu'fa	0
瓦克夫期限	wa'ke'fu'qi'xian	0
瓦克夫受益人	wa'ke'fu'shou'yi'ren	0
未接触证据	wei'jie'chu'zheng'ju	0
唯美	wei'mei	0
委托休妻	wei'tuo'xiu'qi	0
伪训	wei'xun	0
卧各夫	wo'ge'fu	0
五圣书	wu'sheng'shu	0
乌苏尔	wu'su'er	0
乌苏勒	wu'su'le	0
诬陷私通罪	wu'xian'si'tong'zui	0
无效婚姻	wu'xiao'hun'yin	0
五种行为规范	wu'zhong'xing'wei'gui'fan	0
希巴拉	xi'ba'la	0
希白	xi'bai	0
析产	xi'chan	0
西哈胡西塔	xi'ha'hu'xi'ta	0
希亚沙沙里亚	xi'ya'sha'sha'li'ya	0
希兹布	xi'zi'bu	0
现代主义注释	xian'dai'zhu'yi'zhu'shi	0
先买权	xian'mai'quan	0
先知的逊奈	xian'zhi'de'xun'nai	0
协议离婚	xie'yi'li'hun	0
信实的圣训	xin'shi'de'sheng'xun	0
信托契约	xin'tuo'qi'yue	0
刑法	xing'fa	0
休妻	xiu'qi	0
酗酒罪	xu'jiu'zui	0
选择法	xuan'ze'fa	0
选择期	xuan'ze'qi	0
血金	xue'jin	0
血亲复仇	xue'qin'fu'chou	0
逊奈	xun'nai	0
逊尼派继承法	xun'ni'pai'ji'cheng'fa	0
伊巴达特	yi'ba'da'te	0
伊达	yi'da	0
意见	yi'jian	0
意见注释	yi'jian'zhu'shi	0
伊拉	yi'la	0
以石击毙刑	yi'shi'ji'bi'xing	0
伊斯兰法庭	yi'si'lan'fa'ting	0
伊斯兰教法	yi'si'lan'jiao'fa	0
伊斯兰宪法	yi'si'lan'xian'fa	0
伊斯纳德	yi'si'na'de	0
伊斯提哈桑	yi'si'ti'ha'sang	0
伊斯提斯哈伯	yi'si'ti'si'ha'bo	0
伊斯提斯拉赫	yi'si'ti'si'la'he	0
义务遗嘱	yi'wu'yi'zhu	0
遗赠	yi'zeng	0
遗赠继承人	yi'zeng'ji'cheng'ren	0
伊制玛尔	yi'zhi'ma'er	0
伊智提哈德	yi'zhi'ti'ha'de	0
遗嘱	yi'zhu	0
遗嘱继承	yi'zhu'ji'cheng	0
遗嘱执行人	yi'zhu'zhi'xing'ren	0
隐意	yin'yi	0
犹太教式注释	you'tai'jiao'shi'zhu'shi	0
有效婚姻	you'xiao'hun'yin	0
优选	you'xuan	0
余产	yu'chan	0
原告	yuan'gao	0
远亲继承人	yuan'qin'ji'cheng'ren	0
约定聘礼	yue'ding'pin'li	0
赞许的休妻	zan'xu'de'xiu'qi	0
赠与	zeng'yu	0
赠与人	zeng'yu'ren	0
斩首刑	zhan'shou'xing	0
证据	zheng'ju	0
证人	zheng'ren	0
证人信誉	zheng'ren'xin'yu	0
治安法庭	zhi'an'fa'ting	0
朱兹	zhu'zi	0
转化制	zhuan'hua'zhi	0
酌定刑	zhuo'ding'xing	0
祖母外祖母遗产判例	zu'mu'wai'zu'mu'yi'chan'pan'li	0
最长妊娠期	zui'chang'ren'shen'qi	0
最短妊娠期	zui'duan'ren'shen'qi	0
