阿巴耶卡罗笈多	a'ba'ye'ka'luo'ji'duo	0
阿鼻地狱	a'bi'di'yu	0
阿比罗提	a'bi'luo'ti	0
阿鞞跋致	a'bing'ba'zhi	0
阿波陀那	a'bo'tuo'na	0
阿部肇一	a'bu'zhao'yi	0
阿阐底迦	a'chan'di'jia	0
阿达婆吠陀	a'da'po'fei'tuo	0
阿道	a'dao	0
阿地瞿多	a'di'qu'duo	0
阿底峡	a'di'xia	0
阿颠底迦	a'dian'di'jia	0
阿闍世王	a'du'shi'wang	0
阿浮陀达磨	a'fu'tuo'da'mo	0
阿伽色	a'ga'se	0
阿伽陀药	a'ga'tuo'yao	0
阿含经	a'han'jing	0
阿吽	a'hong	0
阿克巴	a'ke'ba	0
阿拉善延寿寺	a'la'shan'yan'shou'si	0
阿赖耶识	a'lai'ye'shi	0
阿兰若	a'lan're	0
阿离耶	a'li'ye	0
阿卢那	a'lu'na	0
阿罗汉	a'luo'han	0
阿罗逻迦兰	a'luo'luo'jia'lan	0
阿罗毗国	a'luo'pi'guo	0
阿弥陀经	a'mi'tuo'jing	0
阿弥陀净土变	a'mi'tuo'jing'tu'bian	0
阿摩勒树	a'mo'le'shu	0
阿摩罗梵语辞典	a'mo'luo'fan'yu'ci'dian	0
阿摩落迦塔	a'mo'luo'jia'ta	0
阿摩罗婆提	a'mo'luo'po'ti	0
阿摩罗普罗派	a'mo'luo'pu'luo'pai	0
阿摩罗识	a'mo'luo'shi	0
阿那含	a'na'han	0
阿那律	a'na'lv	0
阿难	a'nan	0
阿难陀寺	a'nan'tuo'si	0
阿尼哥	a'ni'ge	0
阿耨达池	a'nou'da'chi	0
阿耨达龙王	a'nou'da'long'wang	0
阿耨多罗三藐三菩提	a'nou'duo'luo'san'miao'san'pu'ti	0
阿奴波村	a'nu'bo'cun	0
阿奴律陀	a'nu'lv'tuo	0
阿诺德	a'nuo'de	0
阿毗达磨	a'pi'da'mo	0
阿毗达磨大乘经	a'pi'da'mo'da'cheng'jing	0
阿毗达磨灯论	a'pi'da'mo'deng'lun	0
阿毗昙八犍度论	a'pi'tan'ba'jian'du'lun	0
阿毗昙毗婆沙论	a'pi'tan'pi'po'sha'lun	0
阿毗昙心论	a'pi'tan'xin'lun	0
阿耆多翅舍钦婆罗	a'qi'duo'chi'she'qin'po'luo	0
阿若憍陈如	a'ruo'jiao'chen'ru	0
阿僧祇	a'seng'chi	0
阿湿波	a'shi'bo	0
阿湿波国	a'shi'bo'guo	0
阿输迦树	a'shu'jia'shu	0
阿说示	a'shuo'shi	0
阿私陀仙	a'si'tuo'xian	0
阿娑缚抄	a'suo'fu'chao	0
阿特曼	a'te'man	0
阿陀那识	a'tuo'na'shi	0
阿王老藏	a'wang'lao'cang	0
阿旺洛桑	a'wang'luo'sang	0
阿旺洛桑丹巴坚赞	a'wang'luo'sang'dan'ba'jian'zan	0
阿旺曲培	a'wang'qu'pei	0
阿尾奢法	a'wei'she'fa	0
阿修罗	a'xiu'luo	0
阿逸多	a'yi'duo	0
阿诣罗	a'yi'luo	0
阿由多	a'you'duo	0
阿踰陀国	a'yu'tuo'guo	0
阿育王	a'yu'wang	0
阿育王法勒	a'yu'wang'fa'le	0
阿育王经	a'yu'wang'jing	0
阿育王寺	a'yu'wang'si	0
阿育王塔	a'yu'wang'ta	0
阿育王息坏目因缘经	a'yu'wang'xi'huai'mu'yin'yuan'jing	0
阿咤力教	a'zha'li'jiao	0
阿旃陀石窟	a'zhan'tuo'shi'ku	0
阿字本不生	a'zi'ben'bu'sheng	0
阿字观	a'zi'guan	0
阿字五转	a'zi'wu'zhuan	0
爱别离苦	ai'bie'li'ku	0
爱国寺念佛堂	ai'guo'si'nian'fo'tang	0
矮国王	ai'guo'wang	0
爱见	ai'jian	0
爱见大悲	ai'jian'da'bei	0
埃勒凡达岛	ai'le'fan'da'dao	0
艾略特	ai'lve'te	0
艾罗拉石窟	ai'luo'la'shi'ku	0
爱染明王	ai'ran'ming'wang	0
爱行	ai'xing	0
艾泽顿	ai'ze'dun	0
爱之歌	ai'zhi'ge	0
爱知学院大学	ai'zhi'xue'yuan'da'xue	0
庵	an	0
安贝卡	an'bei'ka	0
安禅那	an'chan'na	0
安澄	an'cheng	0
安呾罗缚国	an'da'luo'fu'guo	0
案达罗国	an'da'luo'guo	0
案达派	an'da'pai	0
安闍那林	an'du'na'lin	0
安多政教多	an'duo'zheng'jiao'duo	0
安法钦	an'fa'qin	0
安国寺	an'guo'si	0
安国兴国寺	an'guo'xing'guo'si	0
安含	an'han	0
安慧	an'hui	0
安徽东华山普慧禅寺	an'hui'dong'hua'shan'pu'hui'chan'si	0
安徽淮南白塔寺	an'hui'huai'nan'bai'ta'si	0
安徽淮南弘法慈善功德会	an'hui'huai'nan'hong'fa'ci'shan'gong'de'hui	0
安徽淮南上窑古观音寺	an'hui'huai'nan'shang'yao'gu'guan'yin'si	0
安徽怀宁福慧寺	an'hui'huai'ning'fu'hui'si	0
安徽省安庆市灵山寺	an'hui'sheng'an'qing'shi'ling'shan'si	0
安徽省阜阳市東狱禅寺	an'hui'sheng'fu'yang'shi'dong'yu'chan'si	0
安徽省阜阳市颍州西湖铁佛寺	an'hui'sheng'fu'yang'shi'ying'zhou'xi'hu'tie'fo'si	0
安徽省淮南市弘法堂	an'hui'sheng'huai'nan'shi'hong'fa'tang	0
安徽省南陵县千佛禅寺	an'hui'sheng'nan'ling'xian'qian'fo'chan'si	0
安居	an'ju	0
安克迭都培龙	an'ke'die'dou'pei'long	0
安乐行院	an'le'hang'yuan	0
安乐集	an'le'ji	0
安乐寿院	an'le'shou'yuan	0
安乐寺	an'le'si	0
安立	an'li	0
安廪	an'lin	0
安流传授纪要	an'liu'chuan'shou'ji'yao	0
鞍马寺	an'ma'si	0
菴没罗园	an'mei'luo'yuan	0
安尼伯森夫人	an'ni'bo'sen'fu'ren	0
安然	an'ran	0
安世高	an'shi'gao	0
安藤俊雄	an'teng'jun'xiong	0
安土宗论	an'tu'zong'lun	0
安陀会	an'tuo'hui	0
安息国	an'xi'guo	0
安息香	an'xi'xiang	0
安详的心	an'xiang'de'xin	0
安祥寺	an'xiang'si	0
安心	an'xin	0
安心决定钞	an'xin'jue'ding'chao	0
安玄	an'xuan	0
安养抄	an'yang'chao	0
安养集	an'yang'ji	0
安养寺	an'yang'si	0
安远庙	an'yuan'miao	0
安乐律	an'yue'lv	0
安乐律院	an'yue'lv'yuan	0
安岳磨崖佛像	an'yue'mo'ya'fo'xiang	0
安宅神咒经	an'zhai'shen'zhou'jing	0
安住何处	an'zhu'he'chu	0
鞍作鸟	an'zuo'niao	0
奥义书	ao'yi'shu	0
八不净物	ba'bu'jing'wu	0
八不中道	ba'bu'zhong'dao	0
巴操尼玛札	ba'cao'ni'ma'zha	0
跋祇国	ba'chi'guo	0
八触	ba'chu	0
巴达利	ba'da'li	0
八大灵塔	ba'da'ling'ta	0
八大灵塔梵赞	ba'da'ling'ta'fan'zan	0
八大灵塔名号经	ba'da'ling'ta'ming'hao'jing	0
巴达弥	ba'da'mi	0
八大菩萨	ba'da'pu'sa	0
八大菩萨曼荼罗经	ba'da'pu'sa'man'tu'luo'jing	0
八大人觉	ba'da'ren'jue	0
八大人觉经	ba'da'ren'jue'jing	0
八大山人	ba'da'shan'ren	0
八大童子	ba'da'tong'zi	0
巴丹闍梨	ba'dan'du'li	0
巴丹巿	ba'dan'fu	0
巴德拉巴夫	ba'de'la'ba'fu	0
巴尔夫	ba'er'fu	0
巴尔拉姆与乔萨发特	ba'er'la'mu'yu'qiao'sa'fa'te	0
八法	ba'fa	0
八幡大菩萨	ba'fan'da'pu'sa	0
八风吹不动	ba'feng'chui'bu'dong	0
八风吹不动一屁过江来	ba'feng'chui'bu'dong'yi'pi'guo'jiang'lai	0
巴格石窟	ba'ge'shi'ku	0
八功德水	ba'gong'de'shui	0
八关会	ba'guan'hui	0
八关斋戒	ba'guan'zhai'jie	0
巴壶天	ba'hu'tian	0
八吉祥经	ba'ji'xiang'jing	0
八吉祥颂	ba'ji'xiang'song	0
八解脱	ba'jie'tuo	0
八敬法	ba'jing'fa	0
八觉	ba'jue	0
八苦	ba'ku	0
巴里岛	ba'li'dao	0
巴利律藏	ba'li'lv'cang	0
巴利圣典协会	ba'li'sheng'dian'xie'hui	0
巴利语	ba'li'yu	0
巴利语佛典	ba'li'yu'fo'dian	0
巴林右旗荟福寺	ba'lin'you'qi'hui'fu'si	0
巴路特	ba'lu'te	0
把门关好	ba'men'guan'hao	0
巴米扬石窟	ba'mi'yang'shi'ku	0
八难	ba'nan	0
八千枚护摩供	ba'qian'mei'hu'mo'gong	0
八忍八智	ba'ren'ba'zhi	0
八胜处	ba'sheng'chu	0
八圣吉祥祈请文	ba'sheng'ji'xiang'qi'qing'wen	0
八圣吉祥颂	ba'sheng'ji'xiang'song	0
八识	ba'shi	0
八十八使	ba'shi'ba'shi	0
八十八祖道影传赞	ba'shi'ba'zu'dao'ying'chuan'zan	0
八识规矩颂	ba'shi'gui'ju'song	0
八十九心	ba'shi'jiu'xin	0
八十随形好	ba'shi'sui'xing'hao	0
把手放下来	ba'shou'fang'xia'lai	0
八思巴	ba'si'ba	0
八思巴文字	ba'si'ba'wen'zi	0
巴特那	ba'te'na	0
八万四千法门	ba'wan'si'qian'fa'men	0
八万细行	ba'wan'xi'xing	0
八未曾有	ba'wei'ceng'you	0
拔希	ba'xi	0
巴西佛教	ba'xi'fo'jiao	0
把溪寺	ba'xi'si	0
八相成道	ba'xiang'cheng'dao	0
巴协	ba'xie	0
八叶莲华观	ba'ye'lian'hua'guan	0
八折诵经	ba'zhe'song'jing	0
八正道	ba'zheng'dao	0
八支甘露心要祕密教授续	ba'zhi'gan'lu'xin'yao'mi'mi'jiao'shou'xu	0
八指头陀	ba'zhi'tou'tuo	0
八指头陀诗集	ba'zhi'tou'tuo'shi'ji	0
八支瑜伽	ba'zhi'yu'jia	0
巴宙	ba'zhou	0
霸州市净心佛堂	ba'zhou'shi'jing'xin'fo'tang	0
霸州市龙泉禅寺	ba'zhou'shi'long'quan'chan'si	0
把住	ba'zhu	0
八转声	ba'zhuan'sheng	0
八字文殊菩萨	ba'zi'wen'shu'pu'sa	0
八宗	ba'zong	0
八宗纲要	ba'zong'gang'yao	0
呗	bai	0
百八烦恼	bai'ba'fan'nao	0
百八三昧	bai'ba'san'mei	0
百八塔	bai'ba'ta	0
白度母咒	bai'du'mu'zhou	0
百法	bai'fa	0
白法黑法	bai'fa'hei'fa	0
百法明门	bai'fa'ming'men	0
百福庄严	bai'fu'zhuang'yan	0
白古	bai'gu	0
白国因由	bai'guo'yin'you	0
百济观音	bai'ji'guan'yin	0
百界千如	bai'jie'qian'ru	0
白居易	bai'ju'yi	0
白居易问禅	bai'ju'yi'wen'chan	0
白莲社	bai'lian'she	0
白莲宗	bai'lian'zong	0
百灵庙	bai'ling'miao	0
白龙	bai'long	0
白龙城	bai'long'cheng	0
百论	bai'lun	0
百论疏	bai'lun'shu	0
白马寺	bai'ma'si	0
百年一梦	bai'nian'yi'meng	0
白伞盖佛顶	bai'san'gai'fo'ding	0
白圣	bai'sheng	0
百颂诗集	bai'song'shi'ji	0
百岁宫	bai'sui'gong	0
白塔寺	bai'ta'si	0
百塔寺	bai'ta'si	0
白檀	bai'tan	0
百万塔陀罗尼	bai'wan'ta'tuo'luo'ni	0
百味具足	bai'wei'ju'zu	0
百味饮食	bai'wei'yin'shi	0
白文殊咒	bai'wen'shu'zhou	0
白夏瓦	bai'xia'wa	0
白雪	bai'xue	0
白羊寺	bai'yang'si	0
白业	bai'ye	0
白衣	bai'yi	0
白衣观音	bai'yi'guan'yin	0
白衣观音灵感真言	bai'yi'guan'yin'ling'gan'zhen'yan	0
百一物	bai'yi'wu	0
白隐禅师	bai'yin'chan'shi	0
百喻经	bai'yu'jing	0
拜愿	bai'yuan	0
白月	bai'yue	0
白云	bai'yun	0
白云花	bai'yun'hua	0
白云宗	bai'yun'zong	0
百丈丛林清规	bai'zhang'cong'lin'qing'gui	0
百丈清规证义记	bai'zhang'qing'gui'zheng'yi'ji	0
百丈山	bai'zhang'shan	0
百丈野狐	bai'zhang'ye'hu	0
百丈野鸭子	bai'zhang'ye'ya'zi	0
百字论	bai'zi'lun	0
百字明修法	bai'zi'ming'xiu'fa	0
板	ban	0
办道	ban'dao	0
般闍罗国	ban'du'luo'guo	0
半跏思惟像	ban'jia'si'wei'xiang	0
半肯半不肯	ban'ken'ban'bu'ken	0
般苦三昧	ban'ku'san'mei	0
班玛瓜唐	ban'ma'gua'tang	0
班台斯利	ban'tai'si'li	0
半托迦	ban'tuo'jia	0
半择迦	ban'ze'jia	0
般舟三昧	ban'zhou'san'mei	0
半字满字	ban'zi'man'zi	0
半座	ban'zuo	0
谤三宝戒	bang'san'bao'jie	0
保安寺	bao'an'si	0
保参玉泉	bao'can'yu'quan	0
宝唱	bao'chang	0
宝称	bao'cheng	0
保定博野护国寺	bao'ding'bo'ye'hu'guo'si	0
保定阜平县嘉绒观音寺	bao'ding'fu'ping'xian'jia'rong'guan'yin'si	0
保定市安国兴国寺	bao'ding'shi'an'guo'xing'guo'si	0
宝鼎赞	bao'ding'zan	0
报恩禅寺	bao'en'chan'si	0
报恩寺	bao'en'si	0
报父母恩咒	bao'fu'mu'en'zhou	0
宝光寺	bao'guang'si	0
保国寺	bao'guo'si	0
报国寺	bao'guo'si	0
宝华山	bao'hua'shan	0
宝镜三昧	bao'jing'san'mei	0
薄拘罗	bao'ju'luo	0
宝卷	bao'juan	0
宝觉禅寺	bao'jue'chan'si	0
宝觉寺	bao'jue'si	0
宝莲禅寺	bao'lian'chan'si	0
宝亮	bao'liang	0
宝轮寺	bao'lun'si	0
薄瞑	bao'ming	0
保宁寺	bao'ning'si	0
宝女所问经	bao'nv'suo'wen'jing	0
宝瓶气	bao'ping'qi	0
宝箧印陀罗尼	bao'qie'yin'tuo'luo'ni	0
宝箧印陀罗尼的故事	bao'qie'yin'tuo'luo'ni'de'gu'shi	0
宝庆记	bao'qing'ji	0
宝山石窟	bao'shan'shi'ku	0
报身	bao'shen	0
宝生佛	bao'sheng'fo	0
报生三昧	bao'sheng'san'mei	0
保圣寺	bao'sheng'si	0
抱树	bao'shu	0
宝通禅寺	bao'tong'chan'si	0
报土	bao'tu	0
宝王三昧念佛直指	bao'wang'san'mei'nian'fo'zhi'zhi	0
宝行王正论	bao'xing'wang'zheng'lun	0
宝应寺	bao'ying'si	0
宝雨经	bao'yu'jing	0
宝云	bao'yun	0
宝藏论	bao'zang'lun	0
保志	bao'zhi	0
宝作寂	bao'zuo'ji	0
北碚天台禅院	bei'bei'tian'tai'chan'yuan	0
背柴走江湖	bei'chai'zou'jiang'hu	0
北朝佛教	bei'chao'fo'jiao	0
北传佛教	bei'chuan'fo'jiao	0
北斗法	bei'dou'fa	0
杯渡	bei'du	0
北海白塔	bei'hai'bai'ta	0
悲华经	bei'hua'jing	0
北涧居简禅师语录	bei'jian'ju'jian'chan'shi'yu'lu	0
北京八大处	bei'jing'ba'da'chu	0
北京律	bei'jing'lv	0
卑摩罗叉	bei'mo'luo'cha	0
北山禅寺	bei'shan'chan'si	0
北山录	bei'shan'lu	0
北山住部	bei'shan'zhu'bu	0
北石窟寺	bei'shi'ku'si	0
杯水禅机	bei'shui'chan'ji	0
北寺塔	bei'si'ta	0
悲田坊	bei'tian'fang	0
北条时赖	bei'tiao'shi'lai	0
北条时宗	bei'tiao'shi'zong	0
贝叶经	bei'ye'jing	0
悲增	bei'zeng	0
北周武帝	bei'zhou'wu'di	0
贝子庙	bei'zi'miao	0
北宗	bei'zong	0
本朝高僧传	ben'chao'gao'seng'chuan	0
本初佛	ben'chu'fo	0
本地垂迹	ben'di'chui'ji	0
本地身	ben'di'shen	0
本高	ben'gao	0
本化	ben'hua	0
本化别头佛祖统纪	ben'hua'bie'tou'fo'zu'tong'ji	0
本寂	ben'ji	0
本济	ben'ji	0
本迹二门	ben'ji'er'men	0
本觉	ben'jue	0
本空非有	ben'kong'fei'you	0
本来面目	ben'lai'mian'mu	0
本门佛立宗	ben'men'fo'li'zong	0
本门寺	ben'men'si	0
本门宗	ben'men'zong	0
本能寺	ben'neng'si	0
本如	ben'ru	0
本生	ben'sheng	0
本生鬘	ben'sheng'man	0
本生注	ben'sheng'zhu	0
本师释迦牟尼佛	ben'shi'shi'jia'mou'ni'fo	0
本堂	ben'tang	0
本田义英	ben'tian'yi'ying	0
本未有善	ben'wei'you'shan	0
本有家	ben'you'jia	0
本圆	ben'yuan	0
本愿	ben'yuan	0
本愿寺	ben'yuan'si	0
本质	ben'zhi	0
本尊	ben'zun	0
彼岸会	bi'an'hui	0
毕钵罗窟	bi'bo'luo'ku	0
毕钵罗树	bi'bo'luo'shu	0
比大	bi'da	0
笔峰寺	bi'feng'si	0
闭关	bi'guan	0
比哈	bi'ha	0
毕竟空	bi'jing'kong	0
庇立得法会	bi'li'de'fa'hui	0
比量	bi'liang	0
比量相违过	bi'liang'xiang'wei'guo	0
比丘	bi'qiu	0
比丘尼	bi'qiu'ni	0
比丘尼传	bi'qiu'ni'chuan	0
比叡山	bi'rui'shan	0
碧巖录	bi'yan'lu	0
碧云寺	bi'yun'si	0
辩才天	bian'cai'tian	0
辨长	bian'chang	0
辨法法性论	bian'fa'fa'xing'lun	0
遍告十方	bian'gao'shi'fang	0
边国	bian'guo	0
遍计所执性	bian'ji'suo'zhi'xing	0
辩经	bian'jing	0
遍净天	bian'jing'tian	0
辨庆	bian'qing	0
遍是宗法性	bian'shi'zong'fa'xing	0
辩伪录	bian'wei'lu	0
变文	bian'wen	0
辨喜	bian'xi	0
辨显密二教论	bian'xian'mi'er'jiao'lun	0
辩显密二教论	bian'xian'mi'er'jiao'lun	0
变相图	bian'xiang'tu	0
遍行	bian'xing	0
变易生死	bian'yi'sheng'si	0
变与不变	bian'yu'bu'bian	0
辩正论	bian'zheng'lun	0
遍知	bian'zhi	0
边执见	bian'zhi'jian	0
辩中边论	bian'zhong'bian'lun	0
杓	biao	0
表诠	biao'quan	0
表色	biao'se	0
表无表	biao'wu'biao	0
表制集	biao'zhi'ji	0
别蚌寺	bie'bang'si	0
别报	bie'bao	0
别当	bie'dang	0
别法	bie'fa	0
别教	bie'jiao	0
别解脱戒	bie'jie'tuo'jie	0
别境	bie'jing	0
别理随缘	bie'li'sui'yuan	0
别请	bie'qing	0
别时念佛	bie'shi'nian'fo	0
别向圆修	bie'xiang'yuan'xiu	0
摈出	bin'chu	0
宾头卢	bin'tou'lu	0
斌宗	bin'zong	0
冰揭罗天	bing'jie'luo'tian	0
炳灵寺石窟	bing'ling'si'shi'ku	0
摒弃私心	bing'qi'si'xin	0
钵	bo	0
薄地	bo'di	0
帛法祖	bo'fa'zu	0
博湖巴克新库热	bo'hu'ba'ke'xin'ku're	0
薄伽梵歌	bo'jia'fan'ge	0
波剌斯国	bo'la'si'guo	0
泊莲寺	bo'lian'si	0
柏林禅寺	bo'lin'chan'si	0
柏林寺	bo'lin'si	0
波隆纳鲁伐	bo'long'na'lu'fa	0
波罗浮屠	bo'luo'fu'tu	0
波罗奈国	bo'luo'nai'guo	0
波罗颇迦罗蜜多罗	bo'luo'po'jia'luo'mi'duo'luo	0
波罗提木叉	bo'luo'ti'mu'cha	0
波罗提提舍尼	bo'luo'ti'ti'she'ni	0
波罗王朝	bo'luo'wang'chao	0
哱囉舞	bo'luo'wu	0
钵罗耶伽	bo'luo'ye'ga	0
波罗夷	bo'luo'yi	0
博那佛塔	bo'na'fo'ta	0
波你尼文法	bo'ni'ni'wen'fa	0
般若波罗蜜	bo're'bo'luo'mi	0
般若波罗蜜多心经	bo're'bo'luo'mi'duo'xin'jing	0
般若灯论释	bo're'deng'lun'shi	0
般若佛母心咒	bo're'fo'mu'xin'zhou	0
般若经	bo're'jing	0
般若理趣释	bo're'li'qu'shi	0
般若心经祕键	bo're'xin'jing'mi'jian	0
般若心咒	bo're'xin'zhou	0
博山无异禅师广录	bo'shan'wu'yi'chan'shi'guang'lu	0
帛尸梨蜜多罗	bo'shi'li'mi'duo'luo	0
波斯匿王	bo'si'ni'wang	0
钵头摩地狱	bo'tou'mo'di'yu	0
拨无因果	bo'wu'yin'guo	0
伯希和	bo'xi'he	0
博野县菩提念佛堂	bo'ye'xian'pu'ti'nian'fo'tang	0
波逸提	bo'yi'ti	0
伯孜克里克石窟	bo'zi'ke'li'ke'shi'ku	0
不变随缘	bu'bian'sui'yuan	0
不变应万变	bu'bian'ying'wan'bian	0
不曾空过	bu'ceng'kong'guo	0
布达拉宫	bu'da'la'gong	0
不丹佛教	bu'dan'fo'jiao	0
不得见	bu'de'jian	0
不定	bu'ding	0
不定地法	bu'ding'de'fa	0
不定教	bu'ding'jiao	0
不定业	bu'ding'ye	0
不动法	bu'dong'fa	0
不动曼荼罗	bu'dong'man'tu'luo	0
不动明王	bu'dong'ming'wang	0
不动心	bu'dong'xin	0
不动智神妙录	bu'dong'zhi'shen'miao'lu	0
不断念佛	bu'duan'nian'fo	0
布顿	bu'dun	0
布顿佛教史	bu'dun'fo'jiao'shi	0
不二门下歌	bu'er'men'xia'ge	0
不二摩诃衍	bu'er'mo'he'yan	0
不二一元论	bu'er'yi'yuan'lun	0
不放逸	bu'fang'yi	0
不复再画	bu'fu'zai'hua	0
不共法	bu'gong'fa	0
不共教	bu'gong'jiao	0
不共相	bu'gong'xiang	0
不共业	bu'gong'ye	0
不害	bu'hai	0
布赫诺夫	bu'he'nuo'fu	0
不坏法	bu'huai'fa	0
不净观	bu'jing'guan	0
不可触贱民	bu'ke'chu'jian'min	0
不可说	bu'ke'shuo	0
不可执著	bu'ke'zhi'zhuo	0
不肯承担	bu'ken'cheng'dan	0
不肯放下	bu'ken'fang'xia	0
不空	bu'kong	0
不空成就如来	bu'kong'cheng'jiu'ru'lai	0
不空罥索观音	bu'kong'juan'suo'guan'yin	0
不空罥索神变真言经	bu'kong'juan'suo'shen'bian'zhen'yan'jing	0
不空罥索神咒心经	bu'kong'juan'suo'shen'zhou'xin'jing	0
不空罥索陀罗尼经	bu'kong'juan'suo'tuo'luo'ni'jing	0
不愧为侍者	bu'kui'wei'shi'zhe	0
布勒	bu'le	0
不离过	bu'li'guo	0
不立文字	bu'li'wen'zi	0
不了义	bu'liao'yi	0
不留平常心	bu'liu'ping'chang'xin	0
不落有无	bu'luo'you'wu	0
不能代替	bu'neng'dai'ti	0
部派佛教	bu'pai'fo'jiao	0
不迁	bu'qian	0
不悭戒	bu'qian'jie	0
不缺盐酱	bu'que'yan'jiang	0
不染污	bu'ran'wu	0
不染污无知	bu'ran'wu'wu'zhi	0
不辱国体	bu'ru'guo'ti	0
不如密多	bu'ru'mi'duo	0
不如小丑	bu'ru'xiao'chou	0
布萨	bu'sa	0
不善	bu'shan	0
不生不灭	bu'sheng'bu'mie	0
布施	bu'shi	0
不是传声筒	bu'shi'chuan'sheng'tong	0
不识法身	bu'shi'fa'shen	0
不时解脱	bu'shi'jie'tuo	0
不受不施派	bu'shou'bu'shi'pai	0
补特伽罗	bu'te'ga'luo	0
不同境界	bu'tong'jing'jie	0
不退寺	bu'tui'si	0
补陀洛山	bu'tuo'luo'shan	0
不闲	bu'xian	0
不像个人	bu'xiang'ge'ren	0
不相应心	bu'xiang'ying'xin	0
不信是真谛	bu'xin'shi'zhen'di	0
补续高僧传	bu'xu'gao'seng'chuan	0
不许为师	bu'xu'wei'shi	0
不要拂拭	bu'yao'fu'shi	0
不一不异说	bu'yi'bu'yi'shuo	0
不饮酒戒	bu'yin'jiu'jie	0
不在别处	bu'zai'bie'chu	0
不增不减	bu'zeng'bu'jian	0
不增不减经	bu'zeng'bu'jian'jing	0
不着相	bu'zhao'xiang	0
不知道	bu'zhi'dao	0
部执异论	bu'zhi'yi'lun	0
蔡巴贡噶多杰	cai'ba'gong'ga'duo'jie	0
财宝天王心咒	cai'bao'tian'wang'xin'zhou	0
菜根谭	cai'gen'tan	0
蔡荣婷	cai'rong'ting	0
蔡运辰	cai'yun'chen	0
参	can	0
参禅	can'chan	0
参禅法器	can'chan'fa'qi	0
参笼	can'long	0
残缺的鬼	can'que'de'gui	0
参天台五台山记	can'tian'tai'wu'tai'shan'ji	0
粲英	can'ying	0
璨幽	can'you	0
藏论	cang'lun	0
沧州水月寺	cang'zhou'shui'yue'si	0
曹洞教会修证义	cao'dong'jiao'hui'xiu'zheng'yi	0
曹洞宗	cao'dong'zong	0
操度心咒	cao'du'xin'zhou	0
漕矩咤国	cao'ju'zha'guo	0
草木成佛	cao'mu'cheng'fo	0
曹仕邦	cao'shi'bang	0
草堂派	cao'tang'pai	0
草堂寺	cao'tang'si	0
曹王禅寺	cao'wang'chan'si	0
曹溪宝林传	cao'xi'bao'lin'chuan	0
曹溪宗	cao'xi'zong	0
曾普信	ceng'pu'xin	0
茶	cha	0
剎	cha	0
茶杯的死期	cha'bei'de'si'qi	0
茶杯与茶壶	cha'bei'yu'cha'hu	0
差别	cha'bie	0
茶禅一味	cha'chan'yi'wei	0
茶道	cha'dao	0
剎帝利	cha'di'li	0
剎那	cha'na	0
叉手	cha'shou	0
茶心禅意	cha'xin'chan'yi	0
禅	chan	0
缠	chan	0
禅病	chan'bing	0
禅茶录	chan'cha'lu	0
禅的心要	chan'de'xin'yao	0
禅灯世谱	chan'deng'shi'pu	0
忏法	chan'fa	0
禅法要解	chan'fa'yao'jie	0
禅非所知	chan'fei'suo'zhi	0
缠缚	chan'fu	0
禅关策进	chan'guan'ce'jin	0
禅海十珍	chan'hai'shi'zhen	0
忏悔	chan'hui	0
忏悔歌	chan'hui'ge	0
忏悔换来夫妻和	chan'hui'huan'lai'fu'qi'he	0
忏悔偈	chan'hui'ji	0
禅戒	chan'jie	0
禅聚	chan'ju	0
禅林宝训	chan'lin'bao'xun	0
禅林类聚	chan'lin'lei'ju	0
禅林僧宝传	chan'lin'seng'bao'chuan	0
禅林疏语考证	chan'lin'shu'yu'kao'zheng	0
禅林寺	chan'lin'si	0
禅林象器笺	chan'lin'xiang'qi'jian	0
禅门锻鍊说	chan'men'duan'lian'shuo	0
禅门公案名	chan'men'gong'an'ming	0
禅门口诀	chan'men'kou'jue	0
禅门拈颂集	chan'men'nian'song'ji	0
禅门日诵	chan'men'ri'song	0
禅门师资承袭图	chan'men'shi'zi'cheng'xi'tu	0
禅门问答	chan'men'wen'da	0
禅门要略	chan'men'yao'lve	0
禅祕要法经	chan'mi'yao'fa'jing	0
禅如来如去	chan'ru'lai'ru'qu	0
禅师	chan'shi	0
禅说	chan'shuo	0
禅味	chan'wei	0
禅像什么	chan'xiang'shen'me	0
禅心与经语	chan'xin'yu'jing'yu	0
禅需自悟	chan'xu'zi'wu	0
禅与牛	chan'yu'niu	0
禅与生活	chan'yu'sheng'huo	0
禅院	chan'yuan	0
禅苑蒙求	chan'yuan'meng'qiu	0
禅苑清规	chan'yuan'qing'gui	0
禅院钟声	chan'yuan'zhong'sheng	0
禅源诸诠集都序	chan'yuan'zhu'quan'ji'dou'xu	0
禅月集	chan'yue'ji	0
忏云	chan'yun	0
禅云寺	chan'yun'si	0
禅者的脚步百年虚云	chan'zhe'de'jiao'bu'bai'nian'xu'yun	0
禅者的祝福	chan'zhe'de'zhu'fu	0
禅宗	chan'zong	0
禅宗决疑集	chan'zong'jue'yi'ji	0
禅宗全书	chan'zong'quan'shu	0
禅宗永嘉集	chan'zong'yong'jia'ji	0
禅宗语录	chan'zong'yu'lu	0
禅宗杂毒海	chan'zong'za'du'hai	0
禅宗正脉	chan'zong'zheng'mai	0
禅宗直指	chan'zong'zhi'zhi	0
长阿含经	chang'a'han'jing	0
长安佛教	chang'an'fo'jiao	0
常不轻菩萨	chang'bu'qing'pu'sa	0
长春观	chang'chun'guan	0
常春观	chang'chun'guan	0
唱导	chang'dao	0
长干寺	chang'gan'si	0
长谷寺	chang'gu'si	0
长跪	chang'gui	0
常寂光土	chang'ji'guang'tu	0
常见	chang'jian	0
长井真琴	chang'jing'zhen'qin	0
常觉	chang'jue	0
长老尼偈	chang'lao'ni'ji	0
长寿佛咒	chang'shou'fo'zhou	0
长寿灭罪护诸童子陀罗尼经	chang'shou'mie'zui'hu'zhu'tong'zi'tuo'luo'ni'jing	0
长松清风	chang'song'qing'feng	0
长松茹退	chang'song'ru'tui	0
长尾雅人	chang'wei'ya'ren	0
长物	chang'wu	0
长西	chang'xi	0
长行	chang'xing	0
长爪梵志	chang'zhao'fan'zhi	0
常州九龙禅寺	chang'zhou'jiu'long'chan'si	0
常住	chang'zhu	0
昌珠寺	chang'zhu'si	0
常住物	chang'zhu'wu	0
超峰寺	chao'feng'si	0
超佛越祖	chao'fo'yue'zu	0
超戒寺	chao'jie'si	0
抄经	chao'jing	0
朝鲜佛教	chao'xian'fo'jiao	0
朝鲜佛教通史	chao'xian'fo'jiao'tong'shi	0
朝阳寺	chao'yang'si	0
超越三昧	chao'yue'san'mei	0
超越生死	chao'yue'sheng'si	0
超证	chao'zheng	0
尘	chen	0
瞋	chen	0
陈柏达	chen'bai'da	0
沉淀	chen'dian	0
尘点劫	chen'dian'jie	0
陈慧剑	chen'hui'jian	0
陈健民	chen'jian'min	0
尘劳	chen'lao	0
晨露荷珠	chen'lu'he'zhu	0
陈履安	chen'lv'an	0
晨起祈愿文	chen'qi'qi'yuan'wen	0
陈弃药	chen'qi'yao	0
陈清香	chen'qing'xiang	0
陈荣波	chen'rong'bo	0
陈荣灼	chen'rong'zhuo	0
尘沙惑	chen'sha'huo	0
陈神赐	chen'shen'ci	0
沈香树	chen'xiang'shu	0
陈英善	chen'ying'shan	0
陈又新	chen'you'xin	0
陈玉蛟	chen'yu'jiao	0
晨钟偈	chen'zhong'ji	0
陈祚龙	chen'zuo'long	0
承澄	cheng'cheng	0
成道	cheng'dao	0
成佛	cheng'fo	0
成佛之路	cheng'fo'zhi'lu	0
成功就是战胜自己	cheng'gong'jiu'shi'zhan'sheng'zi'ji	0
澄观	cheng'guan	0
成就	cheng'jiu	0
成就法鬘	cheng'jiu'fa'man	0
称名念佛	cheng'ming'nian'fo	0
称念	cheng'nian	0
成实论	cheng'shi'lun	0
成实师	cheng'shi'shi	0
诚实无欺	cheng'shi'wu'qi	0
成实宗	cheng'shi'zong	0
承受信物	cheng'shou'xin'wu	0
承天寺	cheng'tian'si	0
成唯识论	cheng'wei'shi'lun	0
成唯识论述记	cheng'wei'shi'lun'shu'ji	0
呈心偈	cheng'xin'ji	0
成一	cheng'yi	0
承远	cheng'yuan	0
澄远	cheng'yuan	0
称赞净土佛摄受经	cheng'zan'jing'tu'fo'she'shou'jing	0
承珠	cheng'zhu	0
痴	chi	0
吃茶去	chi'cha'qu	0
喫茶养生记	chi'cha'yang'sheng'ji	0
赤峰根佩庙	chi'feng'gen'pei'miao	0
赤峰罕庙	chi'feng'han'miao	0
持国天	chi'guo'tian	0
持戒	chi'jie	0
持律	chi'lv	0
持明咒藏	chi'ming'zhou'cang	0
齿木	chi'mu	0
炽盛光佛顶	chi'sheng'guang'fo'ding	0
持世经	chi'shi'jing	0
持松	chi'song	0
祇陀太子	chi'tuo'tai'zi	0
祇夜	chi'ye	0
祇夜多	chi'ye'duo	0
祇园会	chi'yuan'hui	0
祇园精舍	chi'yuan'jing'she	0
祇园寺	chi'yuan'si	0
持斋	chi'zhai	0
崇福寺	chong'fu'si	0
重庆华岩寺	chong'qing'hua'yan'si	0
重庆梁平鸣钟寺	chong'qing'liang'ping'ming'zhong'si	0
重庆市巴南区云豁寺	chong'qing'shi'ba'nan'qu'yun'huo'si	0
重庆市垫江县太平寺	chong'qing'shi'dian'jiang'xian'tai'ping'si	0
重庆太平禅院	chong'qing'tai'ping'chan'yuan	0
崇善寺	chong'shan'si	0
崇圣寺三塔	chong'sheng'si'san'ta	0
筹	chou	0
处	chu	0
锄草斩蛇	chu'cao'zhan'she	0
出定	chu'ding	0
出定后语	chu'ding'hou'yu	0
出定笑语	chu'ding'xiao'yu	0
初法明道	chu'fa'ming'dao	0
出家	chu'jia	0
楚金	chu'jin	0
楚俊	chu'jun	0
出离	chu'li	0
出离依	chu'li'yi	0
出去	chu'qu	0
除却心头火	chu'que'xin'tou'huo	0
出三藏记集	chu'san'zang'ji'ji	0
畜生道	chu'sheng'dao	0
出世	chu'shi	0
楚石禅师语录	chu'shi'chan'shi'yu'lu	0
出世间	chu'shi'jian	0
处事秘诀	chu'shi'mi'jue	0
楚王英	chu'wang'ying	0
出污泥而不染	chu'wu'ni'er'bu'ran	0
出行会	chu'xing'hui	0
出曜经	chu'yao'jing	0
初夜	chu'ye	0
除一切疾病咒	chu'yi'qie'ji'bing'zhou	0
楚圆	chu'yuan	0
初转法轮	chu'zhuan'fa'lun	0
初祖庵	chu'zu'an	0
初祖达摩	chu'zu'da'mo	0
传道	chuan'dao	0
传灯	chuan'deng	0
传灯录	chuan'deng'lu	0
传灯玉英集	chuan'deng'yu'ying'ji	0
传法	chuan'fa	0
传法宝纪	chuan'fa'bao'ji	0
传法灌顶	chuan'fa'guan'ding	0
传法院	chuan'fa'yuan	0
传法正宗记	chuan'fa'zheng'zong'ji	0
传供	chuan'gong	0
传光录	chuan'guang'lu	0
传悔	chuan'hui	0
传戒	chuan'jie	0
传孝	chuan'xiao	0
传衣	chuan'yi	0
传顗	chuan'yi	0
穿衣吃饭	chuan'yi'chi'fan	0
传召法会	chuan'zhao'fa'hui	0
垂示	chui'shi	0
春日版	chun'ri'ban	0
春日曼荼罗	chun'ri'man'tu'luo	0
慈悲	ci'bei	0
慈悲道场忏法	ci'bei'dao'chang'chan'fa	0
慈悲水忏法	ci'bei'shui'chan'fa	0
慈藏	ci'cang	0
慈昌	ci'chang	0
次第三观	ci'di'san'guan	0
慈恩禅寺	ci'en'chan'si	0
慈观	ci'guan	0
慈航	ci'hang	0
慈航寺	ci'hang'si	0
慈惠	ci'hui	0
慈经	ci'jing	0
慈静寺	ci'jing'si	0
慈愍派	ci'min'pai	0
慈明寺	ci'ming'si	0
慈蓉	ci'rong	0
慈善寺	ci'shan'si	0
此生不能不认识的一个人	ci'sheng'bu'neng'bu'ren'shi'de'yi'ge'ren	0
辞世偈	ci'shi'ji	0
慈溪高山寺	ci'xi'gao'shan'si	0
慈心三昧	ci'xin'san'mei	0
慈怡	ci'yi	0
慈云寺	ci'yun'si	0
慈舟	ci'zhou	0
慈庄	ci'zhuang	0
丛林集	cong'lin'ji	0
葱岭	cong'ling	0
从容录	cong'rong'lu	0
从心流出	cong'xin'liu'chu	0
崔忠镇	cui'zhong'zhen	0
存财于信徒	cun'cai'yu'xin'tu	0
存奖	cun'jiang	0
存牛	cun'niu	0
寸丝不挂	cun'si'bu'gua	0
存易	cun'yi	0
大阿弥陀经	da'a'mi'tuo'jing	0
大爱道比丘尼经	da'ai'dao'bi'qiu'ni'jing	0
大安般守意经	da'an'ban'shou'yi'jing	0
大安寺	da'an'si	0
大安寺流	da'an'si'liu	0
大白伞盖佛母法	da'bai'san'gai'fo'mu'fa	0
大般涅槃经	da'ban'nie'pan'jing	0
大般若波罗蜜多经	da'ban'ruo'bo'luo'mi'duo'jing	0
大般若波罗蜜多经叙	da'ban'ruo'bo'luo'mi'duo'jing'xu	0
大般若会	da'ban'ruo'hui	0
大报恩寺	da'bao'en'si	0
大宝法王	da'bao'fa'wang	0
大宝法王传奇	da'bao'fa'wang'chuan'qi	0
大宝积经	da'bao'ji'jing	0
大宝积经论	da'bao'ji'jing'lun	0
大悲	da'bei	0
大悲忏法	da'bei'chan'fa	0
大悲阐提	da'bei'chan'ti	0
大悲空智金刚大教王仪轨经	da'bei'kong'zhi'jin'gang'da'jiao'wang'yi'gui'jing	0
大悲心陀罗尼	da'bei'xin'tuo'luo'ni	0
大悲咒	da'bei'zhou	0
达彬瑜寺	da'bin'yu'si	0
大不善地法	da'bu'shan'de'fa	0
大曹王寺	da'cao'wang'si	0
呾叉始罗	da'cha'shi'luo	0
达超	da'chao	0
达嚫	da'chen	0
大乘阿毗达磨集论	da'cheng'a'pi'da'mo'ji'lun	0
大乘阿毗达磨杂集论	da'cheng'a'pi'da'mo'za'ji'lun	0
大乘百法明门论	da'cheng'bai'fa'ming'men'lun	0
大乘宝要义论	da'cheng'bao'yao'yi'lun	0
大乘本生心地观经	da'cheng'ben'sheng'xin'di'guan'jing	0
大乘成业论	da'cheng'cheng'ye'lun	0
大乘稻秆经	da'cheng'dao'gan'jing	0
大乘二十二问	da'cheng'er'shi'er'wen	0
大乘法界无差别论	da'cheng'fa'jie'wu'cha'bie'lun	0
大乘法王	da'cheng'fa'wang	0
大乘法相研神章	da'cheng'fa'xiang'yan'shen'zhang	0
大乘法苑义林章	da'cheng'fa'yuan'yi'lin'zhang	0
大乘非佛说论	da'cheng'fei'fo'shuo'lun	0
大乘佛教	da'cheng'fo'jiao	0
大乘伽耶山顶经	da'cheng'ga'ye'shan'ding'jing	0
大乘集菩萨学论	da'cheng'ji'pu'sa'xue'lun	0
大乘经	da'cheng'jing	0
大乘理趣六波罗蜜多经	da'cheng'li'qu'liu'bo'luo'mi'duo'jing	0
大乘离文字普光明藏经	da'cheng'li'wen'zi'pu'guang'ming'cang'jing	0
大乘论	da'cheng'lun	0
大乘律	da'cheng'lv	0
大乘密严经	da'cheng'mi'yan'jing	0
大乘菩萨入道三种观	da'cheng'pu'sa'ru'dao'san'zhong'guan	0
大乘起信论	da'cheng'qi'xin'lun	0
大乘三系	da'cheng'san'xi	0
大乘上座部	da'cheng'shang'zuo'bu	0
大乘四果	da'cheng'si'guo	0
大乘唯识论	da'cheng'wei'shi'lun	0
大乘五门十地实相论	da'cheng'wu'men'shi'di'shi'xiang'lun	0
大乘无生方便门	da'cheng'wu'sheng'fang'bian'men	0
大乘无相妄执	da'cheng'wu'xiang'wang'zhi	0
大乘五蕴论	da'cheng'wu'yun'lun	0
大乘显识经	da'cheng'xian'shi'jing	0
大乘修心七义论释	da'cheng'xiu'xin'qi'yi'lun'shi	0
大乘玄论	da'cheng'xuan'lun	0
大乘要道密集	da'cheng'yao'dao'mi'ji	0
大乘义章	da'cheng'yi'zhang	0
大乘造像功德经	da'cheng'zao'xiang'gong'de'jing	0
大乘掌珍论	da'cheng'zhang'zhen'lun	0
大乘止观法门	da'cheng'zhi'guan'fa'men	0
大乘中观释论	da'cheng'zhong'guan'shi'lun	0
大乘庄严宝王经	da'cheng'zhuang'yan'bao'wang'jing	0
大乘庄严经论	da'cheng'zhuang'yan'jing'lun	0
大川隆法	da'chuan'long'fa	0
大慈大悲	da'ci'da'bei	0
大慈恩寺	da'ci'en'si	0
大慈恩寺三藏法师传	da'ci'en'si'san'zang'fa'shi'chuan	0
大慈法王	da'ci'fa'wang	0
大慈寺	da'ci'si	0
大村西崖	da'cun'xi'ya	0
大道长安	da'dao'chang'an	0
大德	da'de	0
大德寺	da'de'si	0
大德寺派	da'de'si'pai	0
大灯国师语录	da'deng'guo'shi'yu'lu	0
大地法	da'di'fa	0
大颠与韩愈	da'dian'yu'han'yu	0
大定	da'ding	0
达尔喀	da'er'ka	0
大法鼓经	da'fa'gu'jing	0
大法鼓寺	da'fa'gu'si	0
大烦恼地法	da'fan'nao'de'fa	0
大梵天	da'fan'tian	0
大梵天王问佛决疑经	da'fan'tian'wang'wen'fo'jue'yi'jing	0
大方等大集经	da'fang'deng'da'ji'jing	0
大方等大集日藏经	da'fang'deng'da'ji'ri'cang'jing	0
大方等大集月藏经	da'fang'deng'da'ji'yue'cang'jing	0
大方等无想经	da'fang'deng'wu'xiang'jing	0
大方广佛华严经	da'fang'guang'fo'hua'yan'jing	0
大方广佛华严经修慈分	da'fang'guang'fo'hua'yan'jing'xiu'ci'fen	0
大方广如来藏经	da'fang'guang'ru'lai'cang'jing	0
大峰山	da'feng'shan	0
大佛	da'fo	0
大佛寺	da'fo'si	0
大鼓	da'gu	0
大谷大学	da'gu'da'xue	0
大谷光瑞	da'gu'guang'rui	0
大谷石佛	da'gu'shi'fo	0
大谷探险队	da'gu'tan'xian'dui	0
大观	da'guan	0
达和	da'he	0
大黑天	da'hei'tian	0
大幻化网导引法	da'huan'hua'wang'dao'yin'fa	0
大慧刀	da'hui'dao	0
大慧派	da'hui'pai	0
大慧普觉禅师年谱	da'hui'pu'jue'chan'shi'nian'pu	0
大慧普觉禅师语录	da'hui'pu'jue'chan'shi'yu'lu	0
大回向文	da'hui'xiang'wen	0
大机大用	da'ji'da'yong	0
大吉祥天女咒	da'ji'xiang'tian'nv'zhou	0
大迦叶尊者	da'jia'ye'zun'zhe	0
大鉴禅师小清规	da'jian'chan'shi'xiao'qing'gui	0
大荐福寺	da'jian'fu'si	0
大觉禅师语录	da'jiao'chan'shi'yu'lu	0
大九华山西来禅寺	da'jiu'hua'shan'xi'lai'chan'si	0
大觉寺	da'jue'si	0
大开静	da'kai'jing	0
大孔雀明王心咒	da'kong'que'ming'wang'xin'zhou	0
大哭往生与大笑往生	da'ku'wang'sheng'yu'da'xiao'wang'sheng	0
达赖喇嘛	da'lai'la'ma	0
大礼拜	da'li'bai	0
大理佛教	da'li'fo'jiao	0
大理国梵像卷	da'li'guo'fan'xiang'juan	0
大连宝华寺大雄宝殿上梁	da'lian'bao'hua'si'da'xiong'bao'dian'shang'liang	0
大连圣水寺	da'lian'sheng'shui'si	0
大连市莲花山寺	da'lian'shi'lian'hua'shan'si	0
大连瓦房店龙山涌泉寺	da'lian'wa'fang'dian'long'shan'yong'quan'si	0
大连瓦房店市观海寺	da'lian'wa'fang'dian'shi'guan'hai'si	0
大林精舍	da'lin'jing'she	0
达垄噶举派	da'long'ga'ju'pai	0
大龙宫寺	da'long'gong'si	0
达垄寺	da'long'si	0
达罗毗荼国	da'luo'pi'tu'guo	0
达玛瑜特派	da'ma'yu'te'pai	0
大明高僧传	da'ming'gao'seng'chuan	0
大明仁孝皇后梦感佛说第一希有大功德经	da'ming'ren'xiao'huang'hou'meng'gan'fo'shuo'di'yi'xi'you'da'gong'de'jing	0
大明三藏法数	da'ming'san'zang'fa'shu	0
大明寺	da'ming'si	0
大明塔	da'ming'ta	0
达摩波罗	da'mo'bo'luo	0
达摩多罗	da'mo'duo'luo	0
达磨多罗禅经	da'mo'duo'luo'chan'jing	0
达磨忌	da'mo'ji	0
达摩笈多	da'mo'ji'duo	0
达摩易筋经十二式	da'mo'yi'jin'jing'shi'er'shi	0
达磨遮提	da'mo'zhe'ti	0
达摩祖师	da'mo'zu'shi	0
大目干连冥间救母变文	da'mu'gan'lian'ming'jian'jiu'mu'bian'wen	0
大念佛寺	da'nian'fo'si	0
大毗卢遮那成佛经疏	da'pi'lu'zhe'na'cheng'fo'jing'shu	0
大毗卢遮那经广大仪轨	da'pi'lu'zhe'na'jing'guang'da'yi'gui	0
大毗婆沙论	da'pi'po'sha'lun	0
大品般若经	da'pin'bo're'jing	0
打破碗	da'po'wan	0
打七	da'qi	0
大千为床	da'qian'wei'chuang	0
大秦国	da'qin'guo	0
大秦景教流行中国碑	da'qin'jing'jiao'liu'xing'zhong'guo'bei	0
大秦寺	da'qin'si	0
大权修理菩萨	da'quan'xiu'li'pu'sa	0
大日本佛教会	da'ri'ben'fo'jiao'hui	0
大日本佛教全书	da'ri'ben'fo'jiao'quan'shu	0
大日本国法华经验记	da'ri'ben'guo'fa'hua'jing'yan'ji	0
大日经	da'ri'jing	0
大日如来	da'ri'ru'lai	0
大萨遮尼干子所说经	da'sa'zhe'ni'gan'zi'suo'shuo'jing	0
大善地法	da'shan'di'fa	0
大圣欢喜天	da'sheng'huan'xi'tian	0
大事	da'shi	0
大史	da'shi	0
大师	da'shi	0
大士讲经	da'shi'jiang'jing	0
大石寺	da'shi'si	0
大势至菩萨	da'shi'zhi'pu'sa	0
大势至菩萨心咒	da'shi'zhi'pu'sa'xin'zhou	0
大手印	da'shou'yin	0
大手印传承祖师祈请文	da'shou'yin'chuan'cheng'zu'shi'qi'qing'wen	0
大树紧那罗王	da'shu'jin'na'luo'wang	0
大树紧那罗王所问经	da'shu'jin'na'luo'wang'suo'wen'jing	0
达斯	da'si	0
大寺	da'si	0
达斯笈多	da'si'ji'duo	0
大宋僧史略	da'song'seng'shi'lve	0
大随求菩萨	da'sui'qiu'pu'sa	0
大随求陀罗尼	da'sui'qiu'tuo'luo'ni	0
大唐内典录	da'tang'nei'dian'lu	0
大唐西游记	da'tang'xi'you'ji	0
大唐西域记	da'tang'xi'yu'ji	0
大唐西域求法高僧传	da'tang'xi'yu'qiu'fa'gao'seng'chuan	0
怛特罗	da'te'luo	0
怛特罗部集成	da'te'luo'bu'ji'cheng	0
怛特罗佛教	da'te'luo'fo'jiao	0
大天	da'tian	0
大天五事	da'tian'wu'shi	0
大同	da'tong	0
大通智胜佛	da'tong'zhi'sheng'fo	0
大威德明王	da'wei'de'ming'wang	0
大我	da'wo	0
大无畏	da'wu'wei	0
大訢	da'xi	0
大贤	da'xian	0
大仙寺	da'xian'si	0
大小不二	da'xiao'bu'er	0
大小粪桶	da'xiao'fen'tong	0
大小邪见知多少	da'xiao'xie'jian'zhi'duo'shao	0
达信王	da'xin'wang	0
大醒	da'xing	0
大兴善寺	da'xing'shan'si	0
大行事	da'xing'shi	0
大兴寺	da'xing'si	0
大雄	da'xiong	0
大雄宝殿	da'xiong'bao'dian	0
大衍历	da'yan'li	0
大雁塔	da'yan'ta	0
撘衣仪式	da'yi'yi'shi	0
大应派	da'ying'pai	0
大勇	da'yong	0
大佑	da'you	0
大圆镜智	da'yuan'jing'zhi	0
大圆觉寺	da'yuan'jue'si	0
大圆满	da'yuan'man	0
大圆满龙钦心髓前行引导文	da'yuan'man'long'qin'xin'sui'qian'xing'yin'dao'wen	0
大圆满无上智广大心要	da'yuan'man'wu'shang'zhi'guang'da'xin'yao	0
大圆满心要总集	da'yuan'man'xin'yao'zong'ji	0
大圆满虚幻休息妙车疏	da'yuan'man'xu'huan'xiu'xi'miao'che'shu	0
大圆满中阴身闻即解脱成佛咒	da'yuan'man'zhong'yin'shen'wen'ji'jie'tuo'cheng'fo'zhou	0
大圆满中阴声闻解脱即成佛咒	da'yuan'man'zhong'yin'sheng'wen'jie'tuo'ji'cheng'fo'zhou	0
大原问答	da'yuan'wen'da	0
大云轮请雨经	da'yun'lun'qing'yu'jing	0
大云寺	da'yun'si	0
大藏经	da'zang'jing	0
大藏经补编	da'zang'jing'bu'bian	0
大藏经纲目指要录	da'zang'jing'gang'mu'zhi'yao'lu	0
大藏经索引	da'zang'jing'suo'yin	0
大藏圣教法宝标目	da'zang'sheng'jiao'fa'bao'biao'mu	0
大藏一览集	da'zang'yi'lan'ji	0
大丈夫论	da'zhang'fu'lun	0
大召	da'zhao	0
大昭庆律寺志	da'zhao'qing'lv'si'zhi	0
大昭寺	da'zhao'si	0
大正大学	da'zheng'da'xue	0
大正觉寺	da'zheng'jue'si	0
大正新修大藏经	da'zheng'xin'xiu'da'zang'jing	0
大智度论	da'zhi'du'lun	0
大众部	da'zhong'bu	0
大钟寺	da'zhong'si	0
大中祥符法宝录	da'zhong'xiang'fu'fa'bao'lu	0
大周刊定众经目录	da'zhou'kan'ding'zhong'jing'mu'lu	0
大庄严论经	da'zhuang'yan'lun'jing	0
大自在祈请文	da'zi'zai'qi'qing'wen	0
大自在摄受祈祷文	da'zi'zai'she'shou'qi'dao'wen	0
大自在天	da'zi'zai'tian	0
大宗地玄文本论	da'zong'di'xuan'wen'ben'lun	0
大足石刻	da'zu'shi'ke	0
打坐非禅	da'zuo'fei'chan	0
戴传贤	dai'chuan'xian	0
待客之道	dai'ke'zhi'dao	0
戴逵	dai'kui	0
戴密微	dai'mi'wei	0
戴维斯	dai'wei'si	0
带业往生	dai'ye'wang'sheng	0
傣族佛教	dai'zu'fo'jiao	0
单	dan	0
胆巴	dan'ba	0
担当	dan'dang	0
但念阿弥陀佛	dan'nian'e'mi'tuo'fo	0
丹田	dan'tian	0
丹霞烧佛	dan'xia'shao'fo	0
丹霞天然	dan'xia'tian'ran	0
丹周尔	dan'zhou'er	0
当巴桑结	dang'ba'sang'jie	0
当麻曼荼罗	dang'ma'man'tu'luo	0
道	dao	0
道安	dao'an	0
道白	dao'bai	0
道场	dao'chang	0
道场寺	dao'chang'si	0
道成寺	dao'cheng'si	0
道宠	dao'chong	0
道绰	dao'chuo	0
道谛	dao'di	0
到底有没有因果报应	dao'di'you'mei'you'yin'guo'bao'ying	0
道端良秀	dao'duan'liang'xiu	0
道机	dao'ji	0
道济	dao'ji	0
道阶	dao'jie	0
道开	dao'kai	0
道楷	dao'kai	0
道朗	dao'lang	0
到了龙潭	dao'le'long'tan	0
倒离	dao'li	0
忉利天	dao'li'tian	0
道林	dao'lin	0
道隆	dao'long	0
道伦	dao'lun	0
道忞	dao'min	0
道霈	dao'pei	0
道钦	dao'qin	0
道融	dao'rong	0
道诜	dao'shen	0
道诜寺	dao'shen'si	0
道生	dao'sheng	0
道盛	dao'sheng	0
道世	dao'shi	0
岛史	dao'shi	0
道邃	dao'sui	0
道悟	dao'wu	0
道信	dao'xin	0
道宣	dao'xuan	0
道璇	dao'xuan	0
道衍	dao'yan	0
道一	dao'yi	0
道义	dao'yi	0
道膺	dao'ying	0
道余录	dao'yu'lu	0
道元	dao'yuan	0
道源	dao'yuan	0
道在何处	dao'zai'he'chu	0
道在平常日用中	dao'zai'ping'chang'ri'yong'zhong	0
道昭	dao'zhao	0
道忠	dao'zhong	0
德格印经院	de'ge'yin'jing'yuan	0
德光	de'guang	0
德慧	de'hui	0
德惠寺	de'hui'si	0
德俭	de'jian	0
德清	de'qing	0
德僧	de'seng	0
德山禅师轶事	de'shan'chan'shi'yi'shi	0
德山寺	de'shan'si	0
德韶	de'shao	0
德异	de'yi	0
德源禅寺	de'yuan'chan'si	0
德源寺	de'yuan'si	0
德政禅寺	de'zheng'chan'si	0
登噶尔玛目录	deng'ga'er'ma'mu'lu	0
灯光城	deng'guang'cheng	0
等活地狱	deng'huo'di'yu	0
等觉	deng'jue	0
邓克铭	deng'ke'ming	0
等流习气	deng'liu'xi'qi	0
灯明	deng'ming	0
登明寺	deng'ming'si	0
等闲击碎虚空骨	deng'xian'ji'sui'xu'kong'gu	0
灯芯将残	deng'xin'jiang'can	0
邓隐峰参石头禅师公案	deng'yin'feng'can'shi'tou'chan'shi'gong'an	0
谛	di	0
谛观	di'guan	0
地华	di'hua	0
地居天	di'ju'tian	0
地论宗	di'lun'zong	0
底沙佛	di'sha'fo	0
帝师	di'shi	0
帝失罗叉	di'shi'luo'cha	0
帝释天	di'shi'tian	0
滴水和尚	di'shui'he'shang	0
滴水开悟	di'shui'kai'wu	0
地天	di'tian	0
谛闲	di'xian	0
第一义谛	di'yi'yi'di	0
第一义空	di'yi'yi'kong	0
地狱	di'yu	0
地狱变	di'yu'bian	0
地狱得道	di'yu'de'dao	0
地狱与极乐	di'yu'yu'ji'le	0
地藏菩萨	di'zang'pu'sa	0
地藏菩萨本愿经	di'zang'pu'sa'ben'yuan'jing	0
地藏菩萨发心因缘十王经	di'zang'pu'sa'fa'xin'yin'yuan'shi'wang'jing	0
地藏菩萨故事	di'zang'pu'sa'gu'shi	0
地藏菩萨礼赞歌	di'zang'pu'sa'li'zan'ge	0
地藏菩萨灵感歌	di'zang'pu'sa'ling'gan'ge	0
地藏菩萨陀罗尼	di'zang'pu'sa'tuo'luo'ni	0
地藏菩萨心咒	di'zang'pu'sa'xin'zhou	0
地藏十轮经	di'zang'shi'lun'jing	0
地藏王	di'zang'wang	0
地藏王菩薩超度心咒	di'zang'wang'pu'sa'chao'du'xin'zhou	0
颠倒	dian'dao	0
垫江县报恩寺	dian'jiang'xian'bao'en'si	0
垫江县太平寺念佛堂	dian'jiang'xian'tai'ping'si'nian'fo'tang	0
电脑佛典	dian'nao'fo'dian	0
滇释记	dian'shi'ji	0
殿堂	dian'tang	0
典座	dian'zuo	0
掉举	diao'ju	0
定	ding	0
定宾	ding'bin	0
定朝	ding'chao	0
定琛	ding'chen	0
丁福保	ding'fu'bao	0
定共戒	ding'gong'jie	0
定慧寺	ding'hui'si	0
顶礼	ding'li	0
定林寺	ding'lin'si	0
丁敏	ding'min	0
定散	ding'san	0
丁氏佛学丛书	ding'shi'fo'xue'cong'shu	0
定西	ding'xi	0
定业	ding'ye	0
定印	ding'yin	0
东禅院	dong'chan'yuan	0
东初	dong'chu	0
东大寺	dong'da'si	0
东方八佛	dong'fang'ba'fo	0
东方圣书	dong'fang'sheng'shu	0
东福寺	dong'fu'si	0
东国大学	dong'guo'da'xue	0
东国高僧传	dong'guo'gao'seng'chuan	0
东国僧尼录	dong'guo'seng'ni'lu	0
东海观音寺	dong'hai'guan'yin'si	0
东汉佛教	dong'han'fo'jiao	0
东鹤寺	dong'he'si	0
东晋佛教	dong'jin'fo'jiao	0
东净寺	dong'jing'si	0
东林十八高贤传	dong'lin'shi'ba'gao'xian'chuan	0
东林寺	dong'lin'si	0
东密	dong'mi	0
东明派	dong'ming'pai	0
东明寺	dong'ming'si	0
洞然明白	dong'ran'ming'bai	0
洞山良价	dong'shan'liang'jia	0
东山寺	dong'shan'si	0
洞山悟本大师语录	dong'shan'wu'ben'da'shi'yu'lu	0
洞山五位	dong'shan'wu'wei	0
洞上祖宪录	dong'shang'zu'xian'lu	0
东塔宗	dong'ta'zong	0
东洋大学	dong'yang'da'xue	0
兜跋毗沙门	dou'ba'pi'sha'men	0
都讲	dou'jiang	0
兜率天	dou'lv'tian	0
兜沙经	dou'sha'jing	0
笃补巴	du'bu'ba	0
度牒	du'die	0
毒鼓	du'gu	0
睹货逻国	du'huo'luo'guo	0
读经	du'jing	0
闍烂达罗国	du'lan'da'luo'guo	0
独乐寺	du'le'si	0
度门寺	du'men'si	0
度母赞	du'mu'zan	0
闍那崛多	du'na'jue'duo	0
度僧制度	du'seng'zhi'du	0
闍耶跋摩七世	du'ye'ba'mo'qi'shi	0
犊子部	du'zi'bu	0
断惑	duan'huo	0
端美三菩提	duan'mei'san'pu'ti	0
断灭论	duan'mie'lun	0
断末摩	duan'mo'mo	0
断俗寺	duan'su'si	0
断瘟咒	duan'wen'zhou	0
端正的难陀	duan'zheng'de'nan'tuo	0
兑律	dui'lv	0
对治离	dui'zhi'li	0
敦化正觉寺	dun'hua'zheng'jue'si	0
敦煌石窟	dun'huang'shi'ku	0
顿渐二教	dun'jian'er'jiao	0
顿悟	dun'wu	0
顿悟大乘正理决	dun'wu'da'cheng'zheng'li'jue	0
顿悟入道要门论	dun'wu'ru'dao'yao'men'lun	0
多宝佛	duo'bao'fo	0
多吃了六个饼	duo'chi'le'liu'ge'bing	0
朵尔杰	duo'er'jie	0
多捡一些	duo'jian'yi'xie	0
多杰觉拔	duo'jie'jue'ba	0
多揭罗香树	duo'jie'luo'xiang'shu	0
多伦寺	duo'lun'si	0
堕罗钵底国	duo'luo'bo'di'guo	0
多罗那他	duo'luo'na'ta	0
多罗那他佛教史	duo'luo'na'ta'fo'jiao'shi	0
多罗菩萨	duo'luo'pu'sa	0
多罗树	duo'luo'shu	0
多玛食子	duo'ma'shi'zi	0
多玛斯	duo'ma'si	0
多摩罗跋香树	duo'mo'luo'ba'xiang'shu	0
多念义	duo'nian'yi	0
多少重	duo'shao'zhong	0
多闻	duo'wen	0
多闻部	duo'wen'bu	0
朵依斯特普寺	duo'yi'si'te'pu'si	0
多子塔	duo'zi'ta	0
恶	e	0
恶叉聚	e'cha'ju	0
恶见	e'jian	0
莪阑婵院	e'lan'chan'yuan	0
峨眉山	e'mei'shan	0
阿弥陀佛	e'mi'tuo'fo	0
阿弥陀佛歌	e'mi'tuo'fo'ge	0
阿弥陀佛来接引	e'mi'tuo'fo'lai'jie'yin	0
阿弥陀佛颂	e'mi'tuo'fo'song	0
阿弥陀佛谢谢你	e'mi'tuo'fo'xie'xie'ni	0
阿弥陀佛心咒	e'mi'tuo'fo'xin'zhou	0
阿弥陀佛在心间	e'mi'tuo'fo'zai'xin'jian	0
恶念恶果	e'nian'e'guo	0
恶取空	e'qu'kong	0
恶人正机	e'ren'zheng'ji	0
恶酰掣呾逻国	e'xian'che'da'luo'guo	0
恶知识	e'zhi'shi	0
恶作	e'zuo	0
恩	en	0
二边	er'bian	0
二部僧授戒轨范	er'bu'seng'shou'jie'gui'fan	0
二乘	er'cheng	0
二乘作佛	er'cheng'zuo'fo	0
二重中道	er'chong'zhong'dao	0
耳璫	er'dang	0
二谛	er'di	0
二谛义	er'di'yi	0
耳根	er'gen	0
二根	er'gen	0
二河白道	er'he'bai'dao	0
二护	er'hu	0
二教	er'jiao	0
二教六理	er'jiao'liu'li	0
二教论	er'jiao'lun	0
二空	er'kong	0
二力	er'li	0
二取	er'qu	0
二入四行	er'ru'si'hang	0
二入四行论	er'ru'si'hang'lun	0
耳识	er'shi	0
二十八部众	er'shi'ba'bu'zhong	0
二十八宿	er'shi'ba'xiu	0
二十二根	er'shi'er'gen	0
二十二愚	er'shi'er'yu	0
二十犍度	er'shi'jian'du	0
二十四缘	er'shi'si'yuan	0
二十天	er'shi'tian	0
二十五谛	er'shi'wu'di	0
二十五方便	er'shi'wu'fang'bian	0
二十五神	er'shi'wu'shen	0
二十五有	er'shi'wu'you	0
二十五圆通	er'shi'wu'yuan'tong	0
二十五众	er'shi'wu'zhong	0
二十亿耳	er'shi'yi'er	0
二守护	er'shou'hu	0
二鼠啮藤	er'shu'nie'teng	0
二土	er'tu	0
二土弘经	er'tu'hong'jing	0
二形	er'xing	0
二因	er'yin	0
二隐谧禅师语录	er'yin'mi'chan'shi'yu'lu	0
二月堂	er'yue'tang	0
二障	er'zhang	0
二障义	er'zhang'yi	0
二智	er'zhi	0
二种生死	er'zhong'sheng'si	0
二祖山	er'zu'shan	0
二尊院	er'zun'yuan	0
法	fa	0
法宝	fa'bao	0
法藏	fa'cang	0
法藏部	fa'cang'bu	0
法藏和尚传	fa'cang'he'shang'chuan	0
法藏碎金录	fa'cang'sui'jin'lu	0
法差别相违因	fa'cha'bie'xiang'wei'yin	0
法常	fa'chang	0
法成	fa'cheng	0
法称	fa'cheng	0
法持	fa'chi	0
法冲	fa'chong	0
法处所摄色	fa'chu'suo'she'se	0
法尔自然	fa'er'zi'ran	0
法舫	fa'fang	0
法格崇拜	fa'ge'chong'bai	0
法恭	fa'gong	0
法鼓	fa'gu	0
法光寺	fa'guang'si	0
法果	fa'guo	0
法海寺	fa'hai'si	0
法护	fa'hu	0
法华经安乐行义	fa'hua'jing'an'le'xing'yi	0
法华经法	fa'hua'jing'fa	0
法华经论	fa'hua'jing'lun	0
法华经寺	fa'hua'jing'si	0
法华七喻	fa'hua'qi'yu	0
法华三昧	fa'hua'san'mei	0
法华三昧忏仪	fa'hua'san'mei'chan'yi	0
法华寺	fa'hua'si	0
法华文句	fa'hua'wen'ju	0
法华文句记	fa'hua'wen'ju'ji	0
法华秀句	fa'hua'xiu'ju	0
法华玄义	fa'hua'xuan'yi	0
法华玄义释签	fa'hua'xuan'yi'shi'qian	0
法华一揆	fa'hua'yi'kui	0
法华传记	fa'hua'zhuan'ji	0
法会	fa'hui	0
法集论	fa'ji'lun	0
法界	fa'jie	0
法界安立图	fa'jie'an'li'tu	0
法界次第初门	fa'jie'ci'di'chu'men	0
法界定印	fa'jie'ding'yin	0
法界观	fa'jie'guan	0
法界观门	fa'jie'guan'men	0
法界缘起	fa'jie'yuan'qi	0
法经	fa'jing	0
法具	fa'ju	0
法句经	fa'ju'jing	0
法腊	fa'la	0
伐腊毗国	fa'la'pi'guo	0
法朗	fa'lang	0
法砺	fa'li	0
法琳	fa'lin	0
法隆寺	fa'long'si	0
法轮	fa'lun	0
法螺	fa'luo	0
法门	fa'men	0
法门名义集	fa'men'ming'yi'ji	0
法门寺	fa'men'si	0
法名	fa'ming	0
发菩提心	fa'pu'ti'xin	0
法器	fa'qi	0
发趣论	fa'qu'lun	0
法全	fa'quan	0
法融	fa'rong	0
法如	fa'ru	0
法上	fa'shang	0
法上部	fa'shang'bu	0
法身	fa'shen	0
法身基金会	fa'shen'ji'jin'hui	0
法胜	fa'sheng	0
法盛	fa'sheng	0
发誓	fa'shi	0
法事赞	fa'shi'zan	0
法数	fa'shu	0
法顺	fa'shun	0
法泰	fa'tai	0
法堂	fa'tang	0
法体	fa'ti	0
法体恒有	fa'ti'heng'you	0
法天	fa'tian	0
法王	fa'wang	0
法王寺	fa'wang'si	0
法王舞	fa'wang'wu	0
法喜志	fa'xi'zhi	0
法显	fa'xian	0
法献	fa'xian	0
法相	fa'xiang	0
法相辞典	fa'xiang'ci'dian	0
法相宗	fa'xiang'zong	0
法性	fa'xing	0
法性生身	fa'xing'sheng'shen	0
法性土	fa'xing'tu	0
法性宗	fa'xing'zong	0
法演	fa'yan	0
法眼净	fa'yan'jing	0
法眼文益	fa'yan'wen'yi	0
法眼宗	fa'yan'zong	0
法要	fa'yao	0
法业	fa'ye	0
法衣	fa'yi	0
法勇	fa'yong	0
法语	fa'yu	0
法远	fa'yuan	0
法源寺	fa'yuan'si	0
法苑珠林	fa'yuan'zhu'lin	0
法月	fa'yue	0
法云	fa'yun	0
法云禅寺	fa'yun'chan'si	0
法云寺	fa'yun'si	0
法蕴足论	fa'yun'zu'lun	0
法照	fa'zhao	0
法真	fa'zhen	0
法执	fa'zhi	0
法智	fa'zhi	0
发智论	fa'zhi'lun	0
法住记	fa'zhu'ji	0
法住寺	fa'zhu'si	0
法住学会	fa'zhu'xue'hui	0
法住智	fa'zhu'zhi	0
法自相相违因	fa'zi'xiang'xiang'wei'yin	0
法尊	fa'zun	0
法座	fa'zuo	0
幡	fan	0
梵	fan	0
梵呗	fan'bai	0
梵唱大悲咒	fan'chang'da'bei'zhou	0
凡夫	fan'fu	0
凡夫与老师	fan'fu'yu'lao'shi	0
梵经	fan'jing	0
烦恼	fan'nao	0
烦恼即菩提	fan'nao'ji'pu'ti	0
烦恼障	fan'nao'zhang	0
饭钱	fan'qian	0
凡圣两忘	fan'sheng'liang'wang	0
梵书	fan'shu	0
繁塔	fan'ta	0
梵天	fan'tian	0
梵网会	fan'wang'hui	0
梵网经	fan'wang'jing	0
梵文孔雀明王圣号	fan'wen'kong'que'ming'wang'sheng'hao	0
梵行	fan'xing	0
梵学津梁	fan'xue'jin'liang	0
梵衍那国	fan'yan'na'guo	0
翻译名义大集	fan'yi'ming'yi'da'ji	0
翻译名义集	fan'yi'ming'yi'ji	0
梵语	fan'yu	0
梵语千字文	fan'yu'qian'zi'wen	0
梵鱼寺	fan'yu'si	0
梵语杂名	fan'yu'za'ming	0
反主为宾	fan'zhu'wei'bin	0
梵字	fan'zi	0
梵宗寺	fan'zong'si	0
方便	fang'bian	0
方便示教	fang'bian'shi'jiao	0
方便心论	fang'bian'xin'lun	0
芳村修基	fang'cun'xiu'ji	0
方等部	fang'deng'bu	0
方等三昧行法	fang'deng'san'mei'xing'fa	0
方东美	fang'dong'mei	0
放光般若经	fang'guang'bo're'jing	0
方广大庄严经	fang'guang'da'zhuang'yan'jing	0
方广寺	fang'guang'si	0
方汉岩	fang'han'yan	0
方会	fang'hui	0
方净	fang'jing	0
方伦	fang'lun	0
放蒙山	fang'meng'shan	0
放弃很难	fang'qi'hen'nan	0
房山石经	fang'shan'shi'jing	0
放生歌	fang'sheng'ge	0
放生会	fang'sheng'hui	0
放水灯	fang'shui'deng	0
方外	fang'wai	0
方外之交	fang'wai'zhi'jiao	0
放下	fang'xia	0
放下什么	fang'xia'shen'me	0
放行	fang'xing	0
放逸	fang'yi	0
方以智	fang'yi'zhi	0
方丈	fang'zhang	0
放逐天堂	fang'zhu'tian'tang	0
废佛毁释	fei'fo'hui'shi	0
飞来峰济公	fei'lai'feng'ji'gong	0
飞来佛	fei'lai'fo	0
飞来寺	fei'lai'si	0
飞鸟大佛	fei'niao'da'fo	0
非人	fei'ren	0
吠舍佉	fei'she'qu	0
非时食	fei'shi'shi	0
吠檀多精髓	fei'tan'duo'jing'sui	0
飞天	fei'tian	0
吠陀	fei'tuo	0
吠陀圣义纲要	fei'tuo'sheng'yi'gang'yao	0
吠陀时代	fei'tuo'shi'dai	0
飞锡	fei'xi	0
非想非非想处	fei'xiang'fei'fei'xiang'chu	0
非有想非无想	fei'you'xiang'fei'wu'xiang	0
飞越地平线	fei'yue'di'ping'xian	0
飞越生死	fei'yue'sheng'si	0
废纸一堆	fei'zhi'yi'dui	0
非浊	fei'zhuo	0
分别	fen'bie	0
分别变	fen'bie'bian	0
分别功德论	fen'bie'gong'de'lun	0
分别论	fen'bie'lun	0
分别起	fen'bie'qi	0
分别说部	fen'bie'shuo'bu	0
分段生死	fen'duan'sheng'si	0
粉河寺	fen'he'si	0
芬皇寺	fen'huang'si	0
粪扫衣	fen'sao'yi	0
分身	fen'shen	0
分陀利迦	fen'tuo'li'jia	0
分卫	fen'wei	0
汾阳无德禅师语录	fen'yang'wu'de'chan'shi'yu'lu	0
风的故事	feng'de'gu'shi	0
风动幡动心动	feng'dong'fan'dong'xin'dong	0
奉恩寺	feng'en'si	0
奉法要	feng'fa'yao	0
丰干	feng'gan	0
奉国寺	feng'guo'si	0
凤林山派	feng'lin'shan'pai	0
凤山佛教莲社	feng'shan'fo'jiao'lian'she	0
封神榜	feng'shen'bang	0
讽诵	feng'song	0
风天	feng'tian	0
凤停寺	feng'ting'si	0
奉先寺	feng'xian'si	0
风雪禅音	feng'xue'chan'yin	0
风穴寺	feng'xue'si	0
风中迷雾	feng'zhong'mi'wu	0
佛	fo	0
佛般泥洹经	fo'ban'ni'huan'jing	0
佛本行集经	fo'ben'hang'ji'jing	0
佛钵	fo'bo	0
佛部	fo'bu	0
佛藏经	fo'cang'jing	0
佛禅的故事	fo'chan'de'gu'shi	0
佛成道日	fo'cheng'dao'ri	0
佛传图	fo'chuan'tu	0
佛垂般涅槃略说教诫经	fo'chui'ban'nie'pan'lve'shuo'jiao'jie'jing	0
佛大先	fo'da'xian	0
佛诞	fo'dan	0
佛地经	fo'di'jing	0
佛地经论	fo'di'jing'lun	0
佛殿	fo'dian	0
佛典物语	fo'dian'wu'yu	0
佛典音义	fo'dian'yin'yi	0
佛顶	fo'ding	0
佛顶尊胜陀罗尼	fo'ding'zun'sheng'tuo'luo'ni	0
佛顶尊胜陀罗尼经	fo'ding'zun'sheng'tuo'luo'ni'jing	0
佛尔寺	fo'er'si	0
佛法金汤	fo'fa'jin'tang	0
佛法金汤编	fo'fa'jin'tang'bian	0
佛法无多子	fo'fa'wu'duo'zi	0
佛法无二般	fo'fa'wu'er'ban	0
佛骨	fo'gu	0
佛光禅寺	fo'guang'chan'si	0
佛光山寺	fo'guang'shan'si	0
佛光寺	fo'guang'si	0
佛光永远照着你	fo'guang'yong'yuan'zhao'zhe'ni	0
佛国寺	fo'guo'si	0
佛护	fo'hu	0
佛华严入如来德智不思议境界经	fo'hua'yan'ru'ru'lai'de'zhi'bu'si'yi'jing'jie'jing	0
佛教	fo'jiao	0
佛教碑帖	fo'jiao'bei'tie	0
佛教传道协会	fo'jiao'chuan'dao'xie'hui	0
佛教大系	fo'jiao'da'xi	0
佛教大学	fo'jiao'da'xue	0
佛教电视剧	fo'jiao'dian'shi'ju	0
佛教电影	fo'jiao'dian'ying	0
佛教歌曲	fo'jiao'ge'qu	0
佛教混合梵语	fo'jiao'hun'he'fan'yu	0
佛教活论	fo'jiao'huo'lun	0
佛教纪录片	fo'jiao'ji'lu'pian	0
佛教美术	fo'jiao'mei'shu	0
佛教密咒真言佛曲	fo'jiao'mi'zhou'zhen'yan'fo'qu	0
佛教旗	fo'jiao'qi	0
佛教诠释学	fo'jiao'quan'shi'xue	0
佛教天文历	fo'jiao'tian'wen'li	0
佛教统一论	fo'jiao'tong'yi'lun	0
佛教文库	fo'jiao'wen'ku	0
佛教文献学	fo'jiao'wen'xian'xue	0
佛教文学	fo'jiao'wen'xue	0
佛教戏剧	fo'jiao'xi'ju	0
佛教星期日学校	fo'jiao'xing'qi'ri'xue'xiao	0
佛教学	fo'jiao'xue	0
佛教音乐	fo'jiao'yin'yue	0
佛教影视作品	fo'jiao'ying'shi'zuo'pin	0
佛教赞偈祈请	fo'jiao'zan'ji'qi'qing	0
佛今在何处	fo'jin'zai'he'chu	0
佛库	fo'ku	0
佛名会	fo'ming'hui	0
佛名经	fo'ming'jing	0
佛母大孔雀明王经	fo'mu'da'kong'que'ming'wang'jing	0
佛母准提神咒	fo'mu'zhun'ti'shen'zhou	0
佛涅槃日	fo'nie'pan'ri	0
佛前忏悔偈	fo'qian'chan'hui'ji	0
佛前一支莲	fo'qian'yi'zhi'lian	0
佛身	fo'shen	0
佛事	fo'shi	0
佛使	fo'shi	0
佛授	fo'shou	0
佛授记寺	fo'shou'ji'si	0
佛书编目	fo'shu'bian'mu	0
佛所行赞	fo'suo'hang'zan	0
佛坛	fo'tan	0
佛通寺	fo'tong'si	0
佛通寺派	fo'tong'si'pai	0
佛土	fo'tu	0
佛图澄	fo'tu'cheng	0
佛图户	fo'tu'hu	0
佛驮跋陀罗	fo'tuo'ba'tuo'luo	0
佛陀波利	fo'tuo'bo'li	0
佛陀禅师	fo'tuo'chan'shi	0
佛陀传	fo'tuo'chuan	0
佛陀的爱	fo'tuo'de'ai	0
佛陀的故事	fo'tuo'de'gu'shi	0
佛陀的一生	fo'tuo'de'yi'sheng	0
佛陀扇多	fo'tuo'shan'duo	0
佛陀耶舍	fo'tuo'ye'she	0
佛像	fo'xiang	0
佛榭	fo'xie	0
佛心经	fo'xin'jing	0
佛性	fo'xing	0
佛性论	fo'xing'lun	0
佛学院	fo'xue'yuan	0
佛牙节	fo'ya'jie	0
佛牙寺	fo'ya'si	0
佛眼佛母	fo'yan'fo'mu	0
佛岩念佛堂	fo'yan'nian'fo'tang	0
佛印	fo'yin	0
佛印禅师	fo'yin'chan'shi	0
佛影窟	fo'ying'ku	0
佛缘	fo'yuan	0
佛哲	fo'zhe	0
佛智	fo'zhi	0
佛制比丘六物图	fo'zhi'bi'qiu'liu'wu'tu	0
佛之颂	fo'zhi'song	0
佛种	fo'zhong	0
佛种姓种	fo'zhong'xing'zhong	0
佛祖历代通载	fo'zu'li'dai'tong'zai	0
佛祖论美	fo'zu'lun'mei	0
佛足石	fo'zu'shi	0
佛祖统纪	fo'zu'tong'ji	0
佛祖正宗道影	fo'zu'zheng'zong'dao'ying	0
缚	fu	0
服部正明	fu'bu'zheng'ming	0
伏藏	fu'cang	0
拂尘说法	fu'chen'shuo'fa	0
复仇	fu'chou	0
缚刍河	fu'chu'he	0
服从	fu'cong	0
伏道	fu'dao	0
付法	fu'fa	0
付法藏因缘传	fu'fa'cang'yin'yuan'chuan	0
伏鬼妙方	fu'gui'miao'fang	0
伏鬼妙诀	fu'gui'miao'jue	0
福海讲寺	fu'hai'jiang'si	0
缚喝国	fu'he'guo	0
福慧	fu'hui	0
福慧寺	fu'hui'si	0
福济寺	fu'ji'si	0
辅教编	fu'jiao'bian	0
福井康顺	fu'jing'kang'shun	0
福井文雅	fu'jing'wen'ya	0
福聚	fu'ju	0
弗劳瓦尔纳	fu'lao'wa'er'na	0
扶律谈常	fu'lv'tan'chang	0
伏魔禅寺	fu'mo'chan'si	0
扶南国	fu'nan'guo	0
赴请法	fu'qing'fa	0
弗若多罗	fu'ruo'duo'luo	0
扶桑禅林僧宝传	fu'sang'chan'lin'seng'bao'chuan	0
弗沙蜜多罗王	fu'sha'mi'duo'luo'wang	0
浮生梦中	fu'sheng'meng'zhong	0
福生天	fu'sheng'tian	0
浮石寺	fu'shi'si	0
福田	fu'tian	0
浮图	fu'tu	0
傅伟勋	fu'wei'xun	0
扶习润生	fu'xi'run'sheng	0
福严精舍	fu'yan'jing'she	0
福严寺	fu'yan'si	0
扶余	fu'yu	0
福原亮严	fu'yuan'liang'yan	0
福州版大藏经	fu'zhou'ban'da'cang'jing	0
付嘱	fu'zhu	0
拂子	fu'zi	0
噶当宝册	ga'dang'bao'ce	0
噶当派	ga'dang'pai	0
噶举派	ga'ju'pai	0
噶玛噶举派	ga'ma'ga'ju'pai	0
噶玛师利那烂陀佛学院	ga'ma'shi'li'na'lan'tuo'fo'xue'yuan	0
伽那	ga'na	0
伽陀	ga'tuo	0
噶厦	ga'xia	0
伽耶城	ga'ye'cheng	0
伽耶山	ga'ye'shan	0
盖	gai	0
改邪钞	gai'xie'chao	0
甘丹赤巴	gan'dan'chi'ba	0
甘丹寺	gan'dan'si	0
甘地	gan'di	0
干第罗洛颜格朗	gan'di'luo'luo'yan'ge'lang	0
干第文荼	gan'di'wen'tu	0
感恩	gan'en	0
感恩的心	gan'en'de'xin	0
感恩父母	gan'en'fu'mu	0
干凤寺	gan'feng'si	0
甘露	gan'lu	0
甘露饭王	gan'lu'fan'wang	0
甘露歌	gan'lu'ge	0
甘露谱	gan'lu'pu	0
甘露寺	gan'lu'si	0
甘露陀罗尼	gan'lu'tuo'luo'ni	0
甘露味论	gan'lu'wei'lun	0
甘尼沙	gan'ni'sha	0
干闼婆	gan'ta'po	0
感通寺	gan'tong'si	0
干陀罗色	gan'tuo'luo'se	0
干潟龙祥	gan'xi'long'xiang	0
冈波巴	gang'bo'ba	0
刚般若波罗蜜经论	gang'bo're'bo'luo'mi'jing'lun	0
冈野正道	gang'ye'zheng'dao	0
高本钊	gao'ben'zhao	0
高昌国	gao'chang'guo	0
高丽藏	gao'li'cang	0
高丽国	gao'li'guo	0
高棉佛教	gao'mian'fo'jiao	0
高明道	gao'ming'dao	0
高明寺	gao'ming'si	0
高僧传	gao'seng'chuan	0
高僧法显传	gao'seng'fa'xian'chuan	0
高僧摘要	gao'seng'zhai'yao	0
高王观音经	gao'wang'guan'yin'jing	0
高雄佛教堂	gao'xiong'fo'jiao'tang	0
高野山	gao'ye'shan	0
高野山大学	gao'ye'shan'da'xue	0
高与远	gao'yu'yuan	0
割耳救雉	ge'er'jiu'zhi	0
格鲁派	ge'lu'pai	0
个人承担	ge'ren'cheng'dan	0
格萨尔王传	ge'sa'er'wang'chuan	0
葛藤语笺	ge'teng'yu'jian	0
格西	ge'xi	0
格义	ge'yi	0
根	gen	0
根本定	gen'ben'ding	0
根本烦恼	gen'ben'fan'nao	0
根本佛教	gen'ben'fo'jiao	0
根本识	gen'ben'shi	0
根本说一切有部毗奈耶	gen'ben'shuo'yi'qie'you'bu'pi'nai'ye	0
根本智	gen'ben'zhi	0
根边蕴	gen'bian'yun	0
根来寺	gen'lai'si	0
根源会	gen'yuan'hui	0
弓	gong	0
公案	gong'an	0
共般若	gong'bo're	0
弓长岭佛教协会	gong'chang'ling'fo'jiao'xie'hui	0
功德	gong'de	0
功德坟寺	gong'de'fen'si	0
功德使	gong'de'shi	0
功德直	gong'de'zhi	0
功过格	gong'guo'ge	0
公鸡与虫儿	gong'ji'yu'chong'er	0
共教	gong'jiao	0
供具	gong'ju	0
公开地爱	gong'kai'de'ai	0
供曼达	gong'man'da	0
功能	gong'neng	0
工巧明	gong'qiao'ming	0
供物	gong'wu	0
巩县石窟	gong'xian'shi'ku	0
共相	gong'xiang	0
共相惑	gong'xiang'huo	0
公巖	gong'yan	0
供养	gong'yang	0
共业	gong'ye	0
弓裔	gong'yi	0
共种子	gong'zhong'zi	0
钩召法	gou'zhao'fa	0
狗子佛性	gou'zi'fo'xing	0
顾法严	gu'fa'yan	0
古格王朝	gu'ge'wang'chao	0
古涧寒泉	gu'jian'han'quan	0
古今禅藻集	gu'jin'chan'zao'ji	0
古今译经图纪	gu'jin'yi'jing'tu'ji	0
古镜未磨	gu'jing'wei'mo	0
古崑	gu'kun	0
咕噜咕列佛母心咒	gu'lu'gu'lie'fo'mu'xin'zhou	0
古清凉传	gu'qing'liang'chuan	0
鼓山	gu'shan	0
鼓山寺	gu'shan'si	0
鼓山系	gu'shan'xi	0
骨锁观	gu'suo'guan	0
古先派	gu'xian'pai	0
古义真言宗	gu'yi'zhen'yan'zong	0
古音王传	gu'yin'wang'chuan	0
古月	gu'yue	0
古正美	gu'zheng'mei	0
古尊宿语录	gu'zun'su'yu'lu	0
挂撘	gua'da	0
管长	guan'chang	0
灌顶	guan'ding	0
灌顶经	guan'ding'jing	0
灌顶咒梵唱	guan'ding'zhou'fan'chang	0
观法	guan'fa	0
观佛	guan'fo	0
观佛三昧海经	guan'fo'san'mei'hai'jing	0
关怀生命协会	guan'huai'sheng'ming'xie'hui	0
关口真大	guan'kou'zhen'da	0
观普贤菩萨行法经	guan'pu'xian'pu'sa'xing'fa'jing	0
关圣寺	guan'sheng'si	0
关世谦	guan'shi'qian	0
观世音传奇	guan'shi'yin'chuan'qi	0
观世音菩萨	guan'shi'yin'pu'sa	0
观世音菩萨发愿偈	guan'shi'yin'pu'sa'fa'yuan'ji	0
观世音菩萨普门品	guan'shi'yin'pu'sa'pu'men'pin	0
观世音菩萨授记经	guan'shi'yin'pu'sa'shou'ji'jing	0
观世音显灵传奇	guan'shi'yin'xian'ling'chuan'qi	0
贯首	guan'shou	0
官寺	guan'si	0
观所缘缘论	guan'suo'yuan'yuan'lun	0
观无量寿经	guan'wu'liang'shou'jing	0
观心本尊钞	guan'xin'ben'zun'chao	0
观心觉梦钞	guan'xin'jue'meng'chao	0
观心论	guan'xin'lun	0
观音忏法	guan'yin'chan'fa	0
观音禅寺	guan'yin'chan'si	0
观音大士赞	guan'yin'da'shi'zan	0
观音偈	guan'yin'ji	0
观音老母	guan'yin'lao'mu	0
观音灵感歌	guan'yin'ling'gan'ge	0
观音菩萨悲赞	guan'yin'pu'sa'bei'zan	0
观音菩萨偈	guan'yin'pu'sa'ji	0
观音菩萨灭业障真言	guan'yin'pu'sa'mie'ye'zhang'zhen'yan	0
观音菩萨如秋月	guan'yin'pu'sa'ru'qiu'yue	0
观音菩萨圣号	guan'yin'pu'sa'sheng'hao	0
观音菩萨赞	guan'yin'pu'sa'zan	0
观音菩萨治病真言	guan'yin'pu'sa'zhi'bing'zhen'yan	0
观音踏浪来	guan'yin'ta'lang'lai	0
观音岩	guan'yin'yan	0
观音在之杨枝净水赞	guan'yin'zai'zhi'yang'zhi'jing'shui'zan	0
灌云县大伊山石佛寺	guan'yun'xian'da'yi'shan'shi'fo'si	0
灌云县伊芦钟安寺	guan'yun'xian'yi'lu'zhong'an'si	0
关中创立戒坛图经	guan'zhong'chuang'li'jie'tan'tu'jing	0
管主八	guan'zhu'ba	0
观宗讲寺	guan'zong'jiang'si	0
广长舌相	guang'chang'she'xiang	0
广大行	guang'da'xing	0
光德寺	guang'de'si	0
广定	guang'ding	0
广福禅寺	guang'fu'chan'si	0
广福寺	guang'fu'si	0
广果天	guang'guo'tian	0
广弘明集	guang'hong'ming'ji	0
广化寺	guang'hua'si	0
广济寺	guang'ji'si	0
广隆寺	guang'long'si	0
光明	guang'ming	0
光明寺	guang'ming'si	0
光明真言	guang'ming'zhen'yan	0
光目救母	guang'mu'jiu'mu	0
广目天	guang'mu'tian	0
光谦	guang'qian	0
广钦	guang'qin	0
广仁寺	guang'ren'si	0
广胜寺	guang'sheng'si	0
广西河池市凤凰寺	guang'xi'he'chi'shi'feng'huang'si	0
光香禅寺	guang'xiang'chan'si	0
光孝寺	guang'xiao'si	0
广心	guang'xin	0
光音天	guang'yin'tian	0
广佑寺	guang'you'si	0
广元	guang'yuan	0
广元千佛崖	guang'yuan'qian'fo'ya	0
广泽流	guang'ze'liu	0
光宅寺	guang'zhai'si	0
归化寺	gui'hua'si	0
桂花雨	gui'hua'yu	0
归敬序	gui'jing'xu	0
桂林磨崖佛群	gui'lin'mo'ya'fo'qun	0
龟毛兔角	gui'mao'tu'jiao	0
归谬论证派	gui'miu'lun'zheng'pai	0
归鸟迷巢	gui'niao'mi'chao	0
龟山福清寺	gui'shan'fu'qing'si	0
贵霜王朝	gui'shuang'wang'chao	0
归依	gui'yi	0
皈依本师释迦牟尼佛	gui'yi'ben'shi'shi'jia'mou'ni'fo	0
皈依及发菩提心愿文	gui'yi'ji'fa'pu'ti'xin'yuan'wen	0
归依三宝赞	gui'yi'san'bao'zan	0
归元镜	gui'yuan'jing	0
归元寺	gui'yuan'si	0
鬼子母神	gui'zi'mu'shen	0
果	guo	0
果报	guo'bao	0
果成寺	guo'cheng'si	0
果分	guo'fen	0
国分寺	guo'fen'si	0
国际佛教研究协会	guo'ji'fo'jiao'yan'jiu'xie'hui	0
国家战士	guo'jia'zhan'shi	0
果能变	guo'neng'bian	0
国清百录	guo'qing'bai'lu	0
国清寺	guo'qing'si	0
过去现在因果经	guo'qu'xian'zai'yin'guo'jing	0
国色之腊梅	guo'se'zhi'la'mei	0
国师	guo'shi	0
国师是宝	guo'shi'shi'bao	0
过堂	guo'tang	0
果头无人	guo'tou'wu'ren	0
过午不食	guo'wu'bu'shi	0
国相寺	guo'xiang'si	0
国译一切经	guo'yi'yi'qie'jing	0
郭忠生	guo'zhong'sheng	0
哈达	ha'da	0
哈德瓦	ha'de'wa	0
哈尔滨市普照寺	ha'er'bin'shi'pu'zhao'si	0
哈尔滨市卧龙寺	ha'er'bin'shi'wo'long'si	0
蛤蟆还是老茄子	ha'ma'hai'shi'lao'qie'zi	0
海宝塔	hai'bao'ta	0
海潮音	hai'chao'yin	0
海潮院念佛堂	hai'chao'yuan'nian'fo'tang	0
海东高僧传	hai'dong'gao'seng'chuan	0
海会寺	hai'hui'si	0
海宁寺	hai'ning'si	0
海山寺	hai'shan'si	0
海印禅寺	hai'yin'chan'si	0
海印三昧	hai'yin'san'mei	0
海印寺	hai'yin'si	0
邯郸爆台寺	han'dan'bao'tai'si	0
邯郸定国寺	han'dan'ding'guo'si	0
邯郸佛学苑念佛堂	han'dan'fo'xue'yuan'nian'fo'tang	0
邯郸涉县熊耳山开法寺	han'dan'she'xian'xiong'er'shan'kai'fa'si	0
邯郸市磁县索井圣佛寺	han'dan'shi'ci'xian'suo'jing'sheng'fo'si	0
邯郸市大乘玉佛寺	han'dan'shi'da'cheng'yu'fo'si	0
邯郸市榕桦寺	han'dan'shi'rong'hua'si	0
邯郸市月爱寺	han'dan'shi'yue'ai'si	0
邯郸武安佛教协会报恩讲堂	han'dan'wu'an'fo'jiao'xie'hui'bao'en'jiang'tang	0
邯郸永年安仁寺	han'dan'yong'nian'an'ren'si	0
邯郸永年大定寺	han'dan'yong'nian'da'ding'si	0
汗栗驮	han'li'tuo	0
寒林	han'lin	0
韩龙云	han'long'yun	0
韩清净	han'qing'jing	0
憨山大师梦游全集	han'shan'da'shi'meng'you'quan'ji	0
憨山大师醒世歌	han'shan'da'shi'xing'shi'ge	0
寒山僧踪	han'shan'seng'zong	0
寒山寺	han'shan'si	0
汉魏两晋南北朝佛教史	han'wei'liang'jin'nan'bei'chao'fo'jiao'shi	0
寒修行	han'xiu'xing	0
韩愈	han'yu	0
杭州	hang'zhou	0
浩浩洞	hao'hao'dong	0
好花不择处	hao'hua'bu'ze'chu	0
好坚树	hao'jian'shu	0
好事不如无	hao'shi'bu'ru'wu	0
好事不如无事	hao'shi'bu'ru'wu'shi	0
河北省磁州凤凰寺	he'bei'sheng'ci'zhou'feng'huang'si	0
河北省三河市灵山寺	he'bei'sheng'san'he'shi'ling'shan'si	0
河北省无极县法云禅寺	he'bei'sheng'wu'ji'xian'fa'yun'chan'si	0
河北省辛集市清利寺	he'bei'sheng'xin'ji'shi'qing'li'si	0
何法示人	he'fa'shi'ren	0
赫吉森	he'ji'sen	0
河口慧海	he'kou'hui'hai	0
贺兰山北武当寿佛寺	he'lan'shan'bei'wu'dang'shou'fo'si	0
赫鲁葛	he'lu'ge	0
和南	he'nan	0
和平钟声	he'ping'zhong'sheng	0
鹤山仙踪禅寺	he'shan'xian'zong'chan'si	0
和尚	he'shang	0
和尚与禅师	he'shang'yu'chan'shi	0
和尚与大师	he'shang'yu'da'shi	0
何物永远不变	he'wu'yong'yuan'bu'bian	0
河西石窟	he'xi'shi'ku	0
鹤岩寺	he'yan'si	0
和赞	he'zan	0
荷泽神会	he'ze'shen'hui	0
荷泽宗	he'ze'zong	0
合掌	he'zhang	0
合作法	he'zuo'fa	0
黑财神咒	hei'cai'shen'zhou	0
黑龙江省安达市宝安寺	hei'long'jiang'sheng'an'da'shi'bao'an'si	0
黑龙江省大庆市净觉寺	hei'long'jiang'sheng'da'qing'shi'jing'jue'si	0
黑绳地狱	hei'sheng'di'yu	0
黑业	hei'ye	0
黑月	hei'yue	0
横超慧日	heng'chao'hui'ri	0
恒河	heng'he	0
恒清	heng'qing	0
衡山	heng'shan	0
吽	hong	0
红财神心咒	hong'cai'shen'xin'zhou	0
弘储	hong'chu	0
宏船	hong'chuan	0
弘慈寺	hong'ci'si	0
宏法寺	hong'fa'si	0
弘福寺	hong'fu'si	0
洪福寺	hong'fu'si	0
洪镜	hong'jing	0
红莲	hong'lian	0
红螺寺	hong'luo'si	0
弘明集	hong'ming'ji	0
宏明寺	hong'ming'si	0
洪启嵩	hong'qi'song	0
弘忍	hong'ren	0
洪如	hong'ru	0
弘誓	hong'shi	0
红史	hong'shi	0
弘一	hong'yi	0
宏印	hong'yin	0
弘赞	hong'zan	0
弘赞法华传	hong'zan'fa'hua'chuan	0
宏智正觉禅师广录	hong'zhi'zheng'jue'chan'shi'guang'lu	0
洪州宗	hong'zhou'zong	0
吽字义	hong'zi'yi	0
洪遵	hong'zun	0
后有	hou'you	0
护法	hu'fa	0
护法论	hu'fa'lun	0
互跪	hu'gui	0
护国灵岩寺	hu'guo'ling'yan'si	0
护国寺	hu'guo'si	0
忽滑谷快天	hu'hua'gu'kuai'tian	0
胡梅子	hu'mei'zi	0
护命放生轨仪法	hu'ming'fang'sheng'gui'yi'fa	0
护摩	hu'mo	0
护念	hu'nian	0
虎丘派	hu'qiu'pai	0
虎丘山	hu'qiu'shan	0
护身法	hu'shen'fa	0
胡适	hu'shi	0
虎头长角	hu'tou'zhang'jiao	0
呼图克图	hu'tu'ke'tu	0
胡秀卿	hu'xiu'qing	0
互用罪	hu'yong'zui	0
胡语	hu'yu	0
护贼度贼	hu'zei'du'zei	0
华	hua	0
画饼充饥	hua'bing'chong'ji	0
华藏寺	hua'cang'si	0
化城寺	hua'cheng'si	0
化城喻	hua'cheng'yu	0
化地部	hua'di'bu	0
化度寺	hua'du'si	0
化法四教	hua'fa'si'jiao	0
华梵人文科技学院	hua'fan'ren'wen'ke'ji'xue'yuan	0
化佛	hua'fo	0
化乐天	hua'le'tian	0
华林寺	hua'lin'si	0
华鬘	hua'man	0
话梦人生	hua'meng'ren'sheng	0
化人	hua'ren	0
化人说法	hua'ren'shuo'fa	0
花山信胜	hua'shan'xin'sheng	0
化身	hua'shen	0
华氏城	hua'shi'cheng	0
华手经	hua'shou'jing	0
华亭寺	hua'ting'si	0
化土	hua'tu	0
华严变相	hua'yan'bian'xiang	0
华严金师子章	hua'yan'jin'shi'zi'zhang	0
华严经合论	hua'yan'jing'he'lun	0
华严经疏钞	hua'yan'jing'shu'chao	0
华严经疏论纂要	hua'yan'jing'shu'lun'zuan'yao	0
华严经搜玄记	hua'yan'jing'sou'xuan'ji	0
华严经探玄记	hua'yan'jing'tan'xuan'ji	0
华严经问答	hua'yan'jing'wen'da	0
华严经旨归	hua'yan'jing'zhi'gui	0
华严经传记	hua'yan'jing'zhuan'ji	0
华严孔目章	hua'yan'kong'mu'zhang	0
华严莲社	hua'yan'lian'she	0
华严三昧	hua'yan'san'mei	0
华严寺	hua'yan'si	0
华严五教章	hua'yan'wu'jiao'zhang	0
华严五教止观	hua'yan'wu'jiao'zhi'guan	0
华严五十要问答	hua'yan'wu'shi'yao'wen'da	0
华严玄谈	hua'yan'xuan'tan	0
华严一乘十玄门	hua'yan'yi'cheng'shi'xuan'men	0
华严游心法界记	hua'yan'you'xin'fa'jie'ji	0
华严游意	hua'yan'you'yi	0
华严圆融念佛	hua'yan'yuan'rong'nian'fo	0
华严宗	hua'yan'zong	0
化仪四教	hua'yi'si'jiao	0
华雨精舍	hua'yu'jing'she	0
化缘	hua'yuan	0
花园大学	hua'yuan'da'xue	0
化缘度众	hua'yuan'du'zhong	0
化制二教	hua'zhi'er'jiao	0
化主	hua'zhu	0
坏法	huai'fa	0
怀感	huai'gan	0
怀海	huai'hai	0
坏劫	huai'jie	0
怀琏	huai'lian	0
怀念法王如意宝	huai'nian'fa'wang'ru'yi'bao	0
怀让	huai'rang	0
怀柔佛母咒	huai'rou'fo'mu'zhou	0
坏色	huai'se	0
怀素	huai'su	0
怀问	huai'wen	0
怀信	huai'xin	0
怀恽	huai'yun	0
幻	huan	0
幻观成就法	huan'guan'cheng'jiu'fa	0
幻生	huan'sheng	0
还俗	huan'su	0
欢喜	huan'xi	0
欢喜大悲咒	huan'xi'da'bei'zhou	0
欢喜天法	huan'xi'tian'fa	0
欢喜丸	huan'xi'wan	0
幻有	huan'you	0
寰中	huan'zhong	0
幻住派	huan'zhu'pai	0
黄檗清规	huang'bo'qing'gui	0
黄檗山	huang'bo'shan	0
黄檗山断际禅师传心法要	huang'bo'shan'duan'ji'chan'shi'chuan'xin'fa'yao	0
黄檗无念禅师语录	huang'bo'wu'nian'chan'shi'yu'lu	0
黄檗宗	huang'bo'zong	0
黄财神大佛寺	huang'cai'shen'da'fo'si	0
黄财神咒	huang'cai'shen'zhou	0
皇祇寺田州古塔	huang'chi'si'tian'zhou'gu'ta	0
黄公伟	huang'gong'wei	0
黄俊威	huang'jun'wei	0
黄龙慧南禅师语录	huang'long'hui'nan'chan'shi'yu'lu	0
黄龙派	huang'long'pai	0
皇龙寺	huang'long'si	0
黄敏枝	huang'min'zhi	0
黄寺	huang'si	0
黄英杰	huang'ying'jie	0
皇泽寺	huang'ze'si	0
慧	hui	0
慧安	hui'an	0
慧布	hui'bu	0
慧才	hui'cai	0
会昌法难	hui'chang'fa'nan	0
慧超	hui'chao	0
慧超往五天竺国传	hui'chao'wang'wu'tian'zhu'guo'chuan	0
慧彻	hui'che	0
慧谌	hui'chen	0
慧灯普照	hui'deng'pu'zhao	0
慧方	hui'fang	0
慧峰	hui'feng	0
回峰行	hui'feng'xing	0
会供	hui'gong	0
慧观	hui'guan	0
慧光	hui'guang	0
慧海	hui'hai	0
慧鹤	hui'he	0
慧基	hui'ji	0
慧寂	hui'ji	0
慧皎	hui'jiao	0
慧经	hui'jing	0
慧炬	hui'ju	0
慧可	hui'ke	0
慧可安心	hui'ke'an'xin	0
慧立	hui'li	0
慧琳	hui'lin	0
慧琳音义	hui'lin'yin'yi	0
会龙禅寺	hui'long'chan'si	0
慧律	hui'lv	0
惠敏	hui'min	0
慧明	hui'ming	0
慧明寺	hui'ming'si	0
慧南	hui'nan	0
慧能	hui'neng	0
慧年	hui'nian	0
慧勤	hui'qin	0
会泉	hui'quan	0
慧泉禅寺	hui'quan'chan'si	0
慧日	hui'ri	0
慧日讲堂	hui'ri'jiang'tang	0
慧三	hui'san	0
会三归一	hui'san'gui'yi	0
灰身灭智	hui'shen'mie'zhi	0
慧生	hui'sheng	0
慧思	hui'si	0
灰炭塔	hui'tan'ta	0
回头是岸	hui'tou'shi'an	0
秽土	hui'tu	0
慧威	hui'wei	0
慧文	hui'wen	0
回向	hui'xiang	0
回向偈	hui'xiang'ji	0
回心向大	hui'xin'xiang'da	0
会性	hui'xing	0
慧严	hui'yan	0
慧因寺	hui'yin'si	0
慧永	hui'yong	0
慧苑	hui'yuan	0
慧远	hui'yuan	0
慧岳	hui'yue	0
慧沼	hui'zhao	0
回诤论	hui'zheng'lun	0
慧忠	hui'zhong	0
汇宗寺	hui'zong'si	0
惛沉	hun'chen	0
惑	huo	0
祸从口出	huo'cong'kou'chu	0
活得快乐	huo'de'kuai'le	0
霍尔却穹	huo'er'que'qiong	0
火界定	huo'jie'ding	0
火生三昧	huo'sheng'san'mei	0
活水龙	huo'shui'long	0
霍韬晦	huo'tao'hui	0
火天	huo'tian	0
活在感恩的世界	huo'zai'gan'en'de'shi'jie	0
火葬	huo'zang	0
火宅	huo'zhai	0
偈	ji	0
机	ji	0
罽宾	ji'bin	0
吉藏	ji'cang	0
极成	ji'cheng	0
继承密付	ji'cheng'mi'fu	0
吉达利	ji'da'li	0
继灯录	ji'deng'lu	0
集谛	ji'di	0
笈多王朝	ji'duo'wang'chao	0
济公外传	ji'gong'wai'zhuan	0
济公游记	ji'gong'you'ji	0
集古今佛道论衡	ji'gu'jin'fo'dao'lun'heng	0
寂光寺	ji'guang'si	0
己和	ji'he	0
击节录	ji'jie'lu	0
饥来吃饭困来即眠	ji'lai'chi'fan'kun'lai'ji'mian	0
极乐净土	ji'le'jing'tu	0
极乐寺	ji'le'si	0
集量论	ji'liang'lun	0
吉林市灵岩寺	ji'lin'shi'ling'yan'si	0
寂灭	ji'mie	0
鸡鸣寺	ji'ming'si	0
集沙门不应拜俗等事	ji'sha'men'bu'ying'bai'su'deng'shi	0
吉山	ji'shan	0
即身成佛	ji'shen'cheng'fo	0
即身成佛义	ji'shen'cheng'fo'yi	0
集神州塔寺三宝感通录	ji'shen'zhou'ta'si'san'bao'gan'tong'lu	0
极微	ji'wei	0
讥嫌戒	ji'xian'jie	0
季羡林	ji'xian'lin	0
吉祥草	ji'xiang'cao	0
吉祥果	ji'xiang'guo	0
吉祥偈	ji'xiang'ji	0
吉祥天	ji'xiang'tian	0
吉祥天母	ji'xiang'tian'mu	0
吉祥喜金刚集轮甘露泉	ji'xiang'xi'jin'gang'ji'lun'gan'lu'quan	0
吉祥坐	ji'xiang'zuo	0
即心即佛	ji'xin'ji'fo	0
畸形	ji'xing	0
集异门足论	ji'yi'men'zu'lun	0
伎艺天	ji'yi'tian	0
鸡胤部	ji'yin'bu	0
鸡园寺	ji'yuan'si	0
鸡泽县开明禅寺	ji'ze'xian'kai'ming'chan'si	0
集诸经礼忏仪	ji'zhu'jing'li'chan'yi	0
鸡足山	ji'zu'shan	0
假	jia	0
加被	jia'bei	0
嘉曹杰	jia'cao'jie	0
加持	jia'chi	0
迦絺那衣	jia'chi'na'yi	0
加持身	jia'chi'shen	0
加持世界	jia'chi'shi'jie	0
加持物	jia'chi'wu	0
加持香水	jia'chi'xiang'shui	0
加持印明	jia'chi'yin'ming	0
加持咒	jia'chi'zhou	0
加岛法难	jia'dao'fa'nan	0
迦多衍尼子	jia'duo'yan'ni'zi	0
迦兰陀竹园	jia'lan'tuo'zhu'yuan	0
迦梨陀沙	jia'li'tuo'sha	0
迦陵频伽	jia'ling'pin'ga	0
迦留陀夷	jia'liu'tuo'yi	0
迦楼罗	jia'lou'luo	0
嘉禄法难	jia'lu'fa'nan	0
迦罗育王	jia'luo'yu'wang	0
假名	jia'ming	0
迦摩	jia'mo	0
嘉木样一世	jia'mu'yang'yi'shi	0
加拿大佛教	jia'na'da'fo'jiao	0
迦腻色迦王	jia'ni'se'jia'wang	0
迦毗罗卫	jia'pi'luo'wei	0
迦耆布罗城	jia'qi'bu'luo'cheng	0
袈裟	jia'sha	0
袈裟吉他在倾诉	jia'sha'ji'ta'zai'qing'su	0
假实二法	jia'shi'er'fa	0
迦尸国	jia'shi'guo	0
迦湿弥罗国	jia'shi'mi'luo'guo	0
甲寺	jia'si	0
嘉泰普灯录	jia'tai'pu'deng'lu	0
加藤精神	jia'teng'jing'shen	0
家庭经	jia'ting'jing	0
嘉祥寺	jia'xiang'si	0
加行	jia'xing	0
嘉兴大藏经	jia'xing'da'zang'jing	0
加行道	jia'xing'dao	0
加行得	jia'xing'de	0
加行善	jia'xing'shan	0
加行位	jia'xing'wei	0
迦叶	jia'ye	0
迦叶佛	jia'ye'fo	0
迦叶仙	jia'ye'xian	0
迦旃邻提	jia'zhan'lin'ti	0
迦旃延	jia'zhan'yan	0
迦智山	jia'zhi'shan	0
夹紵像	jia'zhu'xiang	0
见	jian	0
见爱二烦恼	jian'ai'er'fan'nao	0
建长寺	jian'chang'si	0
建初寺	jian'chu'si	0
兼但对带	jian'dan'dui'dai	0
简单事重复做	jian'dan'shi'chong'fu'zuo	0
见道	jian'dao	0
犍度	jian'du	0
箭锋相拄	jian'feng'xiang'zhu	0
见佛	jian'fo	0
见惑	jian'huo	0
捡栗子	jian'li'zi	0
艰难一忘	jian'nan'yi'wang	0
建仁寺	jian'ren'si	0
见思惑	jian'si'huo	0
犍陀罗国	jian'tuo'luo'guo	0
渐悟	jian'wu	0
见行	jian'xing	0
减行	jian'xing	0
见性成佛	jian'xing'cheng'fo	0
见修二惑	jian'xiu'er'huo	0
见与不见	jian'yu'bu'jian	0
减缘	jian'yuan	0
犍稚	jian'zhi	0
建志补罗城	jian'zhi'bu'luo'cheng	0
建中靖国续灯录	jian'zhong'jing'guo'xu'deng'lu	0
江灿腾	jiang'can'teng	0
江岛惠教	jiang'dao'hui'jiao	0
蒋贡康楚	jiang'gong'kang'chu	0
江湖风月集	jiang'hu'feng'yue'ji	0
江户佛教	jiang'hu'fo'jiao	0
江湖会	jiang'hu'hui	0
江湖派	jiang'hu'pai	0
讲经	jiang'jing	0
将军的忏悔	jiang'jun'de'chan'hui	0
降魔	jiang'mo	0
江南梵剎志	jiang'nan'fan'cha'zhi	0
降三世明王	jiang'san'shi'ming'wang	0
将手放开	jiang'shou'fang'kai	0
江味农	jiang'wei'nong	0
蒋维乔	jiang'wei'qiao	0
江西靖安古刹传奇	jiang'xi'jing'an'gu'cha'chuan'qi	0
蒋义斌	jiang'yi'bin	0
教禅二宗	jiao'chan'er'zong	0
教乘法数	jiao'cheng'fa'shu	0
憍梵波提	jiao'fan'bo'ti	0
教观二门	jiao'guan'er'men	0
教观纲宗	jiao'guan'gang'zong	0
角虎集	jiao'hu'ji	0
教诫律仪	jiao'jie'lv'yi	0
教理行果	jiao'li'xing'guo	0
蕉敏	jiao'min	0
焦热地狱	jiao're'di'yu	0
憍萨罗国	jiao'sa'luo'guo	0
焦山系	jiao'shan'xi	0
憍赏弥国	jiao'shang'mi'guo	0
教时义	jiao'shi'yi	0
教外别传	jiao'wai'bie'zhuan	0
教王护国寺	jiao'wang'hu'guo'si	0
教相	jiao'xiang	0
教行信证	jiao'xing'xin'zheng	0
教苑清规	jiao'yuan'qing'gui	0
劫	jie	0
戒	jie	0
界	jie	0
介菴进禅师语录	jie'an'jin'chan'shi'yu'lu	0
戒疤	jie'ba	0
戒本	jie'ben	0
戒乘缓急	jie'cheng'huan'ji	0
戒尺	jie'chi	0
劫初	jie'chu	0
戒刀	jie'dao	0
戒德	jie'de	0
戒牒	jie'die	0
戒灌顶	jie'guan'ding	0
戒和尚	jie'he'shang	0
结护	jie'hu	0
结集	jie'ji	0
结界	jie'jie	0
戒禁取见	jie'jin'qu'jian	0
戒腊	jie'la	0
界论	jie'lun	0
羯罗拏苏伐剌那国	jie'luo'na'su'fa'la'na'guo	0
戒律	jie'lv	0
戒门往生	jie'men'wang'sheng	0
解迷显智成悲十明论	jie'mi'xian'zhi'cheng'bei'shi'ming'lun	0
羯磨	jie'mo	0
羯磨金刚	jie'mo'jin'gang	0
界内	jie'nei	0
洁癖	jie'pi	0
介清	jie'qing	0
羯若鞠闍国	jie'ruo'ju'du'guo	0
戒杀放生文	jie'sha'fang'sheng'wen	0
戒杀念佛	jie'sha'nian'fo	0
解深密经	jie'shen'mi'jing	0
界身足论	jie'shen'zu'lun	0
结使	jie'shi	0
戒台寺	jie'tai'si	0
戒坛	jie'tan	0
戒坛院	jie'tan'yuan	0
戒体	jie'ti	0
解脱	jie'tuo	0
解脱道	jie'tuo'dao	0
解脱道论	jie'tuo'dao'lun	0
解脱歌	jie'tuo'ge	0
解脱会	jie'tuo'hui	0
解脱之路	jie'tuo'zhi'lu	0
界外	jie'wai	0
界系	jie'xi	0
结夏	jie'xia	0
结缘	jie'yuan	0
羯朱嗢祇罗国	jie'zhu'wa'chi'luo'guo	0
借住与你	jie'zhu'yu'ni	0
芥子纳须弥	jie'zi'na'xu'mi	0
接足礼	jie'zu'li	0
金箔布施	jin'bo'bu'shi	0
金藏	jin'cang	0
金仓圆照	jin'cang'yuan'zhao	0
金城公主	jin'cheng'gong'zhu	0
今村惠猛	jin'cun'hui'meng	0
金大城	jin'da'cheng	0
金代佛教	jin'dai'fo'jiao	0
金地藏	jin'di'cang	0
金东华	jin'dong'hua	0
金法麟	jin'fa'lin	0
近分定	jin'fen'ding	0
金佛寺	jin'fo'si	0
金刚	jin'gang	0
金刚般若波罗蜜经	jin'gang'bo're'bo'luo'mi'jing	0
金刚部	jin'gang'bu	0
金刚乘	jin'gang'cheng	0
金刚杵	jin'gang'chu	0
金刚顶经一字顶轮王瑜伽一切时处念诵成佛仪轨	jin'gang'ding'jing'yi'zi'ding'lun'wang'yu'jia'yi'qie'shi'chu'nian'song'cheng'fo'yi'gui	0
金刚顶经瑜伽修习毗卢遮那三摩地法	jin'gang'ding'jing'yu'jia'xiu'xi'pi'lu'zhe'na'san'mo'di'fa	0
金刚顶一切如来真实摄大乘现证大教王经	jin'gang'ding'yi'qie'ru'lai'zhen'shi'she'da'cheng'xian'zheng'da'jiao'wang'jing	0
金刚顶瑜伽护摩仪轨	jin'gang'ding'yu'jia'hu'mo'yi'gui	0
金刚顶瑜伽略述三十七尊心要	jin'gang'ding'yu'jia'lve'shu'san'shi'qi'zun'xin'yao	0
金刚顶瑜伽三十七尊出生义	jin'gang'ding'yu'jia'san'shi'qi'zun'chu'sheng'yi	0
金刚顶瑜伽中略出念诵经	jin'gang'ding'yu'jia'zhong'lve'chu'nian'song'jing	0
金刚法界宫	jin'gang'fa'jie'gong	0
金刚峰楼阁一切瑜伽瑜祇经	jin'gang'feng'lou'ge'yi'qie'yu'jia'yu'chi'jing	0
金刚峰寺	jin'gang'feng'si	0
金刚界	jin'gang'jie	0
金刚界大日如来心咒	jin'gang'jie'da'ri'ru'lai'xin'zhou	0
金刚界三十七尊	jin'gang'jie'san'shi'qi'zun	0
金刚铃	jin'gang'ling	0
金刚錍	jin'gang'pi	0
金刚萨埵	jin'gang'sa'duo	0
金刚萨埵心咒	jin'gang'sa'duo'xin'zhou	0
金刚萨埵心咒梵唱	jin'gang'sa'duo'xin'zhou'fan'chang	0
金刚山	jin'gang'shan	0
金刚手菩萨	jin'gang'shou'pu'sa	0
金刚线	jin'gang'xian	0
金刚仙论	jin'gang'xian'lun	0
金刚夜叉明王	jin'gang'ye'cha'ming'wang	0
金刚喻定	jin'gang'yu'ding	0
金刚赞	jin'gang'zan	0
金刚针论	jin'gang'zhen'lun	0
金刚智	jin'gang'zhi	0
金刚座	jin'gang'zuo	0
金阁寺	jin'ge'si	0
金光明经	jin'guang'ming'jing	0
金慧眼	jin'hui'yan	0
锦江禅灯	jin'jiang'chan'deng	0
金戒光明寺	jin'jie'guang'ming'si	0
金克木	jin'ke'mu	0
金陵梵剎志	jin'ling'fan'cha'zhi	0
金陵刻经处	jin'ling'ke'jing'chu	0
金陵清凉院文益禅师语录	jin'ling'qing'liang'yuan'wen'yi'chan'shi'yu'lu	0
紧那罗	jin'na'luo	0
金南泉	jin'nan'quan	0
今能	jin'neng	0
金毗罗	jin'pi'luo	0
金七十论	jin'qi'shi'lun	0
进入深山	jin'ru'shen'shan	0
金山活佛	jin'shan'huo'fo	0
金山寺	jin'shan'si	0
今上牌	jin'shang'pai	0
今释	jin'shi	0
金堂	jin'tang	0
今天不方便	jin'tian'bu'fang'bian	0
今天没人来	jin'tian'mei'ren'lai	0
金吞虚	jin'tun'xu	0
尽智	jin'zhi	0
锦州北普陀山普陀禅寺	jin'zhou'bei'pu'tuo'shan'pu'tuo'chan'si	0
金子大荣	jin'zi'da'rong	0
金字经	jin'zi'jing	0
敬爱法	jing'ai'fa	0
静安寺	jing'an'si	0
经变	jing'bian	0
经藏	jing'cang	0
警策	jing'ce	0
经幢	jing'chuang	0
净慈寺	jing'ci'si	0
景德传灯录	jing'de'chuan'deng'lu	0
净海	jing'hai	0
净慧老和尚谈元音老人	jing'hui'lao'he'shang'tan'yuan'yin'lao'ren	0
净秽一如	jing'hui'yi'ru	0
经集	jing'ji	0
靖江关圣寺	jing'jiang'guan'sheng'si	0
精进	jing'jin	0
静静的嘛呢石	jing'jing'de'ma'ne'shi	0
净居寺	jing'ju'si	0
净觉院	jing'jue'yuan	0
净空	jing'kong	0
净良	jing'liang	0
经量部	jing'liang'bu	0
经录	jing'lu	0
经律异相	jing'lv'yi'xiang	0
净名寺	jing'ming'si	0
净明寺	jing'ming'si	0
静权	jing'quan	0
净肉	jing'rou	0
井上靖	jing'shang'jing	0
井上日召	jing'shang'ri'zhao	0
井上圆了	jing'shang'yuan'le	0
井上哲次郎	jing'shang'zhe'ci'lang	0
精舍	jing'she	0
净施	jing'shi	0
静思精舍	jing'si'jing'she	0
靖嵩	jing'song	0
经塔	jing'ta	0
敬天寺	jing'tian'si	0
净土	jing'tu	0
净土慈悲集	jing'tu'ci'bei'ji	0
净土教美术	jing'tu'jiao'mei'shu	0
净土论	jing'tu'lun	0
净土群疑论	jing'tu'qun'yi'lun	0
净土圣贤录	jing'tu'sheng'xian'lu	0
净土十要	jing'tu'shi'yao	0
净土十疑论	jing'tu'shi'yi'lun	0
净土陀罗尼	jing'tu'tuo'luo'ni	0
净土往生传	jing'tu'wang'sheng'chuan	0
净土五会念佛诵经观行仪	jing'tu'wu'hui'nian'fo'song'jing'guan'xing'yi	0
净土真宗	jing'tu'zhen'zong	0
净土资粮全集	jing'tu'zi'liang'quan'ji	0
净土宗	jing'tu'zong	0
静琬	jing'wan	0
经王	jing'wang	0
经帷子	jing'wei'zi	0
净心	jing'xin	0
净心诫观法	jing'xin'jie'guan'fa	0
净信寺	jing'xin'si	0
净心咒	jing'xin'zhou	0
净行	jing'xing	0
憬兴	jing'xing	0
经行	jing'xing	0
境行果	jing'xing'guo	0
敬雄	jing'xiong	0
净耀	jing'yao	0
净业	jing'ye	0
净业寺	jing'ye'si	0
境野哲	jing'ye'zhe	0
景祐法宝录	jing'you'fa'bao'lu	0
景真八角亭	jing'zhen'ba'jiao'ting	0
经冢	jing'zhong	0
敬钟如佛	jing'zhong'ru'fo	0
净众宗	jing'zhong'zong	0
净住子	jing'zhu'zi	0
净宗朝暮课诵	jing'zong'zhao'mu'ke'song	0
救拔焰口饿鬼陀罗尼经	jiu'ba'yan'kou'e'gui'tuo'luo'ni'jing	0
九拜	jiu'bai	0
久保角太郎	jiu'bao'jiao'tai'lang	0
九本尊心咒	jiu'ben'zun'xin'zhou	0
九部经	jiu'bu'jing	0
旧超峰寺	jiu'chao'feng'si	0
九乘	jiu'cheng	0
臼杵石佛	jiu'chu'shi'fo	0
九次第定	jiu'ci'di'ding	0
九谛	jiu'di	0
九地	jiu'di	0
九方便	jiu'fang'bian	0
九佛事	jiu'fo'shi	0
九横死	jiu'heng'si	0
九华山	jiu'hua'shan	0
九华山一心茅篷	jiu'hua'shan'yi'xin'mao'peng	0
九华山志	jiu'hua'shan'zhi	0
九结	jiu'jie	0
究竟	jiu'jing	0
究竟离	jiu'jing'li	0
究竟一乘宝性论	jiu'jing'yi'cheng'bao'xing'lun	0
九句因	jiu'ju'yin	0
九类生	jiu'lei'sheng	0
九莲寺	jiu'lian'si	0
九龙山	jiu'long'shan	0
久米寺	jiu'mi'si	0
鸠摩利罗	jiu'mo'li'luo	0
鸠摩罗多	jiu'mo'luo'duo	0
鸠摩罗什	jiu'mo'luo'shen	0
鸠摩罗什法师大义	jiu'mo'luo'shen'fa'shi'da'yi	0
鸠摩罗天	jiu'mo'luo'tian	0
久能山	jiu'neng'shan	0
鸠槃荼	jiu'pan'tu	0
九品惑	jiu'pin'huo	0
九品净土	jiu'pin'jing'tu	0
九品莲台	jiu'pin'lian'tai	0
九品往生	jiu'pin'wang'sheng	0
九品印	jiu'pin'yin	0
救仁寺	jiu'ren'si	0
九色鹿	jiu'se'lu	0
九色鹿经	jiu'se'lu'jing	0
九山八海	jiu'shan'ba'hai	0
九山禅门	jiu'shan'chan'men	0
九上缘惑	jiu'shang'yuan'huo	0
九食	jiu'shi	0
九十八随眠	jiu'shi'ba'sui'mian	0
九师相承	jiu'shi'xiang'cheng	0
九识义	jiu'shi'yi	0
就是这样吗	jiu'shi'zhe'yang'ma	0
久松真一	jiu'song'zhen'yi	0
九无为	jiu'wu'wei	0
九无学	jiu'wu'xue	0
九想观	jiu'xiang'guan	0
九心轮	jiu'xin'lun	0
九曜	jiu'yao	0
九业	jiu'ye	0
九有情居	jiu'you'qing'ju	0
久远实成	jiu'yuan'shi'cheng	0
久远寺	jiu'yuan'si	0
九斋日	jiu'zhai'ri	0
九辙	jiu'zhe	0
九种不还	jiu'zhong'bu'huan	0
九种大禅	jiu'zhong'da'chan	0
九种相戒	jiu'zhong'xiang'jie	0
九住心	jiu'zhu'xin	0
九字印	jiu'zi'yin	0
九祖相承	jiu'zu'xiang'cheng	0
句	ju	0
俱不成过	ju'bu'cheng'guo	0
俱不极成过	ju'bu'ji'cheng'guo	0
俱不遣	ju'bu'qian	0
居简	ju'jian	0
俱利迦罗	ju'li'jia'luo	0
拘留孙佛	ju'liu'sun'fo	0
拘卢舍	ju'lu'she	0
拘那含牟尼佛	ju'na'han'mou'ni'fo	0
拘那罗太子	ju'na'luo'tai'zi	0
沮渠京声	ju'qu'jing'sheng	0
橘瑞超	ju'rui'chao	0
俱舍论	ju'she'lun	0
俱舍师	ju'she'shi	0
俱生法	ju'sheng'fa	0
具生吉祥	ju'sheng'ji'xiang	0
俱生起	ju'sheng'qi	0
俱生神	ju'sheng'shen	0
居士	ju'shi	0
居士传	ju'shi'chuan	0
居士分灯录	ju'shi'fen'deng'lu	0
居士佛教运动	ju'shi'fo'jiao'yun'dong	0
拘尸那揭罗	ju'shi'na'jie'luo	0
俱有法	ju'you'fa	0
巨赞	ju'zan	0
驹泽大学	ju'ze'da'xue	0
俱胝	ju'zhi	0
具足戒	ju'zu'jie	0
眷属	juan'shu	0
眷属地狱	juan'shu'di'yu	0
罥索	juan'suo	0
觉	jue	0
觉岸	jue'an	0
觉禅钞	jue'chan'chao	0
决定藏论	jue'ding'cang'lun	0
决定往生集	jue'ding'wang'sheng'ji	0
绝观论	jue'guan'lun	0
觉力	jue'li	0
觉囊派	jue'nang'pai	0
觉他	jue'ta	0
觉天	jue'tian	0
觉悟的诺言	jue'wu'de'nuo'yan	0
觉心	jue'xin	0
觉性	jue'xing	0
觉音	jue'yin	0
觉宇派	jue'yu'pai	0
决择	jue'ze	0
均如	jun'ru	0
军荼	jun'tu	0
君徒钵叹	jun'tu'bo'tan	0
军荼利明王	jun'tu'li'ming'wang	0
卡达拉迦马	ka'da'la'jia'ma	0
卡丹巴王朝	ka'dan'ba'wang'chao	0
卡尔里窟院	ka'er'li'ku'yuan	0
卡卢	ka'lu	0
卡通动画	ka'tong'dong'hua	0
开宝大藏经	kai'bao'da'zang'jing	0
开参	kai'can	0
开福寺	kai'fu'si	0
开阖禅机	kai'he'chan'ji	0
开化寺	kai'hua'si	0
开会	kai'hui	0
开经	kai'jing	0
开经偈	kai'jing'ji	0
开拉沙山	kai'la'sha'shan	0
开三显一	kai'san'xian'yi	0
开山	kai'shan	0
开善寺	kai'shan'si	0
开山堂	kai'shan'tang	0
开示悟入	kai'shi'wu'ru	0
开堂	kai'tang	0
开题	kai'ti	0
开先寺	kai'xian'si	0
开眼	kai'yan	0
开元释教录	kai'yuan'shi'jiao'lu	0
开元释教录略出	kai'yuan'shi'jiao'lu'lve'chu	0
开元寺	kai'yuan'si	0
开遮	kai'zhe	0
开证	kai'zheng	0
龛	kan	0
看病	kan'bing	0
堪布	kan'bu	0
看话禅	kan'hua'chan	0
看话念佛	kan'hua'nian'fo	0
看经	kan'jing	0
砍头落地	kan'tou'luo'di	0
康居	kang'ju	0
考底利耶	kao'di'li'ye	0
客尘烦恼	ke'chen'fan'nao	0
克恩	ke'en	0
科鸠拉贺	ke'jiu'la'he	0
克利须那	ke'li'xu'na	0
克利须那穆尔提	ke'li'xu'na'mu'er'ti	0
克勤	ke'qin	0
渴树罗	ke'shu'luo	0
课诵	ke'song	0
克文	ke'wen	0
科文	ke'wen	0
克雪曼德拉	ke'xue'man'de'la	0
克孜尔石窟	ke'zi'er'shi'ku	0
肯定自己	ken'ding'zi'ji	0
空	kong	0
空杯心态	kong'bei'xin'tai	0
空海	kong'hai	0
空即是色	kong'ji'shi'se	0
空见	kong'jian	0
孔雀明王	kong'que'ming'wang	0
孔雀明王经	kong'que'ming'wang'jing	0
孔雀王朝	kong'que'wang'chao	0
空色本来同	kong'se'ben'lai'tong	0
孔望山汉代摩崖像	kong'wang'shan'han'dai'mo'ya'xiang	0
孔维勤	kong'wei'qin	0
空无边处天	kong'wu'bian'chu'tian	0
空也	kong'ye	0
孔滋	kong'zi	0
叩钟偈	kou'zhong'ji	0
苦	ku	0
库车	ku'che	0
苦谛	ku'di	0
库伦	ku'lun	0
枯木禅	ku'mu'chan	0
库木土拉石窟	ku'mu'tu'la'shi'ku	0
哭笑无常	ku'xiao'wu'chang	0
苦心度众	ku'xin'du'zhong	0
苦行	ku'xing	0
枯崖和尚漫录	ku'ya'he'shang'man'lu	0
苦因与苦果	ku'yin'yu'ku'guo	0
快皈投佛陀座下	kuai'gui'tou'fo'tuo'zuo'xia	0
快活烈汉	kuai'huo'lie'han	0
快乐与痛苦	kuai'le'yu'tong'ku	0
快乐之道	kuai'le'zhi'dao	0
宽朝	kuan'chao	0
宽永寺	kuan'yong'si	0
狂惑	kuang'huo	0
旷野神	kuang'ye'shen	0
愧对禽兽	kui'dui'qin'shou	0
窥基	kui'ji	0
昆达昆达	kun'da'kun'da	0
腊八粥	la'ba'zhou	0
拉卜楞寺	la'bu'leng'si	0
拉藏汗	la'cang'han	0
拉达克	la'da'ke	0
拉达克里希南	la'da'ke'li'xi'nan	0
拉露	la'lu	0
喇嘛	la'ma	0
拉玛四世	la'ma'si'shi	0
拉玛一世	la'ma'yi'shi	0
拉莫特	la'mo'te	0
拉萨	la'sa	0
拉森	la'sen	0
来复	lai'fu	0
来果	lai'guo	0
赖鹏举	lai'peng'ju	0
赖耶缘起	lai'ye'yuan'qi	0
来迎院	lai'ying'yuan	0
赖瑜	lai'yu	0
赖咤和罗	lai'zha'he'luo	0
滥波国	lan'bo'guo	0
蓝吉富	lan'ji'fu	0
蓝毗尼园	lan'pi'ni'yuan	0
廊坊净业精舍念佛堂	lang'fang'jing'ye'jing'she'nian'fo'tang	0
廊坊石佛寺	lang'fang'shi'fo'si	0
廊坊市龙泉白塔寺	lang'fang'shi'long'quan'bai'ta'si	0
老藏丹贝	lao'cang'dan'bei	0
老妇人洗脚	lao'fu'ren'xi'jiao	0
老苦	lao'ku	0
老南山寺	lao'nan'shan'si	0
老婆心切	lao'po'xin'qie	0
老死	lao'si	0
老子化胡经	lao'zi'hua'hu'jing	0
老子化胡说	lao'zi'hua'hu'shuo	0
老做小	lao'zuo'xiao	0
乐	le	0
了菴和尚语录	le'an'he'shang'yu'lu	0
乐邦文类	le'bang'wen'lei	0
乐崇辉	le'chong'hui	0
乐道歌	le'dao'ge	0
了的	le'de	0
了凡的故事	le'fan'de'gu'shi	0
了凡四训	le'fan'si'xun	0
了凡四訓電影版	le'fan'si'xun'dian'ying'ban	0
乐观	le'guan	0
了惠	le'hui	0
了派	le'pai	0
了世	le'shi	0
了堂惟一禅师语录	le'tang'wei'yi'chan'shi'yu'lu	0
了万	le'wan	0
了午	le'wu	0
勒修百丈清规	le'xiu'bai'zhang'qing'gui	0
了义	le'yi	0
了义般若波罗蜜多经	le'yi'bo're'bo'luo'mi'duo'jing	0
了元歌	le'yuan'ge	0
了中	le'zhong	0
雷峰塔	lei'feng'ta	0
雷音寺	lei'yin'si	0
楞伽经	leng'jia'jing	0
楞伽山	leng'jia'shan	0
楞伽师资记	leng'jia'shi'zi'ji	0
冷暖自知	leng'nuan'zi'zhi	0
楞严经	leng'yan'jing	0
楞严一笑	leng'yan'yi'xiao	0
楞严咒	leng'yan'zhou	0
力	li	0
礼拜	li'bai	0
李炳南	li'bing'nan	0
李博永	li'bo'yong	0
历朝释氏资鉴	li'chao'shi'shi'zi'jian	0
离车	li'che	0
历代法宝记	li'dai'fa'bao'ji	0
历代三宝纪	li'dai'san'bao'ji	0
立地成佛	li'di'cheng'fo	0
历法	li'fa	0
礼佛大忏悔文	li'fo'da'chan'hui'wen	0
立花俊道	li'hua'jun'dao	0
历劫	li'jie	0
梨俱吠陀	li'ju'fei'tuo	0
离六堂集	li'liu'tang'ji	0
黎明寺	li'ming'si	0
离婆多	li'po'duo	0
理趣般若经	li'qu'bo're'jing	0
理趣经	li'qu'jing	0
利涉	li'she	0
立世阿毗昙论	li'shi'a'pi'tan'lun	0
李世杰	li'shi'jie	0
立石寺	li'shi'si	0
丽水三岩禅寺	li'shui'san'yan'chan'si	0
利他	li'ta	0
离檀禁止令	li'tan'jin'zhi'ling	0
李挽	li'wan	0
离系	li'xi	0
立信	li'xin	0
利言	li'yan	0
利严	li'yan	0
李元松	li'yuan'song	0
立正安国论	li'zheng'an'guo'lun	0
立正大学	li'zheng'da'xue	0
李志夫	li'zhi'fu	0
李子宽	li'zi'kuan	0
离作法	li'zuo'fa	0
离作业灌顶	li'zuo'ye'guan'ding	0
鎌仓佛教	lian'cang'fo'jiao	0
联灯会要	lian'deng'hui'yao	0
莲芬净土	lian'fen'jing'tu	0
莲航	lian'hang	0
莲华	lian'hua	0
莲华藏世界	lian'hua'cang'shi'jie	0
莲华戒	lian'hua'jie	0
莲花净土	lian'hua'jing'tu	0
莲华色	lian'hua'se	0
莲华色女的故事	lian'hua'se'nv'de'gu'shi	0
莲华生	lian'hua'sheng	0
莲花生大士	lian'hua'sheng'da'shi	0
莲花生大师心咒	lian'hua'sheng'da'shi'xin'zhou	0
莲如	lian'ru	0
莲师心咒	lian'shi'xin'zhou	0
鎌田茂雄	lian'tian'mao'xiong	0
莲香飘渺	lian'xiang'piao'miao	0
莲心洁净	lian'xin'jie'jing	0
量	liang	0
两部大法相承师资付法记	liang'bu'da'fa'xiang'cheng'shi'zi'fu'fa'ji	0
两个国王	liang'ge'guo'wang	0
两个争强好斗者	liang'ge'zheng'qiang'hao'dou'zhe	0
两界曼荼罗	liang'jie'man'tu'luo	0
两俱不成过	liang'ju'bu'cheng'guo	0
量论	liang'lun	0
两舌	liang'she	0
两序	liang'xu	0
两宗禅宗公案	liang'zong'chan'zong'gong'an	0
两座庙善用别人的智慧	liang'zuo'miao'shan'yong'bie'ren'de'zhi'hui	0
辽代佛教	liao'dai'fo'jiao	0
寮国佛教	liao'guo'fo'jiao	0
料简	liao'jian	0
辽宁阜新龙海禅寺	liao'ning'fu'xin'long'hai'chan'si	0
辽宁盘锦祗园寺	liao'ning'pan'jin'zhi'yuan'si	0
辽宁省盘锦市高升念佛堂	liao'ning'sheng'pan'jin'shi'gao'sheng'nian'fo'tang	0
辽宁绥中文殊院	liao'ning'sui'zhong'wen'shu'yuan	0
了然	liao'ran	0
了无功德	liao'wu'gong'de	0
邻阿伽色	lin'a'ga'se	0
林保尧	lin'bao'yao	0
林崇安	lin'chong'an	0
林传芳	lin'chuan'fang	0
临海龙兴古寺	lin'hai'long'xing'gu'si	0
临海市场增福堂	lin'hai'shi'chang'zeng'fu'tang	0
临济禅师法语	lin'ji'chan'shi'fa'yu	0
临济录	lin'ji'lu	0
临济寺	lin'ji'si	0
临济宗	lin'ji'zong	0
林间录	lin'jian'lu	0
林锦东	lin'jin'dong	0
林藜光	lin'li'guang	0
林清玄	lin'qing'xuan	0
林秋梧	lin'qiu'wu	0
林蓉芝	lin'rong'zhi	0
临西月洼寺	lin'xi'yue'wa'si	0
林彦明	lin'yan'ming	0
林云禅寺	lin'yun'chan'si	0
林镇国	lin'zhen'guo	0
临终正念	lin'zhong'zheng'nian	0
灵谷寺	ling'gu'si	0
灵光寺	ling'guang'si	0
灵鹫山般若文教基金会	ling'jiu'shan'bo're'wen'jiao'ji'jin'hui	0
灵利道人	ling'li'dao'ren	0
铃木大拙	ling'mu'da'zhuo	0
铃木正三	ling'mu'zheng'san	0
灵泉禅寺	ling'quan'chan'si	0
灵泉寺	ling'quan'si	0
灵山庵	ling'shan'an	0
灵山寺	ling'shan'si	0
灵巖寺	ling'yan'si	0
灵隐寺	ling'yin'si	0
凌云禅寺	ling'yun'chan'si	0
令知会	ling'zhi'hui	0
六本宗书	liu'ben'zong'shu	0
柳本尊	liu'ben'zun	0
六波罗蜜	liu'bo'luo'mi	0
六不定过	liu'bu'ding'guo	0
六成就	liu'cheng'jiu	0
六触	liu'chu	0
六大	liu'da	0
六大城	liu'da'cheng	0
六大缘起	liu'da'yuan'qi	0
六道	liu'dao	0
六道金刚咒	liu'dao'jin'gang'zhou	0
六度集经	liu'du'ji'jing	0
六恶	liu'e	0
六法	liu'fa	0
六法戒	liu'fa'jie	0
六根	liu'gen	0
六根忏悔	liu'gen'chan'hui	0
六根互用	liu'gen'hu'yong	0
六根清净	liu'gen'qing'jing	0
刘贵杰	liu'gui'jie	0
刘国香	liu'guo'xiang	0
六行观	liu'hang'guan	0
六和敬	liu'he'jing	0
六和塔	liu'he'ta	0
六即	liu'ji	0
六家七宗	liu'jia'qi'zong	0
六境	liu'jing	0
六经十一论	liu'jing'shi'yi'lun	0
六聚	liu'ju	0
六决定	liu'jue'ding	0
琉璃宫大史	liu'li'gong'da'shi	0
六门教授习定论	liu'men'jiao'shou'xi'ding'lun	0
六妙法门	liu'miao'fa'men	0
六妙门	liu'miao'men	0
六难	liu'nan	0
六念	liu'nian	0
刘虬	liu'qiu	0
琉球佛教	liu'qiu'fo'jiao	0
六榕寺	liu'rong'si	0
刘锐之	liu'rui'zhi	0
六识	liu'shi	0
六时	liu'shi	0
六十二见	liu'shi'er'jian	0
六事体功法	liu'shi'ti'gong'fa	0
六十心	liu'shi'xin	0
柳塘外集	liu'tang'wai'ji	0
柳田圣山	liu'tian'sheng'shan	0
六通	liu'tong	0
六味	liu'wei	0
六物	liu'wu	0
六相	liu'xiang	0
六相圆融	liu'xiang'yuan'rong	0
六学僧传	liu'xue'seng'chuan	0
六因	liu'yin	0
六欲天	liu'yu'tian	0
六月会	liu'yue'hui	0
六斋日	liu'zhai'ri	0
六重本迹	liu'zhong'ben'ji	0
六种拳印	liu'zhong'quan'yin	0
六种震动	liu'zhong'zhen'dong	0
流转	liu'zhuan	0
六字大明咒	liu'zi'da'ming'zhou	0
六字经法	liu'zi'jing'fa	0
六字弥陀	liu'zi'mi'tuo	0
六字文殊菩萨	liu'zi'wen'shu'pu'sa	0
六宗	liu'zong	0
柳宗元	liu'zong'yuan	0
六祖慧能传	liu'zu'hui'neng'chuan	0
六足论	liu'zu'lun	0
六祖坛经	liu'zu'tan'jing	0
龙藏	long'cang	0
隆道	long'dao	0
隆多嘉措佛爷坐床仪式	long'duo'jia'cuo'fo'ye'zuo'chuang'yi'shi	0
龙岗寺	long'gang'si	0
龙宫山庆华寺	long'gong'shan'qing'hua'si	0
龙谷大学	long'gu'da'xue	0
龙光寺	long'guang'si	0
龙国庵念佛堂	long'guo'an'nian'fo'tang	0
龙海禅寺	long'hai'chan'si	0
龙湖巖	long'hu'yan	0
龙华三会	long'hua'san'hui	0
龙华树	long'hua'shu	0
龙华寺	long'hua'si	0
龙龛手鉴	long'kan'shou'jian	0
龙门石窟	long'men'shi'ku	0
龙门寺	long'men'si	0
龙女成佛	long'nv'cheng'fo	0
龙盘寺	long'pan'si	0
龙清巴	long'qing'ba	0
龙泉古寺	long'quan'gu'si	0
龙泉寺	long'quan'si	0
泷泉寺	long'quan'si	0
龙山寺	long'shan'si	0
龙树	long'shu	0
龙舒净土文	long'shu'jing'tu'wen	0
龙树菩萨劝诫王颂	long'shu'pu'sa'quan'jie'wang'song	0
龙树山	long'shu'shan	0
龙喜记	long'xi'ji	0
龙象	long'xiang	0
隆兴佛教编年通论	long'xing'fo'jiao'bian'nian'tong'lun	0
隆兴寺	long'xing'si	0
龙兴寺	long'xing'si	0
隆尧开化寺	long'yao'kai'hua'si	0
龙智	long'zhi	0
龙珠寺	long'zhu'si	0
漏	lou	0
漏尽通	lou'jin'tong	0
楼兰	lou'lan	0
鲁冰花	lu'bing'hua	0
六合释	lu'he'shi	0
庐江冶父山寺	lu'jiang'ye'fu'shan'si	0
卢梅楚臣喜饶	lu'mei'chu'chen'xi'rao	0
露盘	lu'pan	0
庐山	lu'shan	0
庐山莲宗宝鉴	lu'shan'lian'zong'bao'jian	0
麓山寺	lu'shan'si	0
漉水囊	lu'shui'nang	0
炉香赞	lu'xiang'zan	0
芦墟泗洲禅寺	lu'xu'si'zhou'chan'si	0
鹿野苑	lu'ye'yuan	0
陆羽煎茶	lu'yu'jian'cha	0
略论安乐净土义	lve'lun'an'le'jing'tu'yi	0
略释新华严经修行次第决疑论	lve'shi'xin'hua'yan'jing'xiu'xing'ci'di'jue'yi'lun	0
轮藏	lun'cang	0
轮回	lun'hui	0
论家	lun'jia	0
论事	lun'shi	0
论师	lun'shi	0
罗布林卡	luo'bu'lin'ka	0
洛叉	luo'cha	0
罗剎	luo'cha	0
罗汉供	luo'han'gong	0
罗侯罗	luo'hou'luo	0
罗侯罗跋陀罗	luo'hou'luo'ba'tuo'luo	0
罗湖野录	luo'hu'ye'lu	0
罗迦陵	luo'jia'ling	0
罗摩功行录	luo'mo'gong'xing'lu	0
罗摩克里希纳	luo'mo'ke'li'xi'na	0
罗摩难陀	luo'mo'nan'tuo	0
罗摩奴闍	luo'mo'nu'du	0
罗摩衍那	luo'mo'yan'na	0
罗姆摩罕罗易	luo'mu'mo'han'luo'yi	0
罗晴湖	luo'qing'hu	0
洛阳伽蓝记	luo'yang'qie'lan'ji	0
律	lv	0
绿财神心咒	lv'cai'shen'xin'zhou	0
律藏	lv'cang	0
绿度母	lv'du'mu	0
绿度母心咒	lv'du'mu'xin'zhou	0
律二十二明了论	lv'er'shi'er'ming'liao'lun	0
律经	lv'jing	0
律师	lv'shi	0
律仪	lv'yi	0
律院	lv'yuan	0
律宗	lv'zong	0
麻谷寺	ma'gu'si	0
马来西亚佛教	ma'lai'xi'ya'fo'jiao	0
麻三斤	ma'san'jin	0
马蹄寺石窟	ma'ti'si'shi'ku	0
马阴藏相	ma'yin'cang'xiang	0
马祖禅师法语	ma'zu'chan'shi'fa'yu	0
马祖道一	ma'zu'dao'yi	0
麦积山石窟	mai'ji'shan'shi'ku	0
买来的智慧	mai'lai'de'zhi'hui	0
卖油翁	mai'you'weng	0
慢	man	0
曼谷	man'gu	0
满了吗	man'le'ma	0
曼殊迦佉耶颂	man'shu'jia'qu'ye'song	0
曼荼罗	man'tu'luo	0
曼陀罗华	man'tuo'luo'hua	0
满意	man'yi	0
缦衣	man'yi	0
满州语译大藏经	man'zhou'yu'yi'da'zang'jing	0
忙莽鸡菩萨	mang'mang'ji'pu'sa	0
盲人点灯	mang'ren'dian'deng	0
么洗	me'xi	0
美国佛教	mei'guo'fo'jiao	0
眉沙迦山	mei'sha'jia'shan	0
没时间老	mei'shi'jian'lao	0
每天吃什么	mei'tian'chi'shen'me	0
门迹	men'ji	0
门前町	men'qian'ding	0
门叶记	men'ye'ji	0
梦	meng	0
蒙古佛教	meng'gu'fo'jiao	0
蒙古源流	meng'gu'yuan'liu	0
梦幻人世间	meng'huan'ren'shi'jian	0
孟加拉佛教	meng'jia'la'fo'jiao	0
迷	mi	0
祕藏宝钥	mi'cang'bao'yao	0
密迹力士	mi'ji'li'shi	0
米兰	mi'lan	0
弥兰王	mi'lan'wang	0
弥勒净土变	mi'le'jing'tu'bian	0
弥勒论师	mi'le'lun'shi	0
弥勒内院	mi'le'nei'yuan	0
弥勒菩萨	mi'le'pu'sa	0
弥勒菩萨所问本愿经	mi'le'pu'sa'suo'wen'ben'yuan'jing	0
弥勒三经	mi'le'san'jing	0
弥勒寺	mi'le'si	0
弥戾车	mi'li'che	0
密林山部	mi'lin'shan'bu	0
祕密集会怛特罗	mi'mi'ji'hui'da'te'luo	0
弥沙塞部和酰五分律	mi'sha'sai'bu'he'xian'wu'fen'lv	0
弥授	mi'shou	0
弥梯罗城	mi'ti'luo'cheng	0
弥陀寺	mi'tuo'si	0
弥陀天堂	mi'tuo'tian'tang	0
密严净土	mi'yan'jing'tu	0
密宗	mi'zong	0
密宗道次第广论	mi'zong'dao'ci'di'guang'lun	0
密宗要决钞	mi'zong'yao'jue'chao	0
缅甸佛教	mian'dian'fo'jiao	0
免丁钱	mian'ding'qian	0
面上污秽	mian'shang'wu'hui	0
庙	miao	0
庙产兴学	miao'chan'xing'xue	0
妙超	miao'chao	0
妙法华寺	miao'fa'hua'si	0
妙法莲华经	miao'fa'lian'hua'jing	0
妙法人	miao'fa'ren	0
妙法寺	miao'fa'si	0
妙法院	miao'fa'yuan	0
妙果	miao'guo	0
妙好人传	miao'hao'ren'chuan	0
妙见菩萨	miao'jian'pu'sa	0
妙觉	miao'jue	0
妙空	miao'kong	0
妙快	miao'kuai	0
妙莲	miao'lian	0
妙莲寺	miao'lian'si	0
妙满寺	miao'man'si	0
妙葩	miao'pa	0
妙清	miao'qing	0
妙然	miao'ran	0
妙声	miao'sheng	0
妙显寺	miao'xian'si	0
妙心寺	miao'xin'si	0
妙心寺派	miao'xin'si'pai	0
妙严寺	miao'yan'si	0
妙音	miao'yin	0
妙音念佛堂	miao'yin'nian'fo'tang	0
妙音天女心咒	miao'yin'tian'nv'xin'zhou	0
妙应寺	miao'ying'si	0
妙云集	miao'yun'ji	0
妙云兰若	miao'yun'lan're	0
妙总	miao'zong	0
灭谛	mie'di	0
灭尽定	mie'jin'ding	0
明	ming	0
明板大藏经	ming'ban'da'zang'jing	0
冥报记	ming'bao'ji	0
明本	ming'ben	0
明乘	ming'cheng	0
明成祖	ming'cheng'zu	0
明代佛教	ming'dai'fo'jiao	0
鸣道集说	ming'dao'ji'shuo	0
明妃	ming'fei	0
明复	ming'fu	0
命根	ming'gen	0
明光	ming'guang	0
明光抹山寺	ming'guang'mo'shan'si	0
明护	ming'hu	0
明觉禅师语录	ming'jiao'chan'shi'yu'lu	0
明净寺	ming'jing'si	0
名句文身	ming'ju'wen'shen	0
明旷	ming'kuang	0
明朗	ming'lang	0
明那耶夫	ming'na'ye'fu	0
名色	ming'se	0
名僧传	ming'seng'chuan	0
明太祖	ming'tai'zu	0
明王	ming'wang	0
明行道六成就法	ming'xing'dao'liu'cheng'jiu'fa	0
名言	ming'yan	0
名言种子	ming'yan'zhong'zi	0
明瓒	ming'zan	0
明瞻	ming'zhan	0
明兆	ming'zhao	0
明照	ming'zhao	0
明真	ming'zhen	0
魔	mo	0
默摈	mo'bin	0
摩呾理迦	mo'da'li'jia	0
末代念佛授手印	mo'dai'nian'fo'shou'shou'yin	0
摩登伽	mo'deng'ga	0
摩登伽经	mo'deng'ga'jing	0
摩咥里制咤	mo'die'li'zhi'zha	0
末法	mo'fa	0
末伽梨拘舍梨	mo'ga'li'ju'she'li	0
摩诃	mo'he	0
摩诃波闍波提	mo'he'bo'du'bo'ti	0
摩诃迦叶	mo'he'jia'ye	0
摩诃劫宾那	mo'he'jie'bin'na	0
摩诃俱絺罗	mo'he'ju'chi'luo	0
摩诃摩耶	mo'he'mo'ye	0
摩诃摩耶经	mo'he'mo'ye'jing	0
摩诃目犍连	mo'he'mu'jian'lian	0
摩诃男	mo'he'nan	0
摩诃婆罗多	mo'he'po'luo'duo	0
摩诃菩提协会	mo'he'pu'ti'xie'hui	0
摩诃僧祇律	mo'he'seng'chi'lv	0
摩诃衍	mo'he'yan	0
摩诃止观	mo'he'zhi'guan	0
摩侯罗伽	mo'hou'luo'ga	0
摩揭陀国	mo'jie'tuo'guo	0
摩腊婆国	mo'la'po'guo	0
摩利支天	mo'li'zhi'tian	0
摩罗国	mo'luo'guo	0
摩罗难陀	mo'luo'nan'tuo	0
末摩	mo'mo	0
摩那埵	mo'na'duo	0
末那识	mo'na'shi	0
摩尼	mo'ni	0
摩奴法典	mo'nu'fa'dian	0
默如	mo'ru	0
磨沙	mo'sha	0
摩哂陀	mo'shen'tuo	0
末田地	mo'tian'di	0
摩突罗国	mo'tu'luo'guo	0
磨崖佛	mo'ya'fo	0
默照禅	mo'zhao'chan	0
磨砖成镜	mo'zhuan'cheng'jing	0
磨砖做镜	mo'zhuan'zuo'jing	0
牟尼	mou'ni	0
牟子理惑论	mou'zi'li'huo'lun	0
牟宗三	mou'zong'san	0
木村泰贤	mu'cun'tai'xian	0
木患子	mu'huan'zi	0
目犍连子帝须	mu'jian'lian'zi'di'xu	0
牧口常三郎	mu'kou'chang'san'lang	0
木兰色	mu'lan'se	0
穆勒	mu'le	0
目连救母	mu'lian'jiu'mu	0
牧田谛亮	mu'tian'di'liang	0
木鱼	mu'yu	0
沐浴	mu'yu	0
拿贡巴东	na'gong'ba'dong	0
那揭罗曷国	na'jie'luo'he'guo	0
那就是禅	na'jiu'shi'chan	0
那烂陀寺	na'lan'tuo'si	0
哪里没有佛	na'li'mei'you'fo	0
那罗延天	na'luo'yan'tian	0
南无	na'mo	0
南无观世音菩萨圣号	na'mo'guan'shi'yin'pu'sa'sheng'hao	0
那锡克	na'xi'ke	0
那先比丘经	na'xian'bi'qiu'jing	0
衲衣	na'yi	0
那由多	na'you'duo	0
奈良大佛	nai'liang'da'fo	0
奈良佛教	nai'liang'fo'jiao	0
耐秣陀河	nai'mo'tuo'he	0
奈塘寺	nai'tang'si	0
南藏	nan'cang	0
南禅寺	nan'chan'si	0
南朝佛教	nan'chao'fo'jiao	0
南传大藏经	nan'chuan'da'zang'jing	0
南传佛教	nan'chuan'fo'jiao	0
南传七论	nan'chuan'qi'lun	0
南都六宗	nan'dou'liu'zong	0
南宫市普彤寺	nan'gong'shi'pu'tong'si	0
南海寄归内法传	nan'hai'ji'gui'nei'fa'chuan	0
南华寺	nan'hua'si	0
南怀瑾	nan'huai'jin	0
南京	nan'jing	0
南京方山定林寺	nan'jing'fang'shan'ding'lin'si	0
南普陀寺	nan'pu'tuo'si	0
南泉救鹅	nan'quan'jiu'e	0
南三北七	nan'san'bei'qi	0
南山念佛门禅宗	nan'shan'nian'fo'men'chan'zong	0
南山三观	nan'shan'san'guan	0
南山寺	nan'shan'si	0
南宋元明禅林僧宝传	nan'song'yuan'ming'chan'lin'seng'bao'chuan	0
南台寺	nan'tai'si	0
南条文雄	nan'tiao'wen'xiong	0
南亭	nan'ting	0
南通太平禅寺	nan'tong'tai'ping'chan'si	0
难陀	nan'tuo	0
难陀龙王	nan'tuo'long'wang	0
难行道	nan'xing'dao	0
南阳慧忠	nan'yang'hui'zhong	0
南岳单传记	nan'yue'dan'zhuan'ji	0
南岳思大禅师立誓愿文	nan'yue'si'da'chan'shi'li'shi'yuan'wen	0
南诏	nan'zhao	0
恼	nao	0
内藏寺	nei'cang'si	0
内道	nei'dao	0
内道场	nei'dao'chang	0
内典	nei'dian	0
内典尘露章	nei'dian'chen'lu'zhang	0
内凡	nei'fan	0
内供奉	nei'gong'feng	0
内蒙古包头市普渡寺	nei'meng'gu'bao'tou'shi'pu'du'si	0
内明	nei'ming	0
内四供养	nei'si'gong'yang	0
内学年刊	nei'xue'nian'kan	0
内证佛法相承血脉谱	nei'zheng'fo'fa'xiang'cheng'xue'mai'pu	0
能	neng	0
能别不极成过	neng'bie'bu'ji'cheng'guo	0
能大能小	neng'da'neng'xiao	0
能立	neng'li	0
能立不遣	neng'li'bu'qian	0
能立法不成	neng'li'fa'bu'cheng	0
能仁寺	neng'ren'si	0
能显中边慧日论	neng'xian'zhong'bian'hui'ri'lun	0
能学	neng'xue	0
尼泊尔佛教	ni'bo'er'fo'jiao	0
你点的是哪个心	ni'dian'de'shi'na'ge'xin	0
尼姑原是女人做	ni'gu'yuan'shi'nv'ren'zuo	0
你好吗	ni'hao'ma	0
你还抱着吗	ni'huan'bao'zhe'ma	0
你就是佛	ni'jiu'shi'fo	0
尼拘律树	ni'ju'lv'shu	0
尼拘陀梵志	ni'ju'tuo'fan'zhi	0
尼连禅河	ni'lian'chan'he	0
泥泞路上	ni'ning'lu'shang	0
尼萨耆波逸提	ni'sa'qi'bo'yi'ti	0
尼师坛	ni'shi'tan	0
尼寺	ni'si	0
尼寺五山	ni'si'wu'shan	0
尼陀那	ni'tuo'na	0
你无怫性	ni'wu'fu'xing	0
尼耶那第洛卡	ni'ye'na'di'luo'ka	0
逆缘	ni'yuan	0
念	nian	0
念常	nian'chang	0
念持佛	nian'chi'fo	0
年分度者	nian'fen'du'zhe	0
念佛	nian'fo	0
念佛宝号	nian'fo'bao'hao	0
念佛禅	nian'fo'chan	0
念佛镜	nian'fo'jing	0
念佛三昧宝王论	nian'fo'san'mei'bao'wang'lun	0
念佛图	nian'fo'tu	0
拈古	nian'gu	0
拈花微笑	nian'hua'wei'xiao	0
拈华微笑	nian'hua'wei'xiao	0
念劫融即	nian'jie'rong'ji	0
念经与成佛	nian'jing'yu'cheng'fo	0
念诵	nian'song	0
念智称	nian'zhi'cheng	0
涅槃	nie'pan	0
涅槃会	nie'pan'hui	0
涅槃师	nie'pan'shi	0
涅槃智	nie'pan'zhi	0
涅槃宗	nie'pan'zong	0
宁城法轮寺	ning'cheng'fa'lun'si	0
宁静夜	ning'jing'ye	0
宁玛派	ning'ma'pai	0
凝然	ning'ran	0
牛头马头	niu'tou'ma'tou	0
牛头山	niu'tou'shan	0
牛头旃檀	niu'tou'zhan'tan	0
农禅寺	nong'chan'si	0
诺健那	nuo'jian'na	0
诺那呼图克图	nuo'na'hu'tu'ke'tu	0
女犯	nv'fan	0
女人成佛	nv'ren'cheng'fo	0
女子出定	nv'zi'chu'ding	0
欧波僧正	ou'bo'seng'zheng	0
欧丹多富梨寺	ou'dan'duo'fu'li'si	0
欧登柏格	ou'deng'bai'ge	0
欧登贝格	ou'deng'bei'ge	0
欧尔卡特	ou'er'ka'te	0
沤和俱舍罗	ou'he'ju'she'luo	0
欧阳渐	ou'yang'jian	0
欧阳无畏	ou'yang'wu'wei	0
欧洲佛教	ou'zhou'fo'jiao	0
爬山	pa'shan	0
帕竹噶举	pa'zhu'ga'ju	0
盘珪禅师语录	pan'gui'chan'shi'yu'lu	0
判教	pan'jiao	0
攀缘	pan'yuan	0
庞蕴	pang'yun	0
裴休	pei'xiu	0
毗佛略	pi'fo'lve	0
毗伽罗论	pi'ga'luo'lun	0
毗诃罗	pi'he'luo	0
被甲护身	pi'jia'hu'shen	0
毗兰若	pi'lan're	0
毗琉璃王	pi'liu'li'wang	0
毗卢七支坐	pi'lu'qi'zhi'zuo	0
毗卢遮那	pi'lu'zhe'na	0
毗卢遮那佛咒	pi'lu'zhe'na'fo'zhou	0
毗尼多流支	pi'ni'duo'liu'zhi	0
毗尼母经	pi'ni'mu'jing	0
毗婆沙	pi'po'sha	0
毗婆尸佛	pi'po'shi'fo	0
毗沙门天	pi'sha'men'tian	0
毗舍闍	pi'she'du	0
毗舍浮佛	pi'she'fu'fo	0
毗舍离	pi'she'li	0
毗湿奴天	pi'shi'nu'tian	0
毗首羯摩天	pi'shou'jie'mo'tian	0
毗昙师	pi'tan'shi	0
譬喻	pi'yu	0
譬喻师	pi'yu'shi	0
品类足论	pin'lei'zu'lun	0
贫女施灯	pin'nv'shi'deng	0
频婆娑罗王	pin'po'suo'luo'wang	0
贫人本生身布施的例子	pin'ren'ben'sheng'shen'bu'shi'de'li'zi	0
贫者一灯	pin'zhe'yi'deng	0
瓶	ping	0
平常心	ping'chang'xin	0
平常心是道	ping'chang'xin'shi'dao	0
平川彰	ping'chuan'zhang	0
平等	ping'deng	0
平等性智	ping'deng'xing'zhi	0
平间寺	ping'jian'si	0
平平淡淡才是真	ping'ping'dan'dan'cai'shi'zhen	0
瓶塔	ping'ta	0
平乡县观音寺	ping'xiang'xian'guan'yin'si	0
平兴寺	ping'xing'si	0
破布裹真珠	po'bu'guo'zhen'zhu	0
破戒	po'jie	0
婆罗门	po'luo'men	0
颇瓦法	po'wa'fa	0
破邪	po'xie	0
普巴金剛	pu'ba'jin'gang	0
普巴金刚祈請文	pu'ba'jin'gang'qi'qing'wen	0
普巴金剛心咒	pu'ba'jin'gang'xin'zhou	0
普巴金刚心咒梵唱	pu'ba'jin'gang'xin'zhou'fan'chang	0
普法	pu'fa	0
蒲甘	pu'gan	0
普光王寺	pu'guang'wang'si	0
朴汉永	pu'han'yong	0
普化摇铃	pu'hua'yao'ling	0
普化宗	pu'hua'zong	0
普慧大藏经	pu'hui'da'zang'jing	0
普济禅寺	pu'ji'chan'si	0
普救寺	pu'jiu'si	0
普拉克利特语	pu'la'ke'li'te'yu	0
普乐寺	pu'le'si	0
普门	pu'men	0
普门寺	pu'men'si	0
菩妙	pu'miao	0
普明寺	pu'ming'si	0
普宁藏	pu'ning'cang	0
普宁寺	pu'ning'si	0
普请	pu'qing	0
朴秋潭	pu'qiu'tan	0
普劝坐禅仪	pu'quan'zuo'chan'yi	0
溥仁寺	pu'ren'si	0
菩萨	pu'sa	0
菩萨本生鬘论	pu'sa'ben'sheng'man'lun	0
菩萨处胎经	pu'sa'chu'tai'jing	0
菩萨的脚印	pu'sa'de'jiao'yin	0
菩萨地持经	pu'sa'di'chi'jing	0
菩萨顶	pu'sa'ding	0
菩萨戒	pu'sa'jie	0
菩萨戒本	pu'sa'jie'ben	0
菩萨僧	pu'sa'seng	0
菩萨善戒经	pu'sa'shan'jie'jing	0
菩萨璎珞本业经	pu'sa'ying'luo'ben'ye'jing	0
朴上月	pu'shang'yue	0
普说	pu'shuo	0
菩提	pu'ti	0
菩提场	pu'ti'chang	0
菩提道次第传灯法师列传	pu'ti'dao'ci'di'chuan'deng'fa'shi'lie'zhuan	0
菩提道次第诀要	pu'ti'dao'ci'di'jue'yao	0
菩提道次第论	pu'ti'dao'ci'di'lun	0
菩提道灯论	pu'ti'dao'deng'lun	0
菩提树	pu'ti'shu	0
菩提寺	pu'ti'si	0
菩提心	pu'ti'xin	0
菩提心论	pu'ti'xin'lun	0
菩提行经	pu'ti'xing'jing	0
菩提吟	pu'ti'yin	0
菩提资粮论	pu'ti'zi'liang'lun	0
普通院	pu'tong'yuan	0
普陀山	pu'tuo'shan	0
普陀宗乘之庙	pu'tuo'zong'cheng'zhi'miao	0
普贤菩萨	pu'xian'pu'sa	0
普贤寺	pu'xian'si	0
普贤行愿品	pu'xian'xing'yuan'pin	0
普贤延命法	pu'xian'yan'ming'fa	0
七宝	qi'bao	0
七宝教寺	qi'bao'jiao'si	0
七不可避	qi'bu'ke'bi	0
七财	qi'cai	0
岂曾混淆	qi'ceng'hun'xiao	0
七层轮灯	qi'ceng'lun'deng	0
七常住果	qi'chang'zhu'guo	0
七处八会	qi'chu'ba'hui	0
七处善	qi'chu'shan	0
契此	qi'ci	0
七大	qi'da	0
七大寺	qi'da'si	0
七代记	qi'dai'ji	0
契丹藏	qi'dan'cang	0
祈祷	qi'dao	0
七谛	qi'di	0
七地	qi'di	0
七地沈空难	qi'di'shen'kong'nan	0
耆闍崛山	qi'du'jue'shan	0
七法	qi'fa	0
七番共解	qi'fan'gong'jie	0
七分别	qi'fen'bie	0
七分获一	qi'fen'huo'yi	0
七佛	qi'fo	0
七佛八菩萨所说大陀罗尼神咒经	qi'fo'ba'pu'sa'suo'shuo'da'tuo'luo'ni'shen'zhou'jing	0
七佛偈碑亭	qi'fo'ji'bei'ting	0
七佛灭罪真言	qi'fo'mie'zui'zhen'yan	0
七佛通戒偈	qi'fo'tong'jie'ji	0
七佛药师	qi'fo'yao'shi	0
七佛药师法	qi'fo'yao'shi'fa	0
七佛赞呗伽陀	qi'fo'zan'bai'ga'tuo	0
祈福	qi'fu	0
七福神	qi'fu'shen	0
乞丐与禅	qi'gai'yu'chan	0
七供	qi'gong	0
七归依	qi'gui'yi	0
七海	qi'hai	0
七黑山	qi'hei'shan	0
齐己	qi'ji	0
七见	qi'jian	0
七金山	qi'jin'shan	0
七净华	qi'jing'hua	0
七境界	qi'jing'jie	0
七聚	qi'ju	0
七句答	qi'ju'da	0
七俱胝独部法	qi'ju'zhi'du'bu'fa	0
七俱胝佛母所说准提陀罗尼经	qi'ju'zhi'fo'mu'suo'shuo'zhun'ti'tuo'luo'ni'jing	0
七觉士	qi'jue'shi	0
七觉支	qi'jue'zhi	0
七空	qi'kong	0
弃老国	qi'lao'guo	0
七流	qi'liu	0
七漏	qi'lou	0
七灭诤	qi'mie'zheng	0
七母天	qi'mu'tian	0
七难	qi'nan	0
骑牛觅牛	qi'niu'mi'niu	0
耆婆耆婆	qi'po'qi'po	0
齐齐哈尔大乘寺	qi'qi'ha'er'da'cheng'si	0
七七斋	qi'qi'zhai	0
祈请文	qi'qing'wen	0
七劝	qi'quan	0
七日作坛法	qi'ri'zuo'tan'fa	0
碛砂版大藏经	qi'sha'ban'da'cang'jing	0
七善	qi'shan	0
七善法	qi'shan'fa	0
七善律仪	qi'shan'lv'yi	0
七善士趣	qi'shan'shi'qu	0
旗山万佛寺	qi'shan'wan'fo'si	0
七圣	qi'sheng	0
七胜事	qi'sheng'shi	0
器世间	qi'shi'jian	0
起世经	qi'shi'jing	0
七十空性论	qi'shi'kong'xing'lun	0
七十五法	qi'shi'wu'fa	0
七识住	qi'shi'zhu	0
齐思贻	qi'si'yi	0
契嵩	qi'song	0
七塔寺	qi'ta'si	0
七塔寺志	qi'ta'si'zhi	0
七堂伽蓝	qi'tang'qie'lan	0
七条衣	qi'tiao'yi	0
七系付法传	qi'xi'fu'fa'chuan	0
栖霞寺	qi'xia'si	0
七贤	qi'xian	0
起行	qi'xing	0
七星如意轮	qi'xing'ru'yi'lun	0
奇央缄来	qi'yang'jian'lai	0
七曜	qi'yao	0
七曜星辰别行法	qi'yao'xing'chen'bie'xing'fa	0
七夜待	qi'ye'dai	0
七叶窟	qi'ye'ku	0
七叶树	qi'ye'shu	0
七因明	qi'yin'ming	0
七有	qi'you	0
七喻	qi'yu	0
祈雨	qi'yu	0
绮语	qi'yu	0
祈愿往生净土陀罗尼	qi'yuan'wang'sheng'jing'tu'tuo'luo'ni	0
七真如	qi'zhen'ru	0
七支结护	qi'zhi'jie'hu	0
七众	qi'zhong	0
七种净	qi'zhong'jing	0
七种立题	qi'zhong'li'ti	0
七种人	qi'zhong'ren	0
七种生死	qi'zhong'sheng'si	0
七转第八互为因果	qi'zhuan'di'ba'hu'wei'yin'guo	0
七转识	qi'zhuan'shi	0
恰巴	qia'ba	0
千钵经	qian'bo'jing	0
千部会	qian'bu'hui	0
浅草寺	qian'cao'si	0
虔诚的心	qian'cheng'de'xin	0
虔诚献香花	qian'cheng'xian'xiang'hua	0
千佛山	qian'fo'shan	0
千佛因缘经	qian'fo'yin'yuan'jing	0
千福寺	qian'fu'si	0
千古楷模	qian'gu'kai'mo	0
千光派	qian'guang'pai	0
钱弘俶	qian'hong'chu	0
千华派	qian'hua'pai	0
銭皇寺	qian'huang'si	0
黔南会灯录	qian'nan'hui'deng'lu	0
千崎如幻	qian'qi'ru'huan	0
千日诣	qian'ri'yi	0
前三三后三三	qian'san'san'hou'san'san	0
千僧斋	qian'seng'zhai	0
千山	qian'shan	0
前世今生	qian'shi'jin'sheng	0
前世今生真人真事	qian'shi'jin'sheng'zhen'ren'zhen'shi	0
千手观音	qian'shou'guan'yin	0
千手千眼大悲心咒行法	qian'shou'qian'yan'da'bei'xin'zhou'xing'fa	0
千手千眼觀音大悲咒	qian'shou'qian'yan'guan'yin'da'bei'zhou	0
千松笔记	qian'song'bi'ji	0
前堂	qian'tang	0
前田惠学	qian'tian'hui'xue	0
前田慧云	qian'tian'hui'yun	0
千熙	qian'xi	0
前正觉山	qian'zheng'jue'shan	0
钱智敏	qian'zhi'min	0
抢不走	qiang'bu'zou	0
强盗弟子	qiang'dao'di'zi	0
伽蓝	qie'lan	0
伽蓝神	qie'lan'shen	0
伽蓝尊者咒	qie'lan'zun'zhe'zhou	0
朅盘陀国	qie'pan'tuo'guo	0
秦皇岛市地藏寺	qin'huang'dao'shi'di'zang'si	0
亲鸾	qin'luan	0
亲情反目为哪般	qin'qing'fan'mu'wei'na'ban	0
勤行	qin'xing	0
亲与子	qin'yu'zi	0
磬	qing	0
轻安	qing'an	0
清代佛教	qing'dai'fo'jiao	0
请观世音消伏毒害陀罗尼经	qing'guan'shi'yin'xiao'fu'du'hai'tuo'luo'ni'jing	0
清规	qing'gui	0
清净庵	qing'jing'an	0
清净本然	qing'jing'ben'ran	0
清净道论	qing'jing'dao'lun	0
清静法身佛	qing'jing'fa'shen'fo	0
清觉寺	qing'jue'si	0
清利寺	qing'li'si	0
清凉寺	qing'liang'si	0
青龙寺	qing'long'si	0
青龙寺仪轨	qing'long'si'yi'gui	0
青梅子	qing'mei'zi	0
青苗会	qing'miao'hui	0
青目	qing'mu	0
庆宁寺	qing'ning'si	0
清僧与美女	qing'seng'yu'mei'nv	0
青史	qing'shi	0
清水寺	qing'shui'si	0
晴虚	qing'xu	0
清严	qing'yan	0
请益录	qing'yi'lu	0
请雨经法	qing'yu'jing'fa	0
情与无情	qing'yu'wu'qing	0
情缘	qing'yuan	0
青原下	qing'yuan'xia	0
庆云寺	qing'yun'si	0
庆昭	qing'zhao	0
庆诸	qing'zhu	0
穷生死蕴	qiong'sheng'si'yun	0
笻竹寺	qiong'zhu'si	0
求不得苦	qiu'bu'de'ku	0
求不死之火	qiu'bu'si'zhi'huo	0
丘处机	qiu'chu'ji	0
龟兹	qiu'ci	0
求法	qiu'fa	0
求那跋摩	qiu'na'ba'mo	0
求那跋陀罗	qiu'na'ba'tuo'luo	0
求那毗地	qiu'na'pi'di	0
求人不如求己	qiu'ren'bu'ru'qiu'ji	0
求闻持法	qiu'wen'chi'fa	0
秋野孝道	qiu'ye'xiao'dao	0
取	qu	0
瞿波罗龙王	qu'bo'luo'long'wang	0
曲肱斋全集	qu'gong'zhai'quan'ji	0
屈浪拏国	qu'lang'na'guo	0
佉梨	qu'li	0
佉留文	qu'liu'wen	0
曲彔	qu'lu	0
佉卢虱咤	qu'lu'shi'zha	0
瞿摩夷	qu'mo'yi	0
瞿毗霜那国	qu'pi'shuang'na'guo	0
瞿汝稷	qu'ru'ji	0
瞿师罗园	qu'shi'luo'yuan	0
屈眴布	qu'shun'bu	0
瞿昙	qu'tan	0
瞿昙弥	qu'tan'mi	0
瞿昙寺	qu'tan'si	0
瞿昙仙	qu'tan'xian	0
佉陀罗山	qu'tuo'luo'shan	0
去问他	qu'wen'ta	0
瞿夷	qu'yi	0
屈映光	qu'ying'guang	0
取蕴	qu'yun	0
劝发菩提心集	quan'fa'pu'ti'xin'ji	0
全分	quan'fen	0
全国各省寺院	quan'guo'ge'sheng'si'yuan	0
泉华严禅寺	quan'hua'yan'chan'si	0
劝人戒杀歌	quan'ren'jie'sha'ge	0
权实	quan'shi	0
劝世佛歌	quan'shi'fo'ge	0
劝修寺	quan'xiu'si	0
全哲学纲要	quan'zhe'xue'gang'yao	0
泉州天莲寺	quan'zhou'tian'lian'si	0
雀离浮图	que'li'fu'tu	0
燃灯佛	ran'deng'fo	0
燃灯会	ran'deng'hui	0
燃灯之歌	ran'deng'zhi'ge	0
染法	ran'fa	0
染净二法	ran'jing'er'fa	0
然妙	ran'miao	0
染污	ran'wu	0
染污无知	ran'wu'wu'zhi	0
染心	ran'xin	0
冉云华	ran'yun'hua	0
燃指供养	ran'zhi'gong'yang	0
让爱起飞	rang'ai'qi'fei	0
热巴巾	re'ba'jin	0
热穷巴	re'qiong'ba	0
热振寺	re'zhen'si	0
忍	ren	0
人本欲生经	ren'ben'yu'sheng'jing	0
仁达哇	ren'da'wa	0
仁恭	ren'gong	0
仁海	ren'hai	0
仁和寺	ren'he'si	0
任继愈	ren'ji'yu	0
人间	ren'jian	0
仁宽	ren'kuan	0
人面疮	ren'mian'chuang	0
仁钦桑布	ren'qin'sang'bu	0
忍辱	ren'ru	0
人生实相	ren'sheng'shi'xiang	0
壬生寺	ren'sheng'si	0
壬生台舜	ren'sheng'tai'shun	0
人生无乞丐	ren'sheng'wu'qi'gai	0
人施设论	ren'shi'she'lun	0
人天宝鉴	ren'tian'bao'jian	0
人天眼目	ren'tian'yan'mu	0
仁王护国般若波罗蜜经	ren'wang'hu'guo'bo're'bo'luo'mi'jing	0
仁王会	ren'wang'hui	0
人我法我	ren'wo'fa'wo	0
人亦当如莲	ren'yi'dang'ru'lian	0
仁勇	ren'yong	0
仁馀古寺	ren'yu'gu'si	0
人子	ren'zi	0
日奥	ri'ao	0
日本大藏经	ri'ben'da'zang'jing	0
日本佛教	ri'ben'fo'jiao	0
日本高僧传要文抄	ri'ben'gao'seng'chuan'yao'wen'chao	0
日本寺	ri'ben'si	0
日本往生极乐记	ri'ben'wang'sheng'ji'yue'ji	0
日本印度学佛教学会	ri'ben'yin'du'xue'fo'jiao'xue'hui	0
日本宗教法人法	ri'ben'zong'jiao'fa'ren'fa	0
日波益西仁波切祈请文	ri'bo'yi'xi'ren'bo'qie'qi'qing'wen	0
日称	ri'cheng	0
日光菩萨	ri'guang'pu'sa	0
日光山	ri'guang'shan	0
日讲	ri'jiang	0
日静	ri'jing	0
日莲	ri'lian	0
日莲正宗	ri'lian'zheng'zong	0
日莲宗	ri'lian'zong	0
日隆	ri'long	0
日罗	ri'luo	0
日没	ri'mei	0
日日是好日	ri'ri'shi'hao'ri	0
日什	ri'shen	0
日天	ri'tian	0
日想观	ri'xiang'guan	0
日印	ri'yin	0
日月灯明佛	ri'yue'deng'ming'fo	0
日照	ri'zhao	0
日真	ri'zhen	0
日置默仙	ri'zhi'mo'xian	0
日中	ri'zhong	0
荣枯一如	rong'ku'yi'ru	0
融通念佛宗	rong'tong'nian'fo'zong	0
荣西	rong'xi	0
肉髻相	rou'ji'xiang	0
肉身不坏	rou'shen'bu'huai	0
肉食妻带	rou'shi'qi'dai	0
入阿毗达磨论	ru'a'pi'da'mo'lun	0
入不二法门	ru'bu'er'fa'men	0
如虫御木	ru'chong'yu'mu	0
如此一棒	ru'ci'yi'bang	0
入大乘论	ru'da'cheng'lun	0
如道	ru'dao	0
入定	ru'ding	0
如果没有那只鸟	ru'guo'mei'you'na'zhi'niao	0
如何见道	ru'he'jian'dao	0
如何作人	ru'he'zuo'ren	0
如幻三昧	ru'huan'san'mei	0
如幻三摩地无量印法门经	ru'huan'san'mo'di'wu'liang'yin'fa'men'jing	0
如净	ru'jing	0
入就瑞白禅师语录	ru'jiu'rui'bai'chan'shi'yu'lu	0
如空	ru'kong	0
如来藏	ru'lai'cang	0
如来禅	ru'lai'chan	0
如来十恩	ru'lai'shi'en	0
如来十号	ru'lai'shi'hao	0
入菩萨行论	ru'pu'sa'xing'lun	0
如实观	ru'shi'guan	0
如实论	ru'shi'lun	0
如是我闻	ru'shi'wo'wen	0
如是语经	ru'shi'yu'jing	0
入唐求法巡礼行记	ru'tang'qiu'fa'xun'li'xing'ji	0
入我我入	ru'wo'wo'ru	0
如悟	ru'wu	0
如馨	ru'xin	0
如学	ru'xue	0
如一	ru'yi	0
如意宝轮王陀罗尼	ru'yi'bao'lun'wang'tuo'luo'ni	0
如意宝树史	ru'yi'bao'shu'shi	0
如意轮观音	ru'yi'lun'guan'yin	0
如意轮寺	ru'yi'lun'si	0
如意轮咒	ru'yi'lun'zhou	0
如意通	ru'yi'tong	0
入藏	ru'zang	0
入中论	ru'zhong'lun	0
入众日用清规	ru'zhong'ri'yong'qing'gui	0
瑞大光塔	rui'da'guang'ta	0
叡福寺	rui'fu'si	0
瑞光塔	rui'guang'ta	0
瑞景派	rui'jing'pai	0
瑞丽姐勒金塔	rui'li'jie'le'jin'ta	0
叡山学院	rui'shan'xue'yuan	0
瑞巖寺	rui'yan'si	0
蕤耶经	rui'ye'jing	0
叡尊	rui'zun	0
若芬	ruo'fen	0
若那毗沙陀闍	ruo'na'pi'sha'tuo'du	0
萨埵	sa'duo	0
萨迦班禅	sa'jia'ban'chan	0
萨迦格言	sa'jia'ge'yan	0
萨迦派	sa'jia'pai	0
萨迦寺	sa'jia'si	0
萨迦耶见	sa'jia'ye'jian	0
洒净	sa'jing	0
萨婆若	sa'po'ruo	0
萨他泥湿伐罗国	sa'ta'ni'shi'fa'luo'guo	0
萨陀波伦菩萨	sa'tuo'bo'lun'pu'sa	0
三拜	san'bai	0
三宝	san'bao	0
三宝感通录	san'bao'gan'tong'lu	0
三宝感应要略录	san'bao'gan'ying'yao'lve'lu	0
三宝歌	san'bao'ge	0
三宝物	san'bao'wu	0
三宝院	san'bao'yuan	0
三钵罗佉多	san'bo'luo'qu'duo	0
三部	san'bu	0
三部大法	san'bu'da'fa	0
三车四车	san'che'si'che	0
三乘	san'cheng	0
三乘方便	san'cheng'fang'bian	0
三祇百劫	san'chi'bai'jie	0
三大	san'da	0
三大阿僧祇劫	san'da'a'seng'chi'jie	0
三大部	san'da'bu	0
三大祕法	san'da'mi'fa	0
三大祕法禀承事	san'da'mi'fa'bing'cheng'shi	0
三道宝阶	san'dao'bao'jie	0
三德	san'de	0
三谛	san'di	0
三毒	san'du	0
三法度论	san'fa'du'lun	0
三法印	san'fa'yin	0
三分科经	san'fen'ke'jing	0
三峰藏和尚语录	san'feng'cang'he'shang'yu'lu	0
三峰派	san'feng'pai	0
三佛寺	san'fo'si	0
三福	san'fu	0
三纲	san'gang	0
三根	san'gen	0
三钴钩	san'gu'gou	0
三观	san'guan	0
三关	san'guan	0
三光天子	san'guang'tian'zi	0
三归依	san'gui'yi	0
三皈依	san'gui'yi	0
三国佛法传通缘起	san'guo'fo'fa'chuan'tong'yuan'qi	0
三国佛教	san'guo'fo'jiao	0
三国遗事	san'guo'yi'shi	0
三慧	san'hui	0
三际时	san'ji'shi	0
三迦叶	san'jia'ye	0
三件古董	san'jian'gu'dong	0
三教合一论	san'jiao'he'yi'lun	0
三教论衡	san'jiao'lun'heng	0
三教平心论	san'jiao'ping'xin'lun	0
三教指归	san'jiao'zhi'gui	0
三界	san'jie	0
三结	san'jie	0
三阶教	san'jie'jiao	0
三阶教研究	san'jie'jiao'yan'jiu	0
三界论	san'jie'lun	0
三解脱门	san'jie'tuo'men	0
三界唯心	san'jie'wei'xin	0
三经一论	san'jing'yi'lun	0
三经义疏	san'jing'yi'shu	0
三聚净戒	san'ju'jing'jie	0
三康文化研究所	san'kang'wen'hua'yan'jiu'suo	0
三科	san'ke	0
三科拣境	san'ke'jian'jing	0
三类境	san'lei'jing	0
三量	san'liang	0
三漏	san'lou	0
散乱	san'luan	0
三论	san'lun	0
三轮身	san'lun'shen	0
三轮体空	san'lun'ti'kong	0
三论玄义	san'lun'xuan'yi	0
三论宗	san'lun'zong	0
三脉七轮	san'mai'qi'lun	0
三昧	san'mei	0
三昧耶戒	san'mei'ye'jie	0
三昧耶曼荼罗	san'mei'ye'man'tu'luo	0
三昧耶形	san'mei'ye'xing	0
三门徒	san'men'tu	0
三密	san'mi	0
三弥底部论	san'mi'di'bu'lun	0
三密加持	san'mi'jia'chi	0
三祕密身	san'mi'mi'shen	0
三明	san'ming	0
三摩钵底	san'mo'bo'di	0
三摩多	san'mo'duo	0
三默堂	san'mo'tang	0
三能变	san'neng'bian	0
三平等观	san'ping'deng'guan	0
三平寺	san'ping'si	0
三菩提	san'pu'ti	0
三千大千世界	san'qian'da'qian'shi'jie	0
三千威仪	san'qian'wei'yi	0
三千院	san'qian'yuan	0
三三昧	san'san'mei	0
三三昧耶	san'san'mei'ye	0
三身	san'shen	0
三身成道	san'shen'cheng'dao	0
三圣禅寺	san'sheng'chan'si	0
三生成佛	san'sheng'cheng'fo	0
三圣圆融观	san'sheng'yuan'rong'guan	0
三圣圆融观门	san'sheng'yuan'rong'guan'men	0
三识	san'shi	0
三世	san'shi	0
三时	san'shi	0
三士道	san'shi'dao	0
三十二相	san'shi'er'xiang	0
三时教	san'shi'jiao	0
三十六部神王	san'shi'liu'bu'shen'wang	0
三十七菩提分法	san'shi'qi'pu'ti'fen'fa	0
三师七证	san'shi'qi'zheng	0
三十日佛名	san'shi'ri'fo'ming	0
三十三过	san'shi'san'guo	0
三十三间堂	san'shi'san'jian'tang	0
三世实有	san'shi'shi'you	0
三十帖策子	san'shi'tie'ce'zi	0
三十五佛	san'shi'wu'fo	0
三时系念仪范	san'shi'xi'nian'yi'fan	0
三时学会	san'shi'xue'hui	0
三世因果	san'shi'yin'guo	0
三世因果歌	san'shi'yin'guo'ge	0
三世因果经	san'shi'yin'guo'jing	0
三时知恩寺	san'shi'zhi'en'si	0
三世诸佛	san'shi'zhu'fo	0
三素尔	san'su'er	0
三坛传戒正范	san'tan'chuan'jie'zheng'fan	0
三土	san'tu	0
三涂	san'tu	0
三途河	san'tu'he	0
三无性	san'wu'xing	0
三无性论	san'wu'xing'lun	0
三武一宗法难	san'wu'yi'zong'fa'nan	0
三细六粗	san'xi'liu'cu	0
三贤十圣	san'xian'shi'sheng	0
三心不可得	san'xin'bu'ke'de	0
三性	san'xing	0
三性对望中道	san'xing'dui'wang'zhong'dao	0
三学	san'xue	0
三验	san'yan	0
三业	san'ye	0
三业惑乱	san'ye'huo'luan	0
三衣	san'yi	0
三衣一钵	san'yi'yi'bo	0
三有	san'you	0
三缘山轮藏目录	san'yuan'shan'lun'cang'mu'lu	0
三灾	san'zai	0
三藏	san'zang	0
三斋	san'zhai	0
三障	san'zhang	0
三智	san'zhi	0
三枝充德	san'zhi'chong'de	0
三支作法	san'zhi'zuo'fa	0
三种人	san'zhong'ren	0
三转读文	san'zhuan'du'wen	0
三转法轮	san'zhuan'fa'lun	0
三转法轮经	san'zhuan'fa'lun'jing	0
三转十二行相	san'zhuan'shi'er'xing'xiang	0
三自性论	san'zi'xing'lun	0
三宗	san'zong	0
三尊佛	san'zun'fo	0
桑浦寺	sang'pu'si	0
桑耶寺	sang'ye'si	0
桑耶宗论	sang'ye'zong'lun	0
扫树叶的小和尚	sao'shu'ye'de'xiao'he'shang	0
色	se	0
色即是空	se'ji'shi'kong	0
色界	se'jie	0
色究竟天	se'jiu'jing'tian	0
色具三千	se'ju'san'qian	0
色拉寺	se'la'si	0
色量	se'liang	0
色身	se'shen	0
色蕴	se'yun	0
森林书	sen'lin'shu	0
僧兵	seng'bing	0
僧残	seng'can	0
僧璨	seng'can	0
僧祇户	seng'chi'hu	0
僧祇支	seng'chi'zhi	0
僧稠	seng'chou	0
僧传	seng'chuan	0
僧导	seng'dao	0
僧伽	seng'ga	0
僧伽跋澄	seng'ga'ba'cheng	0
僧伽跋摩	seng'ga'ba'mo	0
僧伽跋陀罗	seng'ga'ba'tuo'luo	0
僧伽梨	seng'ga'li	0
僧伽罗剎	seng'ga'luo'cha	0
僧伽罗剎所集经	seng'ga'luo'cha'suo'ji'jing	0
僧伽蜜多	seng'ga'mi'duo	0
僧伽婆罗	seng'ga'po'luo	0
僧伽提婆	seng'ga'ti'po	0
僧官制度	seng'guan'zhi'du	0
僧籍	seng'ji	0
僧濬	seng'jun	0
僧科	seng'ke	0
僧朗	seng'lang	0
僧旻	seng'min	0
僧诠	seng'quan	0
僧人与虱子	seng'ren'yu'shi'zi	0
僧叡	seng'rui	0
僧物	seng'wu	0
僧祐	seng'you	0
僧肇	seng'zhao	0
莎车国	sha'che'guo	0
莎昆妲罗	sha'kun'da'luo	0
沙门不敬王者论	sha'men'bu'jing'wang'zhe'lun	0
沙门果经	sha'men'guo'jing	0
沙弥	sha'mi	0
沙弥戒	sha'mi'jie	0
沙弥尼	sha'mi'ni	0
沙弥问答	sha'mi'wen'da	0
沙摩吠陀	sha'mo'fei'tuo	0
杀生戒	sha'sheng'jie	0
晒海苔	shai'hai'tai	0
善	shan	0
山边习学	shan'bian'xi'xue	0
善导寺	shan'dao'si	0
山迪阿输克运动	shan'di'a'shu'ke'yun'dong	0
山顶大笑	shan'ding'da'xiao	0
删定四分僧戒本	shan'ding'si'fen'seng'jie'ben	0
删定止观	shan'ding'zhi'guan	0
善恶相知	shan'e'xiang'zhi	0
山芳卡玛哈耶尼康	shan'fang'ka'ma'ha'ye'ni'kang	0
山伏	shan'fu	0
善福寺	shan'fu'si	0
山冈铁舟	shan'gang'tie'zhou	0
善根	shan'gen	0
山谷寺	shan'gu'si	0
山海关地藏寺	shan'hai'guan'di'zang'si	0
山号	shan'hao	0
善化寺	shan'hua'si	0
善慧	shan'hui	0
山家	shan'jia	0
山家学生式	shan'jia'xue'sheng'shi	0
山家义苑	shan'jia'yi'yuan	0
善见城	shan'jian'cheng	0
善见律毗婆沙	shan'jian'lv'pi'po'sha	0
山口瑞凤	shan'kou'rui'feng	0
山口益	shan'kou'yi	0
善来	shan'lai	0
善良中的自私	shan'liang'zhong'de'zi'si	0
山门	shan'men	0
善女人传	shan'nv'ren'chuan	0
善女天咒	shan'nv'tian'zhou	0
山崎	shan'qi	0
山崎闇斋	shan'qi'an'zhai	0
山崎宏	shan'qi'hong	0
善巧方便	shan'qiao'fang'bian	0
善世院	shan'shi'yuan	0
善书	shan'shu	0
山田龙城	shan'tian'long'cheng	0
珊陀那	shan'tuo'na	0
山外	shan'wai	0
山王曼荼罗	shan'wang'man'tu'luo	0
山王权现	shan'wang'quan'xian	0
山西大同市南郊区观音禅寺	shan'xi'da'tong'shi'nan'jiao'qu'guan'yin'chan'si	0
山西省大同市南郊区观音禅寺	shan'xi'sheng'da'tong'shi'nan'jiao'qu'guan'yin'chan'si	0
山西省怀仁县天竺禅寺	shan'xi'sheng'huai'ren'xian'tian'zhu'chan'si	0
山西省罗睺寺	shan'xi'sheng'luo'hou'si	0
山西省盂县永清寺	shan'xi'sheng'yu'xian'yong'qing'si	0
剡溪石佛	shan'xi'shi'fo	0
山西小院	shan'xi'xiao'yuan	0
山西阳泉圣泉寺	shan'xi'yang'quan'sheng'quan'si	0
善因寺	shan'yin'si	0
善哉	shan'zai	0
善知识	shan'zhi'shi	0
上厕法	shang'ce'fa	0
尚聪	shang'cong	0
上宫皇太子菩萨传	shang'gong'huang'tai'zi'pu'sa'chuan	0
上宫圣德法王帝说	shang'gong'sheng'de'fa'wang'di'shuo	0
上海佛学书局	shang'hai'fo'xue'shu'ju	0
上海龙华古寺	shang'hai'long'hua'gu'si	0
伤害与宽恕	shang'hai'yu'kuan'shu	0
上杭县圆通山圆通寺	shang'hang'xian'yuan'tong'shan'yuan'tong'si	0
上蓝顺	shang'lan'shun	0
上求下化	shang'qiu'xia'hua	0
上山大峻	shang'shan'da'jun	0
上师相应法	shang'shi'xiang'ying'fa	0
上堂	shang'tang	0
上田天瑞	shang'tian'tian'rui	0
上田义文	shang'tian'yi'wen	0
上下华严寺	shang'xia'hua'yan'si	0
上下密院	shang'xia'mi'yuan	0
尚贤	shang'xian	0
上行菩萨	shang'xing'pu'sa	0
尚彦	shang'yan	0
尚有一诀	shang'you'yi'jue	0
上院寺	shang'yuan'si	0
尚直编	shang'zhi'bian	0
上座	shang'zuo	0
上座部	shang'zuo'bu	0
上座何在	shang'zuo'he'zai	0
少光天	shao'guang'tian	0
少净天	shao'jing'tian	0
少康	shao'kang	0
少林寺	shao'lin'si	0
少善根	shao'shan'gen	0
少室六门集	shao'shi'liu'men'ji	0
少室逸书	shao'shi'yi'shu	0
少欲知足	shao'yu'zhi'zu	0
韶州法海	shao'zhou'fa'hai	0
舍	she	0
摄阿毗达磨义论	she'a'pi'da'mo'yi'lun	0
摄大乘论	she'da'cheng'lun	0
舌根	she'gen	0
舍戒	she'jie	0
奢羯罗城	she'jie'luo'cheng	0
舍利	she'li	0
舍利弗	she'li'fu	0
舍利弗阿毗昙论	she'li'fu'a'pi'tan'lun	0
舍利弗问经	she'li'fu'wen'jing	0
摄论师	she'lun'shi	0
摄取	she'qu	0
舍身	she'shen	0
舍世派	she'shi'pai	0
舍卫城	she'wei'cheng	0
攝心寺	she'xin'si	0
摄真实论	she'zhen'shi'lun	0
深不可测	shen'bu'ke'ce	0
神佛分离	shen'fo'fen'li	0
神佛习合	shen'fo'xi'he	0
身根	shen'gen	0
神宫寺	shen'gong'si	0
神护寺	shen'hu'si	0
什么冤仇	shen'me'yuan'chou	0
神灭论之争	shen'mie'lun'zhi'zheng	0
神农尝茶	shen'nong'chang'cha	0
神僧传	shen'seng'chuan	0
深沙大将	shen'sha'da'jiang	0
甚深观	shen'shen'guan	0
神圣的生活	shen'sheng'de'sheng'huo	0
身识	shen'shi	0
申书文	shen'shu'wen	0
神通	shen'tong	0
神通寺	shen'tong'si	0
审祥	shen'xiang	0
身心自在	shen'xin'zi'zai	0
沈阳般若寺	shen'yang'bo're'si	0
沈阳广福寺	shen'yang'guang'fu'si	0
沈阳龙泉寺	shen'yang'long'quan'si	0
身业	shen'ye	0
神智协会	shen'zhi'xie'hui	0
神子族	shen'zi'zu	0
生	sheng	0
省常	sheng'chang	0
圣朝破邪集	sheng'chao'po'xie'ji	0
声尘得道	sheng'chen'de'dao	0
胜持寺	sheng'chi'si	0
生得	sheng'de	0
生得善	sheng'de'shan	0
圣德太子	sheng'de'tai'zi	0
胜法寂忿意自解脱	sheng'fa'ji'fen'yi'zi'jie'tuo	0
生饭	sheng'fan	0
生佛一如	sheng'fo'yi'ru	0
生活的层面	sheng'huo'de'ceng'mian	0
生即无生	sheng'ji'wu'sheng	0
圣教量	sheng'jiao'liang	0
圣教序	sheng'jiao'xu	0
胜解	sheng'jie	0
圣解脱军	sheng'jie'tuo'jun	0
圣开	sheng'kai	0
胜林院	sheng'lin'yuan	0
胜论	sheng'lun	0
胜鬘经	sheng'man'jing	0
生灭	sheng'mie	0
生灭门	sheng'mie'men	0
声明	sheng'ming	0
生命的禮物	sheng'ming'de'li'wu	0
生命的实现	sheng'ming'de'shi'xian	0
省念	sheng'nian	0
圣泉寺	sheng'quan'si	0
圣寿寺	sheng'shou'si	0
生死	sheng'si	0
生死即涅槃	sheng'si'ji'nie'pan	0
生死由他	sheng'si'you'ta	0
生天	sheng'tian	0
胜天王般若波罗蜜经	sheng'tian'wang'bo're'bo'luo'mi'jing	0
声闻	sheng'wen	0
圣武天皇	sheng'wu'tian'huang	0
生像	sheng'xiang	0
生相	sheng'xiang	0
圣严	sheng'yan	0
胜义	sheng'yi	0
圣印	sheng'yin	0
圣勇	sheng'yong	0
圣佑寺	sheng'you'si	0
生圆二次第	sheng'yuan'er'ci'di	0
圣源寺	sheng'yuan'si	0
胜者时鬘	sheng'zhe'shi'man	0
声字实相义	sheng'zi'shi'xiang'yi	0
胜宗十句义论	sheng'zong'shi'ju'yi'lun	0
陞座	sheng'zuo	0
识	shi	0
师	shi	0
十八不共法	shi'ba'bu'gong'fa	0
十八大经	shi'ba'da'jing	0
十八界	shi'ba'jie	0
十八空	shi'ba'kong	0
十八空论	shi'ba'kong'lun	0
十八罗汉	shi'ba'luo'han	0
十八契印	shi'ba'qi'yin	0
十八神变	shi'ba'shen'bian	0
十八檀林	shi'ba'tan'lin	0
十八物	shi'ba'wu	0
十八意近行	shi'ba'yi'jin'xing	0
十八有学	shi'ba'you'xue	0
十八圆满	shi'ba'yuan'man	0
施比受幸福	shi'bi'shou'xing'fu	0
十遍处	shi'bian'chu	0
十波罗蜜	shi'bo'luo'mi	0
十不二门	shi'bu'er'men	0
十不二门指要钞	shi'bu'er'men'zhi'yao'chao	0
式叉摩那	shi'cha'mo'na	0
实叉难陀	shi'cha'nan'tuo	0
释禅波罗蜜次第法门	shi'chan'bo'luo'mi'ci'di'fa'men	0
世诚	shi'cheng	0
十乘观法	shi'cheng'guan'fa	0
十重戒	shi'chong'jie	0
十重禁戒	shi'chong'jin'jie	0
十重唯识	shi'chong'wei'shi	0
矢吹庆辉	shi'chui'qing'hui	0
十大寺	shi'da'si	0
十大愿	shi'da'yuan	0
示导	shi'dao	0
拾得	shi'de	0
十地	shi'di	0
师弟	shi'di	0
十地寄报	shi'di'ji'bao	0
十地经论	shi'di'jing'lun	0
十地经论义记	shi'di'jing'lun'yi'ji	0
十殿阎罗	shi'dian'yan'luo	0
十定	shi'ding	0
室町佛教	shi'ding'fo'jiao	0
史都拉跋得罗	shi'dou'la'ba'de'luo	0
施饿鬼会	shi'e'gui'hui	0
十二处	shi'er'chu	0
十二恶律仪	shi'er'e'lv'yi	0
十二分教	shi'er'fen'jiao	0
十二宫	shi'er'gong	0
十二类生	shi'er'lei'sheng	0
十二门论	shi'er'men'lun	0
十二门论疏	shi'er'men'lun'shu	0
十二神将	shi'er'shen'jiang	0
十二兽	shi'er'shou	0
十二天	shi'er'tian	0
十二头陀行	shi'er'tou'tuo'xing	0
十二缘起	shi'er'yuan'qi	0
十二缘生祥瑞经	shi'er'yuan'sheng'xiang'rui'jing	0
十法界钞	shi'fa'jie'chao	0
十法行	shi'fa'xing	0
十佛	shi'fo	0
石佛	shi'fo	0
十佛名	shi'fo'ming	0
师父腿子	shi'fu'tui'zi	0
师姑是女人	shi'gu'shi'nv'ren	0
士珪	shi'gui	0
十行	shi'hang	0
师号	shi'hao	0
十后悔	shi'hou'hui	0
施护	shi'hu	0
十回向	shi'hui'xiang	0
诗偈论道	shi'ji'lun'dao	0
释迦法	shi'jia'fa	0
释迦方志	shi'jia'fang'zhi	0
尸迦罗越六方礼经	shi'jia'luo'yue'liu'fang'li'jing	0
释迦牟尼佛教化的一生	shi'jia'mou'ni'fo'jiao'hua'de'yi'sheng	0
释迦牟尼佛灭一切恶趣王咒	shi'jia'mou'ni'fo'mie'yi'qie'e'qu'wang'zhou	0
释迦牟尼佛祈请及圣号	shi'jia'mou'ni'fo'qi'qing'ji'sheng'hao	0
释迦牟尼佛心咒	shi'jia'mou'ni'fo'xin'zhou	0
释迦牟尼如来像法灭尽之记	shi'jia'mou'ni'ru'lai'xiang'fa'mie'jin'zhi'ji	0
释迦谱	shi'jia'pu	0
石家庄市桥西区东良厢三圣寺	shi'jia'zhuang'shi'qiao'xi'qu'dong'liang'xiang'san'sheng'si	0
世间	shi'jian	0
时间的河	shi'jian'de'he	0
时间和爱的故事	shi'jian'he'ai'de'gu'shi	0
世间相违过	shi'jian'xiang'wei'guo	0
示教利喜	shi'jiao'li'xi	0
世界	shi'jie	0
十戒	shi'jie	0
十界	shi'jie	0
世界佛教青年会	shi'jie'fo'jiao'qing'nian'hui	0
世界佛教徒友谊会	shi'jie'fo'jiao'tu'you'yi'hui	0
世界海	shi'jie'hai	0
十界互具	shi'jie'hu'ju	0
时解脱	shi'jie'tuo	0
世界宗教研究所	shi'jie'zong'jiao'yan'jiu'suo	0
世界宗教研究院	shi'jie'zong'jiao'yan'jiu'yuan	0
石经	shi'jing	0
试经度僧	shi'jing'du'seng	0
十九执金刚	shi'jiu'zhi'jin'gang	0
始觉	shi'jue	0
石窟庵	shi'ku'an	0
石窟寺	shi'ku'si	0
石窟寺院	shi'ku'si'yuan	0
十力	shi'li	0
室利佛逝	shi'li'fo'shi	0
室利笈多	shi'li'ji'duo	0
室利逻多	shi'li'luo'duo	0
尸利沙树	shi'li'sha'shu	0
释量论	shi'liang'lun	0
十六大国	shi'liu'da'guo	0
十六观	shi'liu'guan	0
十六罗汉	shi'liu'luo'han	0
十六特胜观	shi'liu'te'sheng'guan	0
十六行相	shi'liu'xing'xiang	0
十六执金刚	shi'liu'zhi'jin'gang	0
时轮乘	shi'lun'cheng	0
时轮怛特罗	shi'lun'da'te'luo	0
时轮金刚法	shi'lun'jin'gang'fa	0
时轮金刚心咒	shi'lun'jin'gang'xin'zhou	0
十罗剎女	shi'luo'cha'nv	0
失落地平线	shi'luo'di'ping'xian	0
十门辩惑论	shi'men'bian'huo'lun	0
释门归敬仪	shi'men'gui'jing'yi	0
石门文字禅	shi'men'wen'zi'chan	0
释门章服仪	shi'men'zhang'fu'yi	0
释门正统	shi'men'zheng'tong	0
十明	shi'ming	0
释摩诃般若波罗蜜经觉意三昧	shi'mo'he'bo're'bo'luo'mi'jing'jue'yi'san'mei	0
释摩诃衍论	shi'mo'he'yan'lun	0
十念	shi'nian	0
失念	shi'nian	0
十念处	shi'nian'chu	0
十念业成	shi'nian'ye'cheng	0
十牛图	shi'niu'tu	0
石女	shi'nv	0
尸毗王	shi'pi'wang	0
湿婆	shi'po	0
十普寺	shi'pu'si	0
尸弃大梵	shi'qi'da'fan	0
尸弃佛	shi'qi'fo	0
十七条宪法	shi'qi'tiao'xian'fa	0
世亲	shi'qin	0
十如是	shi'ru'shi	0
十三事法	shi'san'shi'fa	0
十三遮难	shi'san'zhe'nan	0
十三资具衣	shi'san'zi'ju'yi	0
十善	shi'shan	0
石山本愿寺	shi'shan'ben'yuan'si	0
十善法语	shi'shan'fa'yu	0
石山合战	shi'shan'he'zhan	0
十善会	shi'shan'hui	0
十善业道经	shi'shan'ye'dao'jing	0
施设足论	shi'she'zu'lun	0
十身	shi'shen	0
施身法修持仪轨	shi'shen'fa'xiu'chi'yi'gui	0
识身足论	shi'shen'zu'lun	0
十胜行	shi'sheng'xing	0
释氏	shi'shi	0
食时	shi'shi	0
十世	shi'shi	0
十师	shi'shi	0
施食	shi'shi	0
事师法五十颂	shi'shi'fa'wu'shi'song	0
十事非法	shi'shi'fei'fa	0
释氏稽古略	shi'shi'ji'gu'lve	0
十事开示	shi'shi'kai'shi	0
释氏六帖	shi'shi'liu'tie	0
释氏通鉴	shi'shi'tong'jian	0
释氏要览	shi'shi'yao'lan	0
石霜楚圆禅师语录	shi'shuang'chu'yuan'chan'shi'yu'lu	0
氏寺	shi'si	0
十四变化心	shi'si'bian'hua'xin	0
十四根本堕	shi'si'gen'ben'duo	0
十四过类	shi'si'guo'lei	0
十四无记	shi'si'wu'ji	0
十诵律	shi'song'lv	0
世俗	shi'su	0
石泰安	shi'tai'an	0
石涛	shi'tao	0
石头路滑	shi'tou'lu'hua	0
狮头山	shi'tou'shan	0
石头狮吼	shi'tou'shi'hou	0
十万白龙	shi'wan'bai'long	0
十万歌颂	shi'wan'ge'song	0
十王	shi'wang	0
识无边处天	shi'wu'bian'chu'tian	0
石屋珙禅师语录	shi'wu'gong'chan'shi'yu'lu	0
十无尽藏	shi'wu'jin'cang	0
施无畏	shi'wu'wei	0
十五尊	shi'wu'zun	0
实贤	shi'xian	0
事相	shi'xiang	0
实相	shi'xiang	0
十小咒	shi'xiao'zhou	0
是邪是正	shi'xie'shi'zheng	0
十信	shi'xin	0
始兴宗	shi'xing'zong	0
十玄	shi'xuan	0
施药院	shi'yao'yuan	0
十业道	shi'ye'dao	0
十夜法要	shi'ye'fa'yao	0
释业障	shi'ye'zhang	0
失译经	shi'yi'jing	0
十一面观音	shi'yi'mian'guan'yin	0
十一面观音根本咒	shi'yi'mian'guan'yin'gen'ben'zhou	0
世友	shi'you	0
世愚	shi'yu	0
十喻观	shi'yu'guan	0
誓愿	shi'yuan	0
十圆满	shi'yuan'man	0
十斋	shi'zhai	0
侍者	shi'zhe	0
释种	shi'zhong	0
石钟山石窟	shi'zhong'shan'shi'ku	0
十种衣	shi'zhong'yi	0
十住	shi'zhu	0
十住毗婆沙论	shi'zhu'pi'po'sha'lun	0
十住心	shi'zhu'xin	0
十住心论	shi'zhu'xin'lun	0
食子	shi'zi	0
师子奋迅三昧	shi'zi'fen'xun'san'mei	0
师子吼	shi'zi'hou	0
狮子林	shi'zi'lin	0
师子山派	shi'zi'shan'pai	0
虱子是什么做	shi'zi'shi'shen'me'zuo	0
虱子是什么做的	shi'zi'shi'shen'me'zuo'de	0
世自在王佛	shi'zi'zai'wang'fo	0
师子座	shi'zi'zuo	0
时宗	shi'zong	0
石嘴山银善寺	shi'zui'shan'yin'shan'si	0
世尊的诞生到涅槃	shi'zun'de'dan'sheng'dao'nie'pan	0
释尊的故事	shi'zun'de'gu'shi	0
释尊物语	shi'zun'wu'yu	0
受	shou	0
守初	shou'chu	0
守端	shou'duan	0
守端失眠	shou'duan'shi'mian	0
守护大千国土经	shou'hu'da'qian'guo'tu'jing	0
守护国界章	shou'hu'guo'jie'zhang	0
守护国界主陀罗尼经	shou'hu'guo'jie'zhu'tuo'luo'ni'jing	0
守护经法	shou'hu'jing'fa	0
授记	shou'ji	0
受戒	shou'jie	0
手巾	shou'jin	0
守觉	shou'jue	0
首楞严三昧经	shou'leng'yan'san'mei'jing	0
寿量	shou'liang	0
寿宁寺	shou'ning'si	0
守培	shou'pei	0
受菩萨戒仪	shou'pu'sa'jie'yi	0
受菩提心戒仪	shou'pu'ti'xin'jie'yi	0
受日法	shou'ri'fa	0
受体	shou'ti	0
守脱	shou'tuo	0
守温	shou'wen	0
狩野芳崖	shou'ye'fang'ya	0
狩野元信	shou'ye'yuan'xin	0
受用身	shou'yong'shen	0
受用土	shou'yong'tu	0
首愚	shou'yu	0
寿尊	shou'zun	0
首座	shou'zuo	0
疏勒国	shu'le'guo	0
数论	shu'lun	0
树提伽	shu'ti'ga	0
数息观	shu'xi'guan	0
殊像寺	shu'xiang'si	0
竖义	shu'yi	0
输与赢	shu'yu'ying	0
数珠	shu'zhu	0
双林傅翕	shuang'lin'fu'xi	0
双林寺	shuang'lin'si	0
双论	shuang'lun	0
双塔寺	shuang'ta'si	0
双溪寺	shuang'xi'si	0
霜月会	shuang'yue'hui	0
水车原理	shui'che'yuan'li	0
谁的罪过	shui'de'zui'guo	0
水观	shui'guan	0
水晶镜	shui'jing'jing	0
睡莲	shui'lian	0
水玲珑	shui'ling'long	0
水琉璃	shui'liu'li	0
水陆法会	shui'lu'fa'hui	0
水宁寺摩崖造像	shui'ning'si'mo'ya'zao'xiang	0
谁去主持	shui'qu'zhu'chi	0
谁是禅师	shui'shi'chan'shi	0
谁是后人	shui'shi'hou'ren	0
谁束缚汝	shui'shu'fu'ru	0
水天	shui'tian	0
水想观	shui'xiang'guan	0
谁醒谁狂	shui'xing'shui'kuang	0
水野弘元	shui'ye'hong'yuan	0
水野梅晓	shui'ye'mei'xiao	0
水月	shui'yue	0
水月观音	shui'yue'guan'yin	0
水葬	shui'zang	0
谁知道你	shui'zhi'dao'ni	0
瞬目视伊	shun'mu'shi'yi	0
顺其自然	shun'qi'zi'ran	0
顺三分善	shun'san'fen'shan	0
顺缘	shun'yuan	0
顺正理论	shun'zheng'li'lun	0
顺中论	shun'zhong'lun	0
说出世部	shuo'chu'shi'bu	0
说粗说细	shuo'cu'shuo'xi	0
说法	shuo'fa	0
说假部	shuo'jia'bu	0
说究竟法	shuo'jiu'jing'fa	0
说通	shuo'tong	0
说一切有部	shuo'yi'qie'you'bu	0
思	si	0
死	si	0
四阿含经	si'a'han'jing	0
四安乐行	si'an'le'xing	0
四百论	si'bai'lun	0
四百四病	si'bai'si'bing	0
寺本婉雅	si'ben'wan'ya	0
四臂观音六字大明咒	si'bi'guan'yin'liu'zi'da'ming'zhou	0
似比量	si'bi'liang	0
四波罗夷法	si'bo'luo'yi'fa	0
四不成过	si'bu'cheng'guo	0
四不定	si'bu'ding	0
四不思议	si'bu'si'yi	0
四藏	si'cang	0
四禅	si'chan	0
四禅天	si'chan'tian	0
四尘	si'chen	0
四乘观智	si'cheng'guan'zhi	0
四重出体	si'chong'chu'ti	0
四重二谛	si'chong'er'di	0
四大	si'da	0
四大河	si'da'he	0
四大节	si'da'jie	0
四大名山	si'da'ming'shan	0
四大声闻	si'da'sheng'wen	0
四道	si'dao	0
四德	si'de	0
四谛	si'di	0
四谛论	si'di'lun	0
四度加行	si'du'jia'xing	0
四轭	si'e	0
四恶道	si'e'dao	0
四恩	si'en	0
死而复活	si'er'fu'huo	0
嗣法	si'fa	0
四法界	si'fa'jie	0
四法三愿	si'fa'san'yuan	0
四吠陀	si'fei'tuo	0
四分	si'fen	0
四分律	si'fen'lv	0
四分律含注戒本	si'fen'lv'han'zhu'jie'ben	0
四分律开宗记	si'fen'lv'kai'zong'ji	0
四分律删补随机羯磨	si'fen'lv'shan'bu'sui'ji'jie'mo	0
四分律疏	si'fen'lv'shu	0
四分律行事钞	si'fen'lv'xing'shi'chao	0
四分律行事钞资持记	si'fen'lv'xing'shi'chao'zi'chi'ji	0
四分僧戒本	si'fen'seng'jie'ben	0
四佛	si'fo	0
寺格	si'ge	0
四箇格言	si'ge'ge'yan	0
四个老婆	si'ge'lao'po	0
寺格帐	si'ge'zhang	0
四归依	si'gui'yi	0
寺号	si'hao	0
四弘誓愿	si'hong'shi'yuan	0
寺户	si'hu	0
四欢喜	si'huan'xi	0
四记答	si'ji'da	0
四级灌顶	si'ji'guan'ding	0
寺家	si'jia	0
四加行	si'jia'xing	0
四家语录	si'jia'yu'lu	0
四见	si'jian	0
四教	si'jiao	0
四教四门	si'jiao'si'men	0
四教义	si'jiao'yi	0
四劫	si'jie	0
四净定	si'jing'ding	0
四句百非	si'ju'bai'fei	0
四句分别	si'ju'fen'bie	0
司空山	si'kong'shan	0
死苦	si'ku	0
思量不思量	si'liang'bu'si'liang	0
四料简	si'liao'jian	0
寺领	si'ling	0
丝路	si'lu	0
四论	si'lun	0
四论派	si'lun'pai	0
四律五论	si'lv'wu'lun	0
司马达等	si'ma'da'deng	0
四曼相大	si'man'xiang'da	0
四曼相即	si'man'xiang'ji	0
四门	si'men	0
寺门	si'men	0
四门塔	si'men'ta	0
四门游观	si'men'you'guan	0
司命	si'ming	0
四明派	si'ming'pai	0
四明山	si'ming'shan	0
四明十义书	si'ming'shi'yi'shu	0
四明尊者教行录	si'ming'zun'zhe'jiao'xing'lu	0
四魔	si'mo	0
四难	si'nan	0
似能破	si'neng'po	0
四念处	si'nian'chu	0
思念的故事	si'nian'de'gu'shi	0
寺奴	si'nu	0
四菩萨	si'pu'sa	0
四亲近菩萨	si'qin'jin'pu'sa	0
寺请证文	si'qing'zheng'wen	0
四取	si'qu	0
四如实智	si'ru'shi'zhi	0
四沙门果	si'sha'men'guo	0
四善根位	si'shan'gen'wei	0
寺社传奏	si'she'chuan'zou	0
四摄法	si'she'fa	0
寺社奉行	si'she'feng'xing	0
四摄菩萨	si'she'pu'sa	0
四神足	si'shen'zu	0
四圣	si'sheng	0
四生	si'sheng	0
四生百劫	si'sheng'bai'jie	0
四圣地	si'sheng'di	0
四圣种	si'sheng'zhong	0
四食	si'shi	0
四十八轻戒	si'shi'ba'qing'jie	0
四十八愿	si'shi'ba'yuan	0
四十二贤圣	si'shi'er'xian'sheng	0
四十二章经	si'shi'er'zhang'jing	0
四誓偈	si'shi'ji	0
四识住	si'shi'zhu	0
四时坐禅	si'shi'zuo'chan	0
四睡图	si'shui'tu	0
四天王	si'tian'wang	0
四天王寺	si'tian'wang'si	0
四通行	si'tong'xing	0
四王天	si'wang'tian	0
思惟略要法	si'wei'lve'yao'fa	0
四威仪	si'wei'yi	0
四无碍辩	si'wu'ai'bian	0
四无量心	si'wu'liang'xin	0
四无色定	si'wu'se'ding	0
四无所畏	si'wu'suo'wei	0
思溪大藏经	si'xi'da'zang'jing	0
四悉檀	si'xi'tan	0
似现量	si'xian'liang	0
四相	si'xiang	0
四向四果	si'xiang'si'guo	0
四相违因	si'xiang'wei'yin	0
四姓	si'xing	0
四寻思	si'xun'si	0
四依	si'yi	0
四依法	si'yi'fa	0
思益梵天所问经	si'yi'fan'tian'suo'wen'jing	0
四意趣	si'yi'qu	0
四印	si'yin	0
寺印	si'yin	0
四有	si'you	0
四有为相	si'you'wei'xiang	0
四缘	si'yuan	0
寺院	si'yuan	0
寺院版	si'yuan'ban	0
寺院法度	si'yuan'fa'du	0
似云	si'yun	0
思择说	si'ze'shuo	0
四斋日	si'zhai'ri	0
寺镇	si'zhen	0
四证净	si'zheng'jing	0
四正勤	si'zheng'qin	0
四智	si'zhi	0
四众	si'zhong	0
四种怛特罗	si'zhong'da'te'luo	0
四种法	si'zhong'fa	0
四种华严	si'zhong'hua'yan	0
四种曼荼罗	si'zhong'man'tu'luo	0
四种拳	si'zhong'quan	0
四种三昧	si'zhong'san'mei	0
四洲	si'zhou	0
四住期	si'zhu'qi	0
寺子屋	si'zi'wu	0
四宗	si'zong	0
似宗九过	si'zong'jiu'guo	0
四祖道信	si'zu'dao'xin	0
四祖寺	si'zu'si	0
宋版大藏经	song'ban'da'cang'jing	0
宋版佛典	song'ban'fo'dian	0
松本文三郎	song'ben'wen'san'lang	0
送别	song'bie	0
宋藏遗珍	song'cang'yi'zhen	0
宋代佛教	song'dai'fo'jiao	0
松杜罗	song'du'luo	0
宋高僧传	song'gao'seng'chuan	0
颂古	song'gu	0
松广寺	song'guang'si	0
宋濂	song'lian	0
宋曼庵	song'man'an	0
宋满空	song'man'kong	0
嵩山	song'shan	0
松山寺	song'shan'si	0
送一轮明月给他	song'yi'lun'ming'yue'gei'ta	0
嵩岳寺	song'yue'si	0
宋云	song'yun	0
松云禅师	song'yun'chan'shi	0
松赞干布	song'zan'gan'bu	0
嵩祝寺	song'zhu'si	0
俗谛	su'di	0
俗讲	su'jiang	0
苏九山	su'jiu'shan	0
俗离山	su'li'shan	0
苏曼殊	su'man'shu	0
苏门答腊	su'men'da'la	0
苏摩	su'mo	0
苏南嘉措仁波切	su'nan'jia'cuo'ren'bo'qie	0
苏婆诃	su'po'he	0
苏婆呼童子经	su'po'hu'tong'zi'jing	0
苏轼	su'shi	0
素食	su'shi	0
粟特国	su'te'guo	0
苏悉地经	su'xi'di'jing	0
宿曜经	su'yao'jing	0
苏州圣堂寺	su'zhou'sheng'tang'si	0
宿住通	su'zhu'tong	0
隋代佛教	sui'dai'fo'jiao	0
随烦恼	sui'fan'nao	0
随方毗尼	sui'fang'pi'ni	0
随眠	sui'mian	0
岁苏进才老居士念佛往生劝世的心声	sui'su'jin'cai'lao'ju'shi'nian'fo'wang'sheng'quan'shi'de'xin'sheng	0
随喜	sui'xi	0
随信行	sui'xin'xing	0
随行	sui'xing	0
随一不成过	sui'yi'bu'cheng'guo	0
随缘	sui'yuan	0
随缘真如	sui'yuan'zhen'ru	0
随自意三昧	sui'zi'yi'san'mei	0
孙张清扬	sun'zhang'qing'yang	0
所	suo	0
所别不极成过	suo'bie'bu'ji'cheng'guo	0
娑祇多	suo'chi'duo	0
娑伽罗龙王	suo'ga'luo'long'wang	0
所立	suo'li	0
娑罗树	suo'luo'shu	0
娑婆	suo'po	0
缩刷大藏经	suo'shua'da'zang'jing	0
锁虚空	suo'xu'kong	0
所依	suo'yi	0
所依不成过	suo'yi'bu'cheng'guo	0
所缘	suo'yuan	0
所缘缘	suo'yuan'yuan	0
所知障	suo'zhi'zhang	0
塔	ta	0
塔尔寺	ta'er'si	0
他化自在天	ta'hua'zi'zai'tian	0
他力	ta'li	0
塔銮寺	ta'luan'si	0
塔什库尔干	ta'shi'ku'er'gan	0
他心通	ta'xin'tong	0
他心智	ta'xin'zhi	0
塔院寺	ta'yuan'si	0
泰安	tai'an	0
胎藏界	tai'cang'jie	0
胎藏四部仪轨	tai'cang'si'bu'yi'gui	0
泰戈尔	tai'ge'er	0
太古宗	tai'gu'zong	0
泰国佛教	tai'guo'fo'jiao	0
台密	tai'mi	0
胎内五位	tai'nei'wu'wei	0
太平庵	tai'ping'an	0
太平禅寺	tai'ping'chan'si	0
太平兴国寺	tai'ping'xing'guo'si	0
太上感应篇	tai'shang'gan'ying'pian	0
胎外五位	tai'wai'wu'wei	0
台湾佛教	tai'wan'fo'jiao	0
台湾宗教调查	tai'wan'zong'jiao'diao'cha	0
太虚	tai'xu	0
太元帅明王	tai'yuan'shuai'ming'wang	0
太原寺	tai'yuan'si	0
台座	tai'zuo	0
贪	tan	0
檀耳	tan'er	0
昙华	tan'hua	0
昙花一现	tan'hua'yi'xian	0
檀家制度	tan'jia'zhi'du	0
镡津文集	tan'jin'wen'ji	0
坛经传宗	tan'jing'chuan'zong	0
昙旷	tan'kuang	0
檀林	tan'lin	0
昙龙	tan'long	0
昙鸾	tan'luan	0
昙摩迦罗	tan'mo'jia'luo	0
昙摩密多	tan'mo'mi'duo	0
昙摩难提	tan'mo'nan'ti	0
昙迁	tan'qian	0
弹誓	tan'shi	0
贪睡的比丘	tan'shui'de'bi'qiu	0
檀特山	tan'te'shan	0
昙无谶	tan'wu'chen	0
昙无竭菩萨	tan'wu'jie'pu'sa	0
昙无最	tan'wu'zui	0
檀溪寺	tan'xi'si	0
檀像	tan'xiang	0
谈玄	tan'xuan	0
昙延	tan'yan	0
昙曜	tan'yao	0
叹异钞	tan'yi'chao	0
谭云山	tan'yun'shan	0
潭柘寺	tan'zhe'si	0
弹指	tan'zhi	0
塘奔	tang'ben	0
糖饼	tang'bing	0
唐蕃会盟碑	tang'bo'hui'meng'bei	0
唐大和上东征传	tang'da'he'shang'dong'zheng'chuan	0
唐代佛教	tang'dai'fo'jiao	0
汤殿山	tang'dian'shan	0
唐卡	tang'ka	0
汤山寺	tang'shan'si	0
唐招提寺	tang'zhao'ti'si	0
堂中首座	tang'zhong'shou'zuo	0
藤井日达	teng'jing'ri'da	0
剃发	ti'fa	0
醍醐	ti'hu	0
醍醐寺	ti'hu'si	0
体空观	ti'kong'guan	0
提起放下	ti'qi'fang'xia	0
提谓波利经	ti'wei'bo'li'jing	0
天	tian	0
天部	tian'bu	0
天地八阳神咒经	tian'di'ba'yang'shen'zhou'jing	0
天地会	tian'di'hui	0
天耳通	tian'er'tong	0
天盖	tian'gai	0
天宫寺	tian'gong'si	0
天狗	tian'gou	0
天鼓毒鼓	tian'gu'du'gu	0
天鼓雷音佛	tian'gu'lei'yin'fo	0
天冠	tian'guan	0
天海	tian'hai	0
天华寺	tian'hua'si	0
天机	tian'ji	0
天界觉浪盛禅师全录	tian'jie'jue'lang'sheng'chan'shi'quan'lu	0
天界寺	tian'jie'si	0
天空	tian'kong	0
天龙	tian'long	0
天龙八部	tian'long'ba'bu	0
天龙山石窟	tian'long'shan'shi'ku	0
天龙寺	tian'long'si	0
天龙寺派	tian'long'si'pai	0
天目山	tian'mu'shan	0
天目中峰广录	tian'mu'zhong'feng'guang'lu	0
天宁禅寺	tian'ning'chan'si	0
天宁寺	tian'ning'si	0
天平写经	tian'ping'xie'jing	0
天然居士怀净土诗	tian'ran'ju'shi'huai'jing'tu'shi	0
天然释道	tian'ran'shi'dao	0
天人	tian'ren	0
天如和尚语录	tian'ru'he'shang'yu'lu	0
天上天下无如佛	tian'shang'tian'xia'wu'ru'fo	0
天生暴躁	tian'sheng'bao'zao	0
天圣广灯录	tian'sheng'guang'deng'lu	0
天台八教大意	tian'tai'ba'jiao'da'yi	0
天台传佛心印记	tian'tai'chuan'fo'xin'yin'ji	0
天台九祖传	tian'tai'jiu'zu'chuan	0
天台山	tian'tai'shan	0
天台山方外志	tian'tai'shan'fang'wai'zhi	0
天台山秀岩寺	tian'tai'shan'xiu'yan'si	0
天台四教仪	tian'tai'si'jiao'yi	0
天台真言二宗同异章	tian'tai'zhen'yan'er'zong'tong'yi'zhang	0
天台智者大师别传	tian'tai'zhi'zhe'da'shi'bie'zhuan	0
天台宗	tian'tai'zong	0
天堂花	tian'tang'hua	0
天堂鸟	tian'tang'niao	0
天堂与地狱	tian'tang'yu'di'yu	0
天梯山石窟	tian'ti'shan'shi'ku	0
天童和尚辟妄救略说	tian'tong'he'shang'pi'wang'jiu'lve'shuo	0
天童弘觉文心禅师北游集	tian'tong'hong'jue'wen'xin'chan'shi'bei'you'ji	0
天童弘觉文心禅师语录	tian'tong'hong'jue'wen'xin'chan'shi'yu'lu	0
天童寺	tian'tong'si	0
天童寺志	tian'tong'si'zhi	0
天童正觉禅师广录	tian'tong'zheng'jue'chan'shi'guang'lu	0
天王殿	tian'wang'dian	0
天王寺	tian'wang'si	0
天文法华之乱	tian'wen'fa'hua'zhi'luan	0
天息灾	tian'xi'zai	0
天须菩提	tian'xu'pu'ti	0
天学初征	tian'xue'chu'zheng	0
天眼通	tian'yan'tong	0
天乙	tian'yi	0
天英	tian'ying	0
天缘禅寺	tian'yuan'chan'si	0
田中智学	tian'zhong'zhi'xue	0
天主慧	tian'zhu'hui	0
天竺三寺	tian'zhu'san'si	0
天竺寺	tian'zhu'si	0
天竺字源	tian'zhu'zi'yuan	0
天子殿念佛堂	tian'zi'dian'nian'fo'tang	0
调伏天	tiao'fu'tian	0
跳神节	tiao'shen'jie	0
铁佛寺	tie'fo'si	0
铁围山	tie'wei'shan	0
听与不听	ting'yu'bu'ting	0
通道观	tong'dao'guan	0
通度寺	tong'du'si	0
同法喻	tong'fa'yu	0
同分	tong'fen	0
桐华寺	tong'hua'si	0
同教	tong'jiao	0
同口灵觉寺	tong'kou'ling'jue'si	0
同类因	tong'lei'yin	0
桐里山	tong'li'shan	0
通妙	tong'miao	0
通明禅	tong'ming'chan	0
同朋大学	tong'peng'da'xue	0
同品	tong'pin	0
同品定有性	tong'pin'ding'you'xing	0
通身是眼	tong'shen'shi'yan	0
同泰寺	tong'tai'si	0
同体大悲	tong'ti'da'bei	0
童行	tong'xing	0
通州南山寺	tong'zhou'nan'shan'si	0
通州市普昭寺	tong'zhou'shi'pu'zhao'si	0
通州市香光寺	tong'zhou'shi'xiang'guang'si	0
通州贞洁院	tong'zhou'zhen'jie'yuan	0
童子	tong'zi	0
头	tou	0
偷盗戒	tou'dao'jie	0
投华得佛	tou'hua'de'fo	0
头巾	tou'jin	0
偷兰遮	tou'lan'zhe	0
投子山	tou'zi'shan	0
吐蕃僧诤记	tu'bo'seng'zheng'ji	0
土观呼图克图	tu'guan'hu'tu'ke'tu	0
土观三世	tu'guan'san'shi	0
土观宗派源流	tu'guan'zong'pai'yuan'liu	0
吐火罗语	tu'huo'luo'yu	0
突吉罗	tu'ji'luo	0
荼吉尼	tu'ji'ni	0
吐鲁番	tu'lu'fan	0
荼毗	tu'pi	0
图齐	tu'qi	0
土砂加持	tu'sha'jia'chi	0
吐痰	tu'tan	0
涂香	tu'xiang	0
涂艷秋	tu'yan'qiu	0
途中珍重	tu'zhong'zhen'zhong	0
退法阿罗汉	tui'fa'a'luo'han	0
退转	tui'zhuan	0
托钵	tuo'bo	0
拖耳耳长	tuo'er'er'chang	0
托林寺	tuo'lin'si	0
陀罗骠	tuo'luo'biao	0
陀罗尼	tuo'luo'ni	0
陀罗尼集经	tuo'luo'ni'ji'jing	0
妥美桑布	tuo'mei'sang'bu	0
驼山石窟	tuo'shan'shi'ku	0
脱俗与随俗	tuo'su'yu'sui'su	0
托胎	tuo'tai	0
瓦官寺	wa'guan'si	0
瓦经	wa'jing	0
瓦拉那西	wa'la'na'xi	0
外道小乘涅槃论	wai'dao'xiao'cheng'nie'pan'lun	0
外道小乘四宗论	wai'dao'xiao'cheng'si'zong'lun	0
外五股印	wai'wu'gu'yin	0
万灯会	wan'deng'hui	0
宛尔不同	wan'er'bu'tong	0
万佛禅寺	wan'fo'chan'si	0
万佛寺	wan'fo'si	0
万佛堂石窟	wan'fo'tang'shi'ku	0
万福寺	wan'fu'si	0
万行	wan'hang	0
万金川	wan'jin'chuan	0
完美	wan'mei	0
完美大师	wan'mei'da'shi	0
万年寺	wan'nian'si	0
万善同归集	wan'shan'tong'gui'ji	0
丸山照雄	wan'shan'zhao'xiong	0
万寿寺	wan'shou'si	0
丸香	wan'xiang	0
卍续藏经	wan'xu'cang'jing	0
卍正藏经	wan'zheng'cang'jing	0
卍字	wan'zi	0
王重阳	wang'chong'yang	0
王恩洋	wang'en'yang	0
王法正理论	wang'fa'zheng'li'lun	0
王梵志	wang'fan'zhi	0
王夫之	wang'fu'zhi	0
王古	wang'gu	0
望海寺	wang'hai'si	0
王缙	wang'jin	0
妄尽还源观	wang'jin'hai'yuan'guan	0
王进瑞	wang'jin'rui	0
往哪里里去	wang'na'li'li'qu	0
妄念	wang'nian	0
妄染	wang'ran	0
王日休	wang'ri'xiu	0
王儒龙	wang'ru'long	0
王三昧	wang'san'mei	0
王舍城	wang'she'cheng	0
王审知	wang'shen'zhi	0
往生	wang'sheng	0
往生集	wang'sheng'ji	0
往生讲	wang'sheng'jiang	0
往生净土忏愿仪	wang'sheng'jing'tu'chan'yuan'yi	0
往生礼赞偈	wang'sheng'li'zan'ji	0
往生论注	wang'sheng'lun'zhu	0
往生西方净土瑞应删传	wang'sheng'xi'fang'jing'tu'rui'ying'shan'chuan	0
往生要集	wang'sheng'yao'ji	0
往生咒	wang'sheng'zhou	0
往世书	wang'shi'shu	0
王统史	wang'tong'shi	0
王维	wang'wei	0
妄想	wang'xiang	0
王玄策	wang'xuan'ce	0
妄语戒	wang'yu'jie	0
妄执	wang'zhi	0
微尘	wei'chen	0
未到曹溪亦不失	wei'dao'cao'xi'yi'bu'shi	0
威德与折福	wei'de'yu'zhe'fu	0
为己所迷	wei'ji'suo'mi	0
伪经	wei'jing	0
惟觉	wei'jue	0
维摩诘所说经	wei'mo'jie'suo'shuo'jing	0
卫塞节	wei'sai'jie	0
未上树时	wei'shang'shu'shi	0
为什么不能吃它们	wei'shen'me'bu'neng'chi'ta'men	0
为什么停不下来	wei'shen'me'ting'bu'xia'lai	0
为什么要悲伤哭泣	wei'shen'me'yao'bei'shang'ku'qi	0
唯识	wei'shi	0
唯识二十论	wei'shi'er'shi'lun	0
唯识三十颂	wei'shi'san'shi'song	0
唯识三十颂释	wei'shi'san'shi'song'shi	0
为师胸怀	wei'shi'xiong'huai	0
魏书释老志	wei'shu'shi'lao'zhi	0
韦提希	wei'ti'xi	0
韦驮天	wei'tuo'tian	0
威县普济寺	wei'xian'pu'ji'si	0
唯心净土	wei'xin'jing'tu	0
沩仰宗	wei'yang'zong	0
威仪	wei'yi	0
威音王佛	wei'yin'wang'fo	0
卫元嵩	wei'yuan'song	0
未至定	wei'zhi'ding	0
为止小儿啼	wei'zhi'xiao'er'ti	0
文才	wen'cai	0
文成公主	wen'cheng'gong'zhu	0
文成公主庙	wen'cheng'gong'zhu'miao	0
文纲	wen'gang	0
文观	wen'guan	0
文觉	wen'jue	0
问情	wen'qing	0
温室洗浴众僧经	wen'shi'xi'yu'zhong'seng'jing	0
文殊八字咒	wen'shu'ba'zi'zhou	0
文殊会	wen'shu'hui	0
文殊菩萨心咒	wen'shu'pu'sa'xin'zhou	0
文殊山石窟	wen'shu'shan'shi'ku	0
文殊师利	wen'shu'shi'li	0
文殊师利般涅槃经	wen'shu'shi'li'ban'nie'pan'jing	0
文殊师利问经	wen'shu'shi'li'wen'jing	0
文殊颂	wen'shu'song	0
文殊现身	wen'shu'xian'shen	0
文殊一字咒	wen'shu'yi'zi'zhou	0
文殊院	wen'shu'yuan	0
闻思修	wen'si'xiu	0
温特尼兹	wen'te'ni'zi	0
文琇	wen'xiu	0
问讯	wen'xun	0
文偃	wen'yan	0
文益	wen'yi	0
文准	wen'zhun	0
卧	wo	0
我	wo	0
我不是佛	wo'bu'shi'fo	0
我不是众生	wo'bu'shi'zhong'sheng	0
我不识字	wo'bu'shi'zi	0
倭藏	wo'cang	0
我法二空	wo'fa'er'kong	0
我法二执	wo'fa'er'zhi	0
我法俱有宗	wo'fa'ju'you'zong	0
卧佛寺	wo'fo'si	0
我见	wo'jian	0
我看你象佛	wo'kan'ni'xiang'fo	0
我看你像牛粪	wo'kan'ni'xiang'niu'fen	0
我空法有	wo'kong'fa'you	0
卧龙寺	wo'long'si	0
我慢	wo'man	0
我们走吧	wo'men'zou'ba	0
卧如来	wo'ru'lai	0
我是侍者	wo'shi'shi'zhe	0
我所	wo'suo	0
我往西方走	wo'wang'xi'fang'zou	0
我为你祝福	wo'wei'ni'zhu'fu	0
我我所见	wo'wo'suo'jian	0
我相	wo'xiang	0
我也可以为你忙	wo'ye'ke'yi'wei'ni'mang	0
我也有舌头	wo'ye'you'she'tou	0
我有你呀	wo'you'ni'ya	0
我在哪里	wo'zai'na'li	0
我执	wo'zhi	0
悟	wu	0
无	wu	0
无碍解道	wu'ai'jie'dao	0
五百大愿	wu'bai'da'yuan	0
五百戒	wu'bai'jie	0
五百罗汉	wu'bai'luo'han	0
五宝	wu'bao	0
无表色	wu'biao'se	0
邬波婆沙	wu'bo'po'sha	0
邬波驮耶	wu'bo'tuo'ye	0
五部	wu'bu	0
五部大论	wu'bu'da'lun	0
五部灌顶	wu'bu'guan'ding	0
五部律	wu'bu'lv	0
五部祕观	wu'bu'mi'guan	0
五部祕经	wu'bu'mi'jing	0
五怖畏	wu'bu'wei	0
五部座	wu'bu'zuo	0
五参上堂	wu'can'shang'tang	0
五藏	wu'cang	0
无常	wu'chang	0
武昌佛学院	wu'chang'fo'xue'yuan	0
无常偈	wu'chang'ji	0
无常经	wu'chang'jing	0
五乘	wu'cheng	0
五处加持	wu'chu'jia'chi	0
悟慈	wu'ci	0
五次第	wu'ci'di	0
五大	wu'da	0
五大部	wu'da'bu	0
五大力菩萨	wu'da'li'pu'sa	0
邬达罗迦	wu'da'luo'jia	0
五大虚空藏菩萨	wu'da'xu'kong'cang'pu'sa	0
五大愿	wu'da'yuan	0
乌达正觉寺	wu'da'zheng'jue'si	0
五代佛教	wu'dai'fo'jiao	0
五当召	wu'dang'zhao	0
无道心	wu'dao'xin	0
吴道子	wu'dao'zi	0
五灯会元	wu'deng'hui'yuan	0
五灯全书	wu'deng'quan'shu	0
五灯严统	wu'deng'yan'tong	0
五谛	wu'di	0
吴都法乘	wu'dou'fa'cheng	0
邬闍衍那国	wu'du'yan'na'guo	0
五钝使	wu'dun'shi	0
五法	wu'fa	0
五法藏	wu'fa'cang	0
无烦天	wu'fan'tian	0
五方便念佛门	wu'fang'bian'nian'fo'men	0
五方佛礼赞	wu'fang'fo'li'zan	0
五分比丘尼戒本	wu'fen'bi'qiu'ni'jie'ben	0
无分别智	wu'fen'bie'zhi	0
五分法身	wu'fen'fa'shen	0
五分戒	wu'fen'jie	0
五佛	wu'fo	0
五佛顶	wu'fo'ding	0
五佛顶法	wu'fo'ding'fa	0
五盖	wu'gai	0
吴哥寺	wu'ge'si	0
吴哥王城	wu'ge'wang'cheng	0
五根	wu'gen	0
五供养	wu'gong'yang	0
无功用	wu'gong'yong	0
五股印	wu'gu'yin	0
五观	wu'guan	0
悟光	wu'guang	0
五果	wu'guo	0
乌海市兴海寺	wu'hai'shi'xing'hai'si	0
五河	wu'he	0
无合	wu'he	0
五悔	wu'hui	0
五会法事赞	wu'hui'fa'shi'zan	0
五会念佛	wu'hui'nian'fo	0
无记	wu'ji	0
五家七宗	wu'jia'qi'zong	0
五家语录	wu'jia'yu'lu	0
五家正宗赞	wu'jia'zheng'zong'zan	0
五家宗旨纂要	wu'jia'zong'zhi'zuan'yao	0
无间地狱	wu'jian'di'yu	0
五教	wu'jiao	0
五教两宗	wu'jiao'liang'zong	0
五教十宗	wu'jiao'shi'zong	0
五戒	wu'jie	0
五解脱轮	wu'jie'tuo'lun	0
无尽藏	wu'jin'cang	0
无尽灯	wu'jin'deng	0
无尽意菩萨	wu'jin'yi'pu'sa	0
五净	wu'jing	0
五境	wu'jing	0
五净居天	wu'jing'ju'tian	0
五精舍十塔	wu'jing'she'shi'ta	0
五卷书	wu'juan'shu	0
五力	wu'li	0
五利使	wu'li'shi	0
无量寿佛心咒	wu'liang'shou'fo'xin'zhou	0
无量寿经	wu'liang'shou'jing	0
无量寿如来陀罗尼	wu'liang'shou'ru'lai'tuo'luo'ni	0
无量义经	wu'liang'yi'jing	0
武林西湖高僧事略	wu'lin'xi'hu'gao'seng'shi'lve	0
无漏法	wu'lou'fa	0
无漏律仪	wu'lou'lv'yi	0
无漏智	wu'lou'zhi	0
乌鲁木齐清泉山清泉禅寺	wu'lu'mu'qi'qing'quan'shan'qing'quan'chan'si	0
呜噜捺囉叉	wu'lu'na'luo'cha	0
五轮	wu'lun	0
五轮三昧	wu'lun'san'mei	0
五轮塔	wu'lun'ta	0
五门禅经要用法	wu'men'chan'jing'yao'yong'fa	0
无门关	wu'men'guan	0
五明	wu'ming	0
悟明	wu'ming	0
无明	wu'ming	0
五摩字	wu'mo'zi	0
五难	wu'nan	0
五逆	wu'ni	0
五念门	wu'nian'men	0
五品弟子位	wu'pin'di'zi'wei	0
无情说法	wu'qing'shuo'fa	0
无情有性	wu'qing'you'xing	0
五趣生死轮	wu'qu'sheng'si'lun	0
五取蕴	wu'qu'yun	0
吴汝钧	wu'ru'jun	0
吴润江	wu'run'jiang	0
五色	wu'se	0
无色界	wu'se'jie	0
五山版	wu'shan'ban	0
五山十剎	wu'shan'shi'cha	0
五山文学	wu'shan'wen'xue	0
五善五恶	wu'shan'wu'e	0
无上法宝	wu'shang'fa'bao	0
五上分结	wu'shang'fen'jie	0
无上依经	wu'shang'yi'jing	0
乌审旗乌审召	wu'shen'qi'wu'shen'zhao	0
无生法忍	wu'sheng'fa'ren	0
五识	wu'shi	0
五时	wu'shi	0
五时八教	wu'shi'ba'jiao	0
五十二数	wu'shi'er'shu	0
五十二位	wu'shi'er'wei	0
五十卷钞	wu'shi'juan'chao	0
五失三不易	wu'shi'san'bu'yi	0
五十三参	wu'shi'san'can	0
五十三佛	wu'shi'san'fo	0
无事手	wu'shi'shou	0
乌枢沙摩明王	wu'shu'sha'mo'ming'wang	0
乌素图召	wu'su'tu'zhao	0
五随	wu'sui	0
五岁庵	wu'sui'an	0
无所有处天	wu'suo'you'chu'tian	0
五塔寺	wu'ta'si	0
五台山	wu'tai'shan	0
无体	wu'ti	0
五体投地	wu'ti'tou'di	0
五停心观	wu'ting'xin'guan	0
五通	wu'tong	0
五屯寺	wu'tun'si	0
五位	wu'wei	0
五味	wu'wei	0
五位百法	wu'wei'bai'fa	0
五味禅	wu'wei'chan	0
无为法	wu'wei'fa	0
五位七十五法	wu'wei'qi'shi'wu'fa	0
无畏三藏禅要	wu'wei'san'zang'chan'yao	0
无畏山寺	wu'wei'shan'si	0
五位无心	wu'wei'wu'xin	0
无位真人	wu'wei'zhen'ren	0
无我	wu'wo	0
五五百年	wu'wu'bai'nian	0
五下分结	wu'xia'fen'jie	0
巫峡镇念佛堂	wu'xia'zhen'nian'fo'tang	0
无想	wu'xiang	0
无相	wu'xiang	0
五相成身观	wu'xiang'cheng'shen'guan	0
无想定	wu'xiang'ding	0
无响无闻	wu'xiang'wu'wen	0
五小部	wu'xiao'bu	0
五辛	wu'xin	0
五行	wu'xing	0
五星	wu'xing	0
无姓儿	wu'xing'er	0
吴惺月	wu'xing'yue	0
无学	wu'xue	0
无学派	wu'xue'pai	0
五眼	wu'yan	0
无言句	wu'yan'ju	0
无言之教	wu'yan'zhi'jiao	0
五药	wu'yao	0
五衣	wu'yi	0
悟一	wu'yi	0
悟因	wu'yin	0
五阴盛苦	wu'yin'sheng'ku	0
乌尤寺	wu'you'si	0
五欲	wu'yu	0
悟与不悟	wu'yu'bu'wu	0
无余依涅槃	wu'yu'yi'nie'pan	0
无缘	wu'yuan	0
五原理精要	wu'yuan'li'jing'yao	0
五岳	wu'yue	0
五蕴	wu'yun	0
武则天	wu'ze'tian	0
五障	wu'zhang	0
乌仗那国	wu'zhang'na'guo	0
无遮大会	wu'zhe'da'hui	0
悟真寺	wu'zhen'si	0
无诤	wu'zheng	0
五智	wu'zhi	0
五智如来	wu'zhi'ru'lai	0
五支作法	wu'zhi'zuo'fa	0
五众	wu'zhong	0
五种三昧道	wu'zhong'san'mei'dao	0
五种三昧耶	wu'zhong'san'mei'ye	0
五重唯识观	wu'zhong'wei'shi'guan	0
五种姓	wu'zhong'xing	0
吴忠兴教寺	wu'zhong'xing'jiao'si	0
五种修法	wu'zhong'xiu'fa	0
五重玄义	wu'zhong'xuan'yi	0
五周因果	wu'zhou'yin'guo	0
无住	wu'zhu	0
无住处涅槃	wu'zhu'chu'nie'pan	0
五住地烦恼	wu'zhu'di'fan'nao	0
五庄严法	wu'zhuang'yan'fa	0
五浊	wu'zhuo	0
五字文殊菩萨	wu'zi'wen'shu'pu'sa	0
五字严身观	wu'zi'yan'shen'guan	0
五宗教	wu'zong'jiao	0
五宗救	wu'zong'jiu	0
无宗派运动	wu'zong'pai'yun'dong	0
五宗原	wu'zong'yuan	0
五祖山	wu'zu'shan	0
无嘴说法	wu'zui'shuo'fa	0
系	xi	0
西禅寺	xi'chan'si	0
洗出佛性	xi'chu'fo'xing	0
西大寺	xi'da'si	0
悉地	xi'di	0
西方佛教僧团之友	xi'fang'fo'jiao'seng'tuan'zhi'you	0
西方公据	xi'fang'gong'ju	0
西方合论	xi'fang'he'lun	0
西方净土	xi'fang'jing'tu	0
西芳寺	xi'fang'si	0
西方要决释疑通规	xi'fang'yao'jue'shi'yi'tong'gui	0
西谷启治	xi'gu'qi'zhi	0
西光万吉	xi'guang'wan'ji	0
西归直指	xi'gui'zhi'zhi	0
西湖	xi'hu	0
西基利亚	xi'ji'li'ya	0
西涧派	xi'jian'pai	0
西教寺	xi'jiao'si	0
希解派	xi'jie'pai	0
西晋佛教	xi'jin'fo'jiao	0
锡金佛教	xi'jin'fo'jiao	0
锡克沁千佛洞	xi'ke'qin'qian'fo'dong	0
析空观	xi'kong'guan	0
西来寺	xi'lai'si	0
西来意	xi'lai'yi	0
锡兰佛教	xi'lan'fo'jiao	0
溪岚拾叶集	xi'lan'shi'ye'ji	0
希朗	xi'lang	0
席力图召	xi'li'tu'zhao	0
希陵	xi'ling	0
戏论	xi'lun	0
洗面革心	xi'mian'ge'xin	0
西明寺	xi'ming'si	0
西念寺	xi'nian'si	0
习气	xi'qi	0
细色	xi'se	0
西山八大处	xi'shan'ba'da'chu	0
西山派	xi'shan'pai	0
西山住部	xi'shan'zhu'bu	0
喜舍	xi'she	0
西双版纳	xi'shuang'ban'na	0
西寺	xi'si	0
希叟绍昙禅师广录	xi'sou'shao'tan'chan'shi'guang'lu	0
悉昙	xi'tan	0
西堂智藏	xi'tang'zhi'cang	0
西田几多郎	xi'tian'ji'duo'lang	0
西田龙雄	xi'tian'long'xiong	0
西天目山禅源寺	xi'tian'mu'shan'chan'yuan'si	0
西田天香	xi'tian'tian'xiang	0
洗碗扫地	xi'wan'sao'di	0
戏忘天	xi'wang'tian	0
西夏佛教	xi'xia'fo'jiao	0
西夏文大藏经	xi'xia'wen'da'zang'jing	0
西行	xi'xing	0
细意识	xi'yi'shi	0
西义雄	xi'yi'xiong	0
西游记	xi'you'ji	0
西域	xi'yu	0
西域中华海东佛祖源流	xi'yu'zhong'hua'hai'dong'fo'zu'yuan'liu	0
惜缘	xi'yuan	0
西园寺	xi'yuan'si	0
息灾法	xi'zai'fa	0
西藏	xi'zang	0
西藏大藏经	xi'zang'da'zang'jing	0
西藏佛教	xi'zang'fo'jiao	0
西藏高僧全书	xi'zang'gao'seng'quan'shu	0
西藏王臣记	xi'zang'wang'chen'ji	0
西藏王统记	xi'zang'wang'tong'ji	0
西藏文	xi'zang'wen	0
西斋净土诗	xi'zhai'jing'tu'shi	0
锡杖	xi'zhang	0
夏鲁寺	xia'lu'si	0
厦门大佛寺	xia'men'da'fo'si	0
厦门南普陀寺	xia'men'nan'pu'tuo'si	0
闲	xian	0
现代佛教学术丛刊	xian'dai'fo'jiao'xue'shu'cong'kan	0
仙丹花	xian'dan'hua	0
贤顿	xian'dun	0
献供赞	xian'gong'zan	0
现观	xian'guan	0
现观庄严论	xian'guan'zhuang'yan'lun	0
贤护菩萨	xian'hu'pu'sa	0
贤劫	xian'jie	0
显戒论	xian'jie'lun	0
贤劫千佛	xian'jie'qian'fo	0
贤劫十六尊	xian'jie'shi'liu'zun	0
闲居编	xian'ju'bian	0
现量相违过	xian'liang'xiang'wei'guo	0
酰罗城	xian'luo'cheng	0
暹罗派	xian'luo'pai	0
酰罗山	xian'luo'shan	0
显明	xian'ming	0
咸润	xian'run	0
贤圣	xian'sheng	0
显识论	xian'shi'lun	0
仙天禅师	xian'tian'chan'shi	0
显通寺	xian'tong'si	0
现图曼荼罗	xian'tu'man'tu'luo	0
线香	xian'xiang	0
现行	xian'xing	0
仙巖寺	xian'yan'si	0
显扬圣教论	xian'yang'sheng'jiao'lun	0
贤愚经	xian'yu'jing	0
贤者喜宴	xian'zhe'xi'yan	0
显正	xian'zheng	0
贤胄部	xian'zhou'bu	0
显宗记	xian'zong'ji	0
香	xiang	0
想	xiang	0
相	xiang	0
响巴迦举派	xiang'ba'jia'ju'pai	0
相部宗	xiang'bu'zong	0
香灯	xiang'deng	0
像法决疑经	xiang'fa'jue'yi'jing	0
香房	xiang'fang	0
相符极成过	xiang'fu'ji'cheng'guo	0
香港佛教	xiang'gang'fo'jiao	0
香光寺	xiang'guang'si	0
相国寺	xiang'guo'si	0
相好	xiang'hao	0
香偈	xiang'ji	0
相即	xiang'ji	0
香积佛	xiang'ji'fo	0
香积寺	xiang'ji'si	0
象教皮编	xiang'jiao'pi'bian	0
香界寺	xiang'jie'si	0
香炉	xiang'lu	0
像牛粪	xiang'niu'fen	0
相入	xiang'ru	0
香山寺	xiang'shan'si	0
香山昭庙	xiang'shan'zhao'miao	0
相实	xiang'shi	0
香水海	xiang'shui'hai	0
香汤	xiang'tang	0
响堂山石窟	xiang'tang'shan'shi'ku	0
香象	xiang'xiang	0
香姓婆罗门	xiang'xing'po'luo'men	0
相续	xiang'xu	0
香严击竹	xiang'yan'ji'zhu	0
香巖寺	xiang'yan'si	0
香烟寺	xiang'yan'si	0
香严智闲	xiang'yan'zhi'xian	0
相应	xiang'ying	0
相应心	xiang'ying'xin	0
香语	xiang'yu	0
向原寺	xiang'yuan'si	0
向岳寺派	xiang'yue'si'pai	0
祥云	xiang'yun	0
相宗八要	xiang'zong'ba'yao	0
香醉山	xiang'zui'shan	0
小部	xiao'bu	0
小参	xiao'can	0
小乘佛教	xiao'cheng'fo'jiao	0
小川贯一	xiao'chuan'guan'yi	0
笑多于哭	xiao'duo'yu'ku	0
小恶小善都不能轻视	xiao'e'xiao'shan'dou'bu'neng'qing'shi	0
小烦恼地法	xiao'fan'nao'de'fa	0
萧金松	xiao'jin'song	0
小笠原宣秀	xiao'li'yuan'xuan'xiu	0
小品般若经	xiao'pin'bo're'jing	0
小沙弥与老和尚	xiao'sha'mi'yu'lao'he'shang	0
小杉一雄	xiao'shan'yi'xiong	0
小史	xiao'shi	0
小诵	xiao'song	0
小松原法难	xiao'song'yuan'fa'nan	0
小偷与月亮	xiao'tou'yu'yue'liang	0
晓乌敏	xiao'wu'min	0
萧武桐	xiao'wu'tong	0
小雁塔	xiao'yan'ta	0
小野玄妙	xiao'ye'xuan'miao	0
晓云	xiao'yun	0
消灾吉祥神咒梵唱	xiao'zai'ji'xiang'shen'zhou'fan'chang	0
消灾咒	xiao'zai'zhou	0
小昭寺	xiao'zhao'si	0
萧子良	xiao'zi'liang	0
谢尔巴斯基	xie'er'ba'si'ji	0
邪见	xie'jian	0
写经	xie'jing	0
谢灵运	xie'ling'yun	0
懈慢国	xie'man'guo	0
胁士	xie'shi	0
邪淫戒	xie'yin'jie	0
信	xin	0
心	xin	0
新编诸宗教藏总录	xin'bian'zhu'zong'jiao'cang'zong'lu	0
心不相应行	xin'bu'xiang'ying'xing	0
新超峰寺	xin'chao'feng'si	0
心淳	xin'chun	0
心道	xin'dao	0
心定	xin'ding	0
信度国	xin'du'guo	0
信度河	xin'du'he	0
心舫	xin'fang	0
新佛教徒同志会	xin'fo'jiao'tu'tong'zhi'hui	0
新佛寺	xin'fo'si	0
心佛众生三法无差	xin'fo'zhong'sheng'san'fa'wu'cha	0
新集浴像仪轨	xin'ji'yu'xiang'yi'gui	0
新加坡佛教	xin'jia'po'fo'jiao	0
信解	xin'jie	0
心镜	xin'jing	0
心净国土净	xin'jing'guo'tu'jing	0
心经会	xin'jing'hui	0
新井石禅	xin'jing'shi'chan	0
心具三千	xin'ju'san'qian	0
心觉	xin'jue	0
心空及第	xin'kong'ji'di	0
心离语言相	xin'li'yu'yan'xiang	0
新妈妈的恩德	xin'ma'ma'de'en'de	0
信满成佛	xin'man'cheng'fo	0
心平	xin'ping	0
新胜寺	xin'sheng'si	0
信施	xin'shi	0
心是莲花	xin'shi'lian'hua	0
心所有法	xin'suo'you'fa	0
心田	xin'tian	0
心王铭	xin'wang'ming	0
心王心所	xin'wang'xin'suo	0
新唯识论	xin'wei'shi'lun	0
心无挂碍	xin'wu'gua'ai	0
心无外物	xin'wu'wai'wu	0
信心铭	xin'xin'ming	0
信行	xin'xing	0
心性本净	xin'xing'ben'jing	0
新兴佛教青年运动	xin'xing'fo'jiao'qing'nian'yun'dong	0
新续高僧传	xin'xu'gao'seng'chuan	0
心意识	xin'yi'shi	0
新义真言宗	xin'yi'zhen'yan'zong	0
心印	xin'yin	0
心与性	xin'yu'xing	0
心源	xin'yuan	0
心在哪	xin'zai'na	0
心昭	xin'zhao	0
心咒	xin'zhou	0
行	xing	0
性	xing	0
行茶	xing'cha	0
兴禅护国论	xing'chan'hu'guo'lun	0
星辰花	xing'chen'hua	0
性澄	xing'cheng	0
性聪	xing'cong	0
行道	xing'dao	0
性得	xing'de	0
性潡	xing'dun	0
性恶	xing'e	0
邢福泉	xing'fu'quan	0
幸福是什么	xing'fu'shi'shen'me	0
兴福寺	xing'fu'si	0
星供	xing'gong	0
性广	xing'guang	0
兴国寺	xing'guo'si	0
行海	xing'hai	0
性海果分	xing'hai'guo'fen	0
行贺	xing'he	0
兴化寺	xing'hua'si	0
兴皇寺	xing'huang'si	0
行基	xing'ji	0
行寂	xing'ji	0
行脚	xing'jiao	0
兴教寺	xing'jiao'si	0
行解	xing'jie	0
行诫	xing'jie	0
性戒	xing'jie	0
性具	xing'ju	0
性觉寺	xing'jue'si	0
性灵集	xing'ling'ji	0
兴隆净寺	xing'long'jing'si	0
兴隆寺	xing'long'si	0
兴轮寺	xing'lun'si	0
行满	xing'man	0
性起	xing'qi	0
兴起行经	xing'qi'xing'jing	0
行勤	xing'qin	0
兴渠	xing'qu	0
形色	xing'se	0
行森	xing'sen	0
兴善古寺	xing'shan'gu'si	0
行思	xing'si	0
邢台观音禅寺	xing'tai'guan'yin'chan'si	0
邢台快活林崇兴寺	xing'tai'kuai'huo'lin'chong'xing'si	0
邢台南海普照寺	xing'tai'nan'hai'pu'zhao'si	0
邢台市百泉寺	xing'tai'shi'bai'quan'si	0
邢台市柏乡县圆福寺	xing'tai'shi'bai'xiang'xian'yuan'fu'si	0
邢台市崇修寺	xing'tai'shi'chong'xiu'si	0
邢台市慈云寺	xing'tai'shi'ci'yun'si	0
邢台市段羊杯法音精舍	xing'tai'shi'duan'yang'bei'fa'yin'jing'she	0
邢台市梵音寺	xing'tai'shi'fan'yin'si	0
邢台市封峦寺	xing'tai'shi'feng'luan'si	0
邢台市福胜寺	xing'tai'shi'fu'sheng'si	0
邢台市光明寺	xing'tai'shi'guang'ming'si	0
邢台市华藏寺	xing'tai'shi'hua'cang'si	0
邢台市净土寺	xing'tai'shi'jing'tu'si	0
邢台市临城县云通寺	xing'tai'shi'lin'cheng'xian'yun'tong'si	0
邢台市隆慈寺	xing'tai'shi'long'ci'si	0
邢台市南宫石佛寺	xing'tai'shi'nan'gong'shi'fo'si	0
邢台市南和县白崔庵	xing'tai'shi'nan'he'xian'bai'cui'an	0
邢台市南和县念佛堂	xing'tai'shi'nan'he'xian'nian'fo'tang	0
邢台市南和县西关念佛堂	xing'tai'shi'nan'he'xian'xi'guan'nian'fo'tang	0
邢台市内邱县且停寺	xing'tai'shi'nei'qiu'xian'qie'ting'si	0
邢台市内邱兴隆寺	xing'tai'shi'nei'qiu'xing'long'si	0
邢台市宁晋县观音寺	xing'tai'shi'ning'jin'xian'guan'yin'si	0
邢台市宁晋县普润寺	xing'tai'shi'ning'jin'xian'pu'run'si	0
邢台市宁晋县云台寺	xing'tai'shi'ning'jin'xian'yun'tai'si	0
邢台市普光寺	xing'tai'shi'pu'guang'si	0
邢台市普明寺	xing'tai'shi'pu'ming'si	0
邢台市清凉寺	xing'tai'shi'qing'liang'si	0
邢台市沙河华藏寺	xing'tai'shi'sha'he'hua'cang'si	0
邢台市沙河妙音念佛堂	xing'tai'shi'sha'he'miao'yin'nian'fo'tang	0
邢台市沙河普照寺	xing'tai'shi'sha'he'pu'zhao'si	0
邢台市沙河县兴隆寺	xing'tai'shi'sha'he'xian'xing'long'si	0
邢台市泰兴寺	xing'tai'shi'tai'xing'si	0
邢台市天佛寺	xing'tai'shi'tian'fo'si	0
邢台市威县崇兴寺	xing'tai'shi'wei'xian'chong'xing'si	0
邢台市威县法云禅寺	xing'tai'shi'wei'xian'fa'yun'chan'si	0
邢台市威县念佛堂	xing'tai'shi'wei'xian'nian'fo'tang	0
邢台市威县石佛寺	xing'tai'shi'wei'xian'shi'fo'si	0
邢台市新河县大佛寺	xing'tai'shi'xin'he'xian'da'fo'si	0
邢台市兴固寺	xing'tai'shi'xing'gu'si	0
邢台市邢台县玉泉禅寺	xing'tai'shi'xing'tai'xian'yu'quan'chan'si	0
邢台市永兴寺	xing'tai'shi'yong'xing'si	0
邢台市园通寺	xing'tai'shi'yuan'tong'si	0
邢台市圆照寺	xing'tai'shi'yuan'zhao'si	0
邢台市中天寺	xing'tai'shi'zhong'tian'si	0
邢台新河县慈明寺	xing'tai'xin'he'xian'ci'ming'si	0
行堂	xing'tang	0
省悟	xing'wu	0
性习二性	xing'xi'er'xing	0
行香	xing'xiang	0
行像	xing'xiang	0
行相	xing'xiang	0
性相	xing'xiang	0
性相二宗	xing'xiang'er'zong	0
行秀	xing'xiu	0
星宿劫	xing'xiu'jie	0
行愿	xing'yuan	0
性愿	xing'yuan	0
行蕴	xing'yun	0
星云	xing'yun	0
行智	xing'zhi	0
行尊	xing'zun	0
熊十力	xiong'shi'li	0
熊琬	xiong'wan	0
熊与鱼	xiong'yu'yu	0
修禅要诀	xiu'chan'yao'jue	0
修大方广佛华严法界观门	xiu'da'fang'guang'fo'hua'yan'fa'jie'guan'men	0
修道	xiu'dao	0
修得	xiu'de	0
修德寺	xiu'de'si	0
修多罗	xiu'duo'luo	0
修法	xiu'fa	0
修观	xiu'guan	0
修惑	xiu'huo	0
休静	xiu'jing	0
修习次第	xiu'xi'ci'di	0
修习止观坐禅法要	xiu'xi'zhi'guan'zuo'chan'fa'yao	0
修行	xiu'xing	0
修行本起经	xiu'xing'ben'qi'jing	0
修行道地经	xiu'xing'dao'di'jing	0
修验道	xiu'yan'dao	0
修养庵	xiu'yang'an	0
修证义	xiu'zheng'yi	0
续高僧传	xu'gao'seng'chuan	0
徐进夫	xu'jin'fu	0
虚空	xu'kong	0
虚空藏菩萨	xu'kong'cang'pu'sa	0
虚空藏菩萨真言	xu'kong'cang'pu'sa'zhen'yan	0
虚空眨眼	xu'kong'zha'yan	0
须弥福寿之庙	xu'mi'fu'shou'zhi'miao	0
须弥山	xu'mi'shan	0
须弥山石窟	xu'mi'shan'shi'ku	0
须弥坛	xu'mi'tan	0
续明	xu'ming	0
许明银	xu'ming'yin	0
须摩提菩萨经	xu'mo'ti'pu'sa'jing	0
虚妄分别	xu'wang'fen'bie	0
虚无僧	xu'wu'seng	0
续祥	xu'xiang	0
旭雅	xu'ya	0
许洋主	xu'yang'zhu	0
玄畅	xuan'chang	0
玄法寺仪轨	xuan'fa'si'yi'gui	0
玄昉	xuan'fang	0
选佛图	xuan'fo'tu	0
玄高	xuan'gao	0
宣化	xuan'hua	0
宣鉴	xuan'jian	0
玄觉	xuan'jue	0
悬空寺	xuan'kong'si	0
玄朗	xuan'lang	0
玄清	xuan'qing	0
宣疏	xuan'shu	0
玄素	xuan'su	0
玄谈	xuan'tan	0
玄琬	xuan'wan	0
玄应	xuan'ying	0
玄应音义	xuan'ying'yin'yi	0
玄宥	xuan'you	0
玄奘	xuan'zang	0
玄赜	xuan'ze	0
选择本愿念佛集	xuan'ze'ben'yuan'nian'fo'ji	0
宣政院	xuan'zheng'yuan	0
玄旨归命坛	xuan'zhi'gui'ming'tan	0
玄中寺	xuan'zhong'si	0
学处	xue'chu	0
雪窦山资圣禅寺	xue'dou'shan'zi'sheng'chan'si	0
雪窦寺	xue'dou'si	0
雪峰寺	xue'feng'si	0
雪霁便行	xue'ji'bian'xing	0
血经	xue'jing	0
血脉类集记	xue'mai'lei'ji'ji	0
血脉论	xue'mai'lun	0
学人	xue'ren	0
雪山	xue'shan	0
雪山部	xue'shan'bu	0
寻伺	xun'ci	0
寻佛	xun'fo	0
巡礼	xun'li	0
巡寮	xun'liao	0
薰陆香树	xun'lu'xiang'shu	0
巡堂	xun'tang	0
熏习	xun'xi	0
延宝传灯录	yan'bao'chuan'deng'lu	0
岩本裕	yan'ben'yu	0
彦琮	yan'cong	0
严佛调	yan'fo'tiao	0
阎浮树	yan'fu'shu	0
延福寺	yan'fu'si	0
阎浮檀金	yan'fu'tan'jin	0
阏伽	yan'ga	0
言教二谛	yan'jiao'er'di	0
眼净	yan'jing	0
颜娟英	yan'juan'ying	0
焰口	yan'kou	0
延历僧录	yan'li'seng'lu	0
延历寺	yan'li'si	0
延命地藏	yan'ming'di'zang	0
延命法	yan'ming'fa	0
阎魔王	yan'mo'wang	0
阎牟那河	yan'mou'na'he	0
延年转寿	yan'nian'zhuan'shou	0
演培	yan'pei	0
阎婆罗达耶怛特罗	yan'po'luo'da'ye'da'te'luo	0
颜尚文	yan'shang'wen	0
延寿堂	yan'shou'tang	0
言语道断	yan'yu'dao'duan	0
言语是心灵的图画	yan'yu'shi'xin'ling'de'tu'hua	0
颜宗养	yan'zong'yang	0
杨白衣	yang'bai'yi	0
仰兑	yang'dui	0
杨惠南	yang'hui'nan	0
央金珠白多杰	yang'jin'zhu'bai'duo'jie	0
鸯掘多罗国	yang'jue'duo'luo'guo	0
央掘摩罗	yang'jue'mo'luo	0
央掘魔罗经	yang'jue'mo'luo'jing	0
杨琏真加	yang'lian'zhen'jia	0
养鸬彻定	yang'lu'che'ding	0
杨岐方会和尚语录	yang'qi'fang'hui'he'shang'yu'lu	0
杨岐派	yang'qi'pai	0
杨文会	yang'wen'hui	0
杨郁文	yang'yu'wen	0
杨曾文	yang'zeng'wen	0
杨政河	yang'zheng'he	0
杨枝净水赞	yang'zhi'jing'shui'zan	0
咬空	yao'kong	0
药石	yao'shi	0
药师佛心咒	yao'shi'fo'xin'zhou	0
药师灌顶真言	yao'shi'guan'ding'zhen'yan	0
药师灌顶咒	yao'shi'guan'ding'zhou	0
药师光如来心咒	yao'shi'guang'ru'lai'xin'zhou	0
药师偈	yao'shi'ji	0
药师琉璃光如来本愿功德经	yao'shi'liu'li'guang'ru'lai'ben'yuan'gong'de'jing	0
藥師琉璃光如來灌顶真言	yao'shi'liu'li'guang'ru'lai'guan'ding'zhen'yan	0
药师琉璃光如来灌顶咒	yao'shi'liu'li'guang'ru'lai'guan'ding'zhou	0
药师如来	yao'shi'ru'lai	0
药师如来赞	yao'shi'ru'lai'zan	0
药师寺	yao'shi'si	0
摇树扫叶	yao'shu'sao'ye	0
药王菩萨	yao'wang'pu'sa	0
药王寺念佛堂	yao'wang'si'nian'fo'tang	0
姚兴	yao'xing	0
要眼珠	yao'yan'zhu	0
姚玉庆	yao'yu'qing	0
业	ye	0
叶阿月	ye'a'yue	0
业报	ye'bao	0
夜叉	ye'cha	0
夜船闲话	ye'chuan'xian'hua	0
业感缘起	ye'gan'yuan'qi	0
野狐禅	ye'hu'chan	0
业镜	ye'jing	0
叶均	ye'jun	0
冶开	ye'kai	0
耶律楚材	ye'lv'chu'cai	0
叶曼	ye'man	0
夜摩天	ye'mo'tian	0
夜柔吠陀	ye'rou'fei'tuo	0
耶若婆佉	ye'ruo'po'qu	0
耶舍	ye'she	0
也是恁么	ye'shi'nen'me	0
耶输陀罗	ye'shu'tuo'luo	0
业通	ye'tong	0
也协沃	ye'xie'wo	0
野鸭子	ye'ya'zi	0
叶衣佛母心咒	ye'yi'fo'mu'xin'zhou	0
夜游	ye'you	0
业障	ye'zhang	0
耶遮文约	ye'zhe'wen'yue	0
意	yi	0
异安心	yi'an'xin	0
一杯茶	yi'bei'cha	0
一本十支	yi'ben'shi'zhi	0
一遍	yi'bian	0
一遍上人语录	yi'bian'shang'ren'yu'lu	0
衣钵	yi'bo	0
衣钵簿	yi'bo'bu	0
异部宗轮论	yi'bu'zong'lun'lun	0
义操	yi'cao	0
一禅	yi'chan	0
一阐提	yi'chan'ti	0
义谌	yi'chen	0
一乘	yi'cheng	0
一乘戒坛院	yi'cheng'jie'tan'yuan	0
一乘决疑论	yi'cheng'jue'yi'lun	0
一乘思想	yi'cheng'si'xiang	0
一乘心法	yi'cheng'xin'fa	0
一乘要决	yi'cheng'yao'jue	0
一成一切成	yi'cheng'yi'qie'cheng	0
一乘院	yi'cheng'yuan	0
一乘真实	yi'cheng'zhen'shi	0
义楚	yi'chu	0
一初元禅师语录	yi'chu'yuan'chan'shi'yu'lu	0
义存	yi'cun	0
一大事因缘	yi'da'shi'yin'yuan	0
一刀三礼	yi'dao'san'li	0
一得一失	yi'de'yi'shi	0
依地	yi'di	0
一断一切断	yi'duan'yi'qie'duan	0
一多法界	yi'duo'fa'jie	0
忆儿时	yi'er'shi	0
一法界	yi'fa'jie	0
一法句	yi'fa'ju	0
一法印	yi'fa'yin	0
一分	yi'fen	0
一佛世界	yi'fo'shi'jie	0
义福	yi'fu	0
衣服吃饭	yi'fu'chi'fan	0
意根	yi'gen	0
一贯别传	yi'guan'bie'zhuan	0
一光三尊	yi'guang'san'zun	0
仪轨	yi'gui	0
义寂	yi'ji	0
一即一切	yi'ji'yi'qie	0
一髻尊陀罗尼经	yi'ji'zun'tuo'luo'ni'jing	0
一家一宗制	yi'jia'yi'zong'zhi	0
一角仙	yi'jiao'xian	0
译经	yi'jing	0
义净	yi'jing	0
一境三谛	yi'jing'san'di	0
一境四心	yi'jing'si'xin	0
译经院	yi'jing'yuan	0
一口吸尽西江水	yi'kou'xi'jin'xi'jiang'shui	0
一来果	yi'lai'guo	0
一来向	yi'lai'xiang	0
伊烂拏钵伐多国	yi'lan'na'bo'fa'duo'guo	0
一路顺风	yi'lu'shun'feng	0
伊罗钵多罗龙王	yi'luo'bo'duo'luo'long'wang	0
伊罗婆那龙象王	yi'luo'po'na'long'xiang'wang	0
伊吕波歌	yi'lv'bo'ge	0
一枚起请文	yi'mei'qi'qing'wen	0
一门普门	yi'men'pu'men	0
一名无量义	yi'ming'wu'liang'yi	0
宜默不宜喧	yi'mo'bu'yi'xuan	0
衣囊	yi'nang	0
一念不生	yi'nian'bu'sheng	0
一念三千	yi'nian'san'qian	0
一念相应	yi'nian'xiang'ying	0
一念信解	yi'nian'xin'jie	0
一念义	yi'nian'yi	0
一宁	yi'ning	0
一片菜叶	yi'pian'cai'ye	0
异品遍无性	yi'pin'bian'wu'xing	0
一起活埋	yi'qi'huo'mai	0
一切不执着	yi'qie'bu'zhi'zhuo	0
一切法	yi'qie'fa	0
一切法高王经	yi'qie'fa'gao'wang'jing	0
一切功德庄严王经	yi'qie'gong'de'zhuang'yan'wang'jing	0
一切皆禅	yi'qie'jie'chan	0
一切皆空	yi'qie'jie'kong	0
一切经	yi'qie'jing	0
一切经音义	yi'qie'jing'yin'yi	0
一切漏经	yi'qie'lou'jing	0
一切如来金刚三业最上祕密大教王经	yi'qie'ru'lai'jin'gang'san'ye'zui'shang'mi'mi'da'jiao'wang'jing	0
一切如来金刚寿命陀罗尼经	yi'qie'ru'lai'jin'gang'shou'ming'tuo'luo'ni'jing	0
一切如来真实摄大乘现证三昧大教王经	yi'qie'ru'lai'zhen'shi'she'da'cheng'xian'zheng'san'mei'da'jiao'wang'jing	0
一切善见律注	yi'qie'shan'jian'lv'zhu	0
一箧四蛇	yi'qie'si'she	0
一切现成	yi'qie'xian'cheng	0
一切行苦	yi'qie'xing'ku	0
一切由他	yi'qie'you'ta	0
一切智	yi'qie'zhi	0
一切智智	yi'qie'zhi'zhi	0
一切种智	yi'qie'zhong'zhi	0
一庆	yi'qing	0
义青	yi'qing	0
一然	yi'ran	0
一三权实	yi'san'quan'shi	0
一色一香无非中道	yi'se'yi'xiang'wu'fei'zhong'dao	0
一杀多生	yi'sha'duo'sheng	0
一山派	yi'shan'pai	0
伊舍那天	yi'she'na'tian	0
一生补处	yi'sheng'bu'chu	0
一声佛号一声心	yi'sheng'fo'hao'yi'sheng'xin	0
一生果遂	yi'sheng'guo'sui	0
意生身	yi'sheng'shen	0
一生万千	yi'sheng'wan'qian	0
异生性	yi'sheng'xing	0
一实	yi'shi	0
意识	yi'shi	0
伊师迦草	yi'shi'jia'cao	0
伊师迦山	yi'shi'jia'shan	0
一室六窗	yi'shi'liu'chuang	0
异熟	yi'shu	0
一说部	yi'shuo'bu	0
一丝不挂	yi'si'bu'gua	0
依他起性	yi'ta'qi'xing	0
依藤证信	yi'teng'zheng'xin	0
义天	yi'tian	0
义通	yi'tong	0
一味禅	yi'wei'chan	0
一味蕴	yi'wei'yun	0
意希班觉	yi'xi'ban'jue	0
一袭衲衣	yi'xi'na'yi	0
一袭纳衣	yi'xi'na'yi	0
一夏九旬	yi'xia'jiu'xun	0
夷夏论	yi'xia'lun	0
一向	yi'xiang	0
义湘	yi'xiang	0
一向一揆	yi'xiang'yi'kui	0
一向专修	yi'xiang'zhuan'xiu	0
一向宗	yi'xiang'zong	0
一心	yi'xin	0
一心不乱	yi'xin'bu'luan	0
以心传心	yi'xin'chuan'xin	0
一心二门	yi'xin'er'men	0
一心三观	yi'xin'san'guan	0
一心三惑	yi'xin'san'huo	0
一心三智	yi'xin'san'zhi	0
一行	yi'xing	0
易行道	yi'xing'dao	0
一性皆成	yi'xing'jie'cheng	0
一行三昧	yi'xing'san'mei	0
一休	yi'xiu	0
一休吃蜜	yi'xiu'chi'mi	0
一宿觉	yi'xiu'jue	0
一休晒藏经	yi'xiu'shai'cang'jing	0
一宿圣	yi'xiu'sheng	0
一休与五休	yi'xiu'yu'wu'xiu	0
义玄	yi'xuan	0
义邑	yi'yi	0
一义无量名	yi'yi'wu'liang'ming	0
一印会	yi'yin'hui	0
一音教	yi'yin'jiao	0
一优陀那	yi'you'tuo'na	0
一玉	yi'yu	0
一与三	yi'yu'san	0
一与十	yi'yu'shi	0
一圆	yi'yuan	0
一愿建立	yi'yuan'jian'li	0
意在钁头边	yi'zai'jue'tou'bian	0
依正二报	yi'zheng'er'bao	0
抑止	yi'zhi	0
一指禅	yi'zhi'chan	0
一指禅的故事	yi'zhi'chan'de'gu'shi	0
意志坚定的人	yi'zhi'jian'ding'de'ren	0
一只猪与一只鸡的一生	yi'zhi'zhu'yu'yi'zhi'ji'de'yi'sheng	0
一转语	yi'zhuan'yu	0
一字不说	yi'zi'bu'shuo	0
一字禅	yi'zi'chan	0
一子地	yi'zi'di	0
一字佛顶轮王经	yi'zi'fo'ding'lun'wang'jing	0
一字金轮	yi'zi'jin'lun	0
伊字三点	yi'zi'san'dian	0
一字文殊	yi'zi'wen'shu	0
一字咒	yi'zi'zhou	0
一宗构	yi'zong'gou	0
一镞破三关	yi'zu'po'san'guan	0
一遵	yi'zun	0
一尊佛	yi'zun'fo	0
衣座室三轨	yi'zuo'shi'san'gui	0
一坐四十年	yi'zuo'si'shi'nian	0
因	yin	0
银川市海宝塔寺	yin'chuan'shi'hai'bao'ta'si	0
印度	yin'du	0
印度佛教	yin'du'fo'jiao	0
印度佛教慈恩会	yin'du'fo'jiao'ci'en'hui	0
印度佛教协会	yin'du'fo'jiao'xie'hui	0
印度河文明	yin'du'he'wen'ming	0
印度文献史	yin'du'wen'xian'shi	0
因分	yin'fen	0
银阁寺	yin'ge'si	0
饮光	yin'guang	0
印光	yin'guang	0
饮光部	yin'guang'bu	0
因果	yin'guo	0
因果报应	yin'guo'bao'ying	0
印海	yin'hai	0
印坏文成	yin'huai'wen'cheng	0
银货两讫	yin'huo'liang'qi	0
印简	yin'jian	0
淫戒	yin'jie	0
饮酒戒	yin'jiu'jie	0
隐居地方	yin'ju'di'fang	0
印可	yin'ke	0
引路菩萨	yin'lu'pu'sa	0
因门六义	yin'men'liu'yi	0
隐祕念佛	yin'mi'nian'fo	0
因明八门	yin'ming'ba'men	0
因明入正理论	yin'ming'ru'zheng'li'lun	0
因明入正理论疏	yin'ming'ru'zheng'li'lun'shu	0
因明学	yin'ming'xue	0
因明义断	yin'ming'yi'duan	0
因明正理门论	yin'ming'zheng'li'men'lun	0
因能变	yin'neng'bian	0
印尼佛教	yin'ni'fo'jiao	0
印契	yin'qi	0
引磬	yin'qing	0
印融	yin'rong	0
因三相	yin'san'xiang	0
音声佛事	yin'sheng'fo'shi	0
引声念佛	yin'sheng'nian'fo	0
因十四过	yin'shi'si'guo	0
印顺	yin'shun	0
因陀罗	yin'tuo'luo	0
因陀罗布底	yin'tuo'luo'bu'di	0
因陀罗窟	yin'tuo'luo'ku	0
阴妄一念	yin'wang'yi'nian	0
隐形法	yin'xing'fa	0
引业	yin'ye	0
引因	yin'yin	0
印元	yin'yuan	0
因缘	yin'yuan	0
因缘变	yin'yuan'bian	0
因缘所成	yin'yuan'suo'cheng	0
因缘性	yin'yuan'xing	0
因缘依	yin'yuan'yi	0
因中无果	yin'zhong'wu'guo	0
因中有果	yin'zhong'you'guo	0
引座	yin'zuo	0
应和宗论	ying'he'zong'lun	0
应化	ying'hua	0
迎江寺	ying'jiang'si	0
应金玉堂	ying'jin'yu'tang	0
璎珞	ying'luo	0
应其	ying'qi	0
莹山清规	ying'shan'qing'gui	0
应身	ying'shen	0
应土	ying'tu	0
应县木塔	ying'xian'mu'ta	0
迎仙桥祗园寺	ying'xian'qiao'zhi'yuan'si	0
蝇子投窗	ying'zi'tou'chuang	0
用爱感动您的心	yong'ai'gan'dong'nin'de'xin	0
永安市圆明寺	yong'an'shi'yuan'ming'si	0
雍布拉岗	yong'bu'la'gang	0
永定	yong'ding	0
永观	yong'guan	0
雍和宫	yong'he'gong	0
用会作么	yong'hui'zuo'me	0
永嘉玄觉	yong'jia'xuan'jue	0
永嘉证道歌	yong'jia'zheng'dao'ge	0
永觉和尚广录	yong'jue'he'shang'guang'lu	0
永明延寿禅净四料简	yong'ming'yan'shou'chan'jing'si'liao'jian	0
永明智觉禅师唯心诀	yong'ming'zhi'jue'chan'shi'wei'xin'jue	0
踊念佛	yong'nian'fo	0
永宁禅寺	yong'ning'chan'si	0
永宁寺	yong'ning'si	0
永平广录	yong'ping'guang'lu	0
永平清规	yong'ping'qing'gui	0
永平寺	yong'ping'si	0
勇气	yong'qi	0
涌泉禅寺	yong'quan'chan'si	0
涌泉寺	yong'quan'si	0
永兴寺	yong'xing'si	0
永璵	yong'yu	0
永远相信	yong'yuan'xiang'xin	0
雍正	yong'zheng	0
永琢	yong'zuo	0
有	you	0
有边无边论	you'bian'wu'bian'lun	0
优波离	you'bo'li	0
优波离出家	you'bo'li'chu'jia	0
优钵罗华	you'bo'luo'hua	0
优波难陀龙王	you'bo'nan'tuo'long'wang	0
优波提舍	you'bo'ti'she	0
有顶天	you'ding'tian	0
有动定	you'dong'ding	0
有对	you'dui	0
有对触	you'dui'chu	0
有法差别相违因	you'fa'cha'bie'xiang'wei'yin	0
有法自相相违因	you'fa'zi'xiang'xiang'wei'yin	0
有分识	you'fen'shi	0
有佛无佛性相常住	you'fo'wu'fo'xing'xiang'chang'zhu	0
有覆无记	you'fu'wu'ji	0
有根身	you'gen'shen	0
有功用	you'gong'yong	0
祐国寺	you'guo'si	0
尤惠贞	you'hui'zhen	0
有教无人	you'jiao'wu'ren	0
有炯	you'jiong	0
有漏	you'lou	0
有漏道	you'lou'dao	0
有漏定	you'lou'ding	0
有漏断	you'lou'duan	0
有漏净土	you'lou'jing'tu	0
优楼频螺迦叶	you'lou'pin'luo'jia'ye	0
优楼频螺聚落	you'lou'pin'luo'ju'luo	0
优楼佉	you'lou'qu	0
有漏善	you'lou'shan	0
有漏识	you'lou'shi	0
有漏业	you'lou'ye	0
有漏智	you'lou'zhi	0
友梅	you'mei	0
佑宁寺	you'ning'si	0
优婆鞠多	you'po'ju'duo	0
优婆塞	you'po'sai	0
优婆塞戒经	you'po'sai'jie'jing	0
有庆	you'qing	0
有情	you'qing	0
有情数	you'qing'shu	0
右绕	you'rao	0
优尸罗	you'shi'luo	0
佑顺寺	you'shun'si	0
友松圆谛	you'song'yuan'di	0
有随眠心	you'sui'mian'xin	0
有所得	you'suo'de	0
有所依	you'suo'yi	0
有贪	you'tan	0
优昙跋罗	you'tan'ba'luo	0
有体	you'ti	0
优填王	you'tian'wang	0
优陀罗罗摩子	you'tuo'luo'luo'mo'zi	0
优陀那	you'tuo'na	0
有为	you'wei	0
有为无漏	you'wei'wu'lou	0
有为转变	you'wei'zhuan'bian	0
有我在	you'wo'zai	0
有想	you'xiang	0
有相	you'xiang	0
有相安乐行	you'xiang'an'le'xing	0
有相观	you'xiang'guan	0
有相无相曼荼罗	you'xiang'wu'xiang'man'tu'luo	0
游祥洲	you'xiang'zhou	0
有心人	you'xin'ren	0
有心位	you'xin'wei	0
游行	you'xing	0
有学	you'xue	0
由旬	you'xun	0
有寻有伺	you'xun'you'ci	0
有严	you'yan	0
有一	you'yi	0
有异熟	you'yi'shu	0
犹豫不成过	you'yu'bu'cheng'guo	0
有余涅槃	you'yu'nie'pan	0
有与无	you'yu'wu	0
有缘	you'yuan	0
有执受	you'zhi'shou	0
有支习气	you'zhi'xi'qi	0
有主物	you'zhu'wu	0
有作无作	you'zuo'wu'zuo	0
喻	yu	0
欲	yu	0
育才之道	yu'cai'zhi'dao	0
玉城康四郎	yu'cheng'kang'si'lang	0
宇多天皇	yu'duo'tian'huang	0
浴佛	yu'fo	0
浴佛偈	yu'fo'ji	0
玉佛寺	yu'fo'si	0
与佛同在	yu'fo'tong'zai	0
与佛无缘	yu'fo'wu'yuan	0
浴佛赞	yu'fo'zan	0
瑜伽师地论	yu'ga'shi'di'lun	0
郁伽长者	yu'ga'zhang'zhe	0
玉函山石窟	yu'han'shan'shi'ku	0
羽黑山	yu'hei'shan	0
玉华寺	yu'hua'si	0
玉皇观念佛堂	yu'huang'guan'nian'fo'tang	0
瑜伽	yu'jia	0
瑜伽经	yu'jia'jing	0
瑜伽行派	yu'jia'xing'pai	0
遇见阿弥陀佛	yu'jian'e'mi'tuo'fo	0
于教二谛	yu'jiao'er'di	0
欲界	yu'jie	0
宇井伯寿	yu'jing'bo'shou	0
俞净意公遇灶神记	yu'jing'yi'gong'yu'zao'shen'ji	0
于君方	yu'jun'fang	0
盂兰盆会	yu'lan'pen'hui	0
盂兰盆经	yu'lan'pen'jing	0
玉琳国师	yu'lin'guo'shi	0
榆林窟	yu'lin'ku	0
于凌波	yu'ling'bo	0
臾那世界国	yu'na'shi'jie'guo	0
余庆	yu'qing	0
玉泉寺	yu'quan'si	0
愚人的智慧	yu'ren'de'zhi'hui	0
于阗	yu'tian	0
愚秃钞	yu'tu'chao	0
羽溪了谛	yu'xi'le'di	0
雨行	yu'xing	0
预修十王生七经	yu'xiu'shi'wang'sheng'qi'jing	0
御选语录	yu'xuan'yu'lu	0
玉耶经	yu'ye'jing	0
虞愚	yu'yu	0
愚者智禅师语录	yu'zhe'zhi'chan'shi'yu'lu	0
御制拣魔辨异录	yu'zhi'jian'mo'bian'yi'lu	0
愿	yuan	0
缘悲藏	yuan'bei'cang	0
圆测	yuan'ce	0
元长	yuan'chang	0
圆澄	yuan'cheng	0
园城寺	yuan'cheng'si	0
元代佛教	yuan'dai'fo'jiao	0
原道辟邪说	yuan'dao'bi'xie'shuo	0
圆顿成佛论	yuan'dun'cheng'fo'lun	0
圆顿戒	yuan'dun'jie	0
圆顿止观	yuan'dun'zhi'guan	0
圆佛教	yuan'fo'jiao	0
元光	yuan'guang	0
圆光	yuan'guang	0
圆光寺	yuan'guang'si	0
元亨释书	yuan'heng'shi'shu	0
元亨寺	yuan'heng'si	0
圆教	yuan'jiao	0
元洁莹禅师语录	yuan'jie'ying'chan'shi'yu'lu	0
缘觉	yuan'jue	0
圆觉经	yuan'jue'jing	0
圆觉经道场修证仪	yuan'jue'jing'dao'chang'xiu'zheng'yi	0
园觉精舍	yuan'jue'jing'she	0
圆觉寺	yuan'jue'si	0
圆空	yuan'kong	0
源空	yuan'kong	0
元来	yuan'lai	0
缘理断九	yuan'li'duan'jiu	0
原理证得经	yuan'li'zheng'de'jing	0
圆梦	yuan'meng	0
圆密一致	yuan'mi'yi'zhi	0
元品无明	yuan'pin'wu'ming	0
缘起	yuan'qi	0
缘起观	yuan'qi'guan	0
缘起相由	yuan'qi'xiang'you	0
缘起性空	yuan'qi'xing'kong	0
缘切寺	yuan'qie'si	0
元庆	yuan'qing	0
源清	yuan'qing	0
圆仁	yuan'ren	0
原人论	yuan'ren'lun	0
圆融	yuan'rong	0
圆融之道	yuan'rong'zhi'dao	0
缘山三大藏目录	yuan'shan'san'da'zang'mu'lu	0
缘生法	yuan'sheng'fa	0
原始佛教	yuan'shi'fo'jiao	0
园田宗惠	yuan'tian'zong'hui	0
圆通	yuan'tong	0
圆通寺	yuan'tong'si	0
圆悟	yuan'wu	0
圆悟佛果禅师语录	yuan'wu'fo'guo'chan'shi'yu'lu	0
元贤	yuan'xian	0
元晓	yuan'xiao	0
源信	yuan'xin	0
元兴寺	yuan'xing'si	0
圆瑛	yuan'ying	0
元瑜	yuan'yu	0
圆泽禅师	yuan'ze'chan'shi	0
元昭	yuan'zhao	0
元照	yuan'zhao	0
圆照	yuan'zhao	0
圆珍	yuan'zhen	0
圆宗	yuan'zong	0
月爱三昧	yue'ai'san'mei	0
月不常住	yue'bu'chang'zhu	0
阅藏知津	yue'cang'zhi'jin	0
月称	yue'cheng	0
月船和尚	yue'chuan'he'shang	0
月灯三昧经	yue'deng'san'mei'jing	0
月顶	yue'ding	0
月官	yue'guan	0
月光菩萨	yue'guang'pu'sa	0
月精寺	yue'jing'si	0
月亮偷不去	yue'liang'tou'bu'qu	0
岳林寺	yue'lin'si	0
月轮观	yue'lun'guan	0
越南佛教	yue'nan'fo'jiao	0
越三昧耶罪	yue'san'mei'ye'zui	0
月上女经	yue'shang'nv'jing	0
月天	yue'tian	0
月霞	yue'xia	0
月性	yue'xing	0
月印释谱	yue'yin'shi'pu	0
月氏	yue'zhi	0
云版	yun'ban	0
运敞	yun'chang	0
运城市芮城县寿圣寺	yun'cheng'shi'rui'cheng'xian'shou'sheng'si	0
允汾	yun'fen	0
云福禅寺	yun'fu'chan'si	0
云冈石窟	yun'gang'shi'ku	0
云和狮山普仁寺	yun'he'shi'shan'pu'ren'si	0
云居山	yun'ju'shan	0
云居寺	yun'ju'si	0
允堪	yun'kan	0
云门匡真禅师广录	yun'men'kuang'zhen'chan'shi'guang'lu	0
云门麦浪怀禅师宗门设难	yun'men'mai'lang'huai'chan'shi'zong'men'she'nan	0
云门山	yun'men'shan	0
云门寺	yun'men'si	0
云门宗	yun'men'zong	0
云栖法汇	yun'qi'fa'hui	0
运庆	yun'qing	0
允若	yun'ruo	0
云水	yun'shui	0
云水禅心歌唱版	yun'shui'chan'xin'ge'chang'ban	0
云水随缘	yun'shui'sui'yuan	0
芸亭	yun'ting	0
云巖寺	yun'yan'si	0
云在青天水在瓶	yun'zai'qing'tian'shui'zai'ping	0
杂阿含经	za'a'han'jing	0
杂阿毗昙心论	za'a'pi'tan'xin'lun	0
杂宝藏经	za'bao'cang'jing	0
杂染	za'ran	0
杂修十三失	za'xiu'shi'san'shi	0
在家	zai'jia	0
再世人狗缘	zai'shi'ren'gou'yuan	0
赞	zan	0
赞佛偈	zan'fo'ji	0
赞宁	zan'ning	0
赞僧歌	zan'seng'ge	0
赞颂阿弥陀佛	zan'song'e'mi'tuo'fo	0
藏传大悲咒	zang'chuan'da'bei'zhou	0
葬法	zang'fa	0
早岛镜正	zao'dao'jing'zheng	0
澡豆	zao'dou	0
糟蹋者	zao'ta'zhe	0
造像量度经	zao'xiang'liang'du'jing	0
责骂与慈悲	ze'ma'yu'ci'bei	0
择灭	ze'mie	0
泽木兴道	ze'mu'xing'dao	0
贼住	zei'zhu	0
怎能会得	zen'neng'hui'de	0
增谷文雄	zeng'gu'wen'xiong	0
增上果	zeng'shang'guo	0
增上寺	zeng'shang'si	0
增上缘	zeng'shang'yuan	0
增壹阿含经	zeng'yi'a'han'jing	0
增益法	zeng'yi'fa	0
增语触	zeng'yu'chu	0
增长天	zeng'zhang'tian	0
增支部	zeng'zhi'bu	0
札仓	zha'cang	0
札什伦布寺	zha'shen'lun'bu'si	0
斋	zhai	0
宅磨派	zhai'mo'pai	0
瞻波国	zhan'bo'guo	0
瞻卜树	zhan'bo'shu	0
占察善恶业报经	zhan'cha'shan'e'ye'bao'jing	0
湛然寺	zhan'ran'si	0
湛山寺	zhan'shan'si	0
旃檀瑞像	zhan'tan'rui'xiang	0
旃檀树	zhan'tan'shu	0
旃陀罗	zhan'tuo'luo	0
战遮	zhan'zhe	0
战主国	zhan'zhu'guo	0
障碍别人就是障碍自己	zhang'ai'bie'ren'jiu'shi'zhang'ai'zi'ji	0
张澄基	zhang'cheng'ji	0
长老偈	zhang'lao'ji	0
杖林	zhang'lin	0
丈六佛	zhang'liu'fo	0
张曼涛	zhang'man'tao	0
彰所知论	zhang'suo'zhi'lun	0
张廷荣	zhang'ting'rong	0
掌中论	zhang'zhong'lun	0
找不回来	zhao'bu'hui'lai	0
找禅心	zhao'chan'xin	0
昭和法宝总目录	zhao'he'fa'bao'zong'mu'lu	0
昭慧	zhao'hui	0
昭觉寺	zhao'jue'si	0
赵亮杰	zhao'liang'jie	0
肇论	zhao'lun	0
昭明太子	zhao'ming'tai'zi	0
朝暮课诵	zhao'mu'ke'song	0
赵朴初	zhao'pu'chu	0
昭庆律寺	zhao'qing'lv'si	0
招提	zhao'ti	0
沼田惠范	zhao'tian'hui'fan	0
爪哇佛教	zhao'wa'fo'jiao	0
赵智凤	zhao'zhi'feng	0
赵州禅茶颂	zhao'zhou'chan'cha'song	0
赵州的佛	zhao'zhou'de'fo	0
赵州和尚语录	zhao'zhou'he'shang'yu'lu	0
赵州小便	zhao'zhou'xiao'bian	0
折伏摄受	zhe'fu'she'shou	0
磔迦国	zhe'jia'guo	0
浙江省金华龙盘寺	zhe'jiang'sheng'jin'hua'long'pan'si	0
遮戒	zhe'jie	0
遮那业	zhe'na'ye	0
遮诠	zhe'quan	0
赭时国	zhe'shi'guo	0
折疑论	zhe'yi'lun	0
真诚的世俗	zhen'cheng'de'shi'su	0
真放得下	zhen'fang'de'xia	0
振光	zhen'guang	0
镇海寺	zhen'hai'si	0
真华	zhen'hua	0
真慧寺	zhen'hui'si	0
真际禅林	zhen'ji'chan'lin	0
真假妄语	zhen'jia'wang'yu	0
镇将夜叉法	zhen'jiang'ye'cha'fa	0
真空妙有	zhen'kong'miao'you	0
真理运动	zhen'li'yun'dong	0
真理之如意宝珠	zhen'li'zhi'ru'yi'bao'zhu	0
真能立	zhen'neng'li	0
真能破	zhen'neng'po	0
真如	zhen'ru	0
真如门	zhen'ru'men	0
真如寺	zhen'ru'si	0
甄叔迦树	zhen'shu'jia'shu	0
真妄二心	zhen'wang'er'xin	0
真妄颂	zhen'wang'song	0
真唯识量	zhen'wei'shi'liang	0
珍惜现在	zhen'xi'xian'zai	0
真现量	zhen'xian'liang	0
真心不昧	zhen'xin'bu'mei	0
真心直说	zhen'xin'zhi'shuo	0
真言	zhen'yan	0
真言传	zhen'yan'chuan	0
真言律宗	zhen'yan'lv'zong	0
真言宗	zhen'yan'zong	0
贞元新定释教目录	zhen'yuan'xin'ding'shi'jiao'mu'lu	0
真正的自己	zhen'zheng'de'zi'ji	0
真正回答	zhen'zheng'hui'da	0
真宗十派	zhen'zong'shi'pai	0
诤	zheng	0
正报	zheng'bao	0
正仓院	zheng'cang'yuan	0
正彻	zheng'che	0
正澄	zheng'cheng	0
正道	zheng'dao	0
正定业	zheng'ding'ye	0
正法	zheng'fa	0
正法念处经	zheng'fa'nian'chu'jing	0
正法眼藏	zheng'fa'yan'zang	0
正法眼藏随闻记	zheng'fa'yan'zang'sui'wen'ji	0
正观	zheng'guan	0
正果	zheng'guo	0
正见	zheng'jian	0
正觉	zheng'jue	0
证空	zheng'kong	0
证空寺	zheng'kong'si	0
正理滴论	zheng'li'di'lun	0
正理经	zheng'li'jing	0
正量部	zheng'liang'bu	0
正念	zheng'nian	0
正使	zheng'shi	0
郑石岩	zheng'shi'yan	0
正像末	zheng'xiang'mo	0
正行	zheng'xing	0
正性离生	zheng'xing'li'sheng	0
郑学礼	zheng'xue'li	0
证严	zheng'yan	0
正喦	zheng'yan	0
证严法师开示	zheng'yan'fa'shi'kai'shi	0
正依傍依	zheng'yi'bang'yi	0
正杂二行	zheng'za'er'xing	0
郑振煌	zheng'zhen'huang	0
正智	zheng'zhi	0
正助二业	zheng'zhu'er'ye	0
正字与反字	zheng'zi'yu'fan'zi	0
智	zhi	0
治病真言	zhi'bing'zhen'yan	0
治禅病祕要法	zhi'chan'bing'mi'yao'fa	0
止持作持	zhi'chi'zuo'chi	0
智道	zhi'dao	0
指导论	zhi'dao'lun	0
志度寺	zhi'du'si	0
支遁	zhi'dun	0
质多	zhi'duo	0
制多山部	zhi'duo'shan'bu	0
止恶修善	zhi'e'xiu'shan	0
知恩报恩	zhi'en'bao'en	0
知恩寺	zhi'en'si	0
知恩院	zhi'en'yuan	0
支分生曼荼罗	zhi'fen'sheng'man'tu'luo	0
芝峰	zhi'feng	0
植福寺	zhi'fu'si	0
止贡噶举派	zhi'gong'ga'ju'pai	0
止贡寺	zhi'gong'si	0
止观	zhi'guan	0
只管打坐	zhi'guan'da'zuo	0
止观辅行传弘决	zhi'guan'fu'xing'chuan'hong'jue	0
止观业	zhi'guan'ye	0
陟岵寺	zhi'hu'si	0
智化寺	zhi'hua'si	0
智积院	zhi'ji'yuan	0
知客	zhi'ke	0
指空	zhi'kong	0
知礼	zhi'li	0
支娄迦谶	zhi'lou'jia'chen	0
支敏度	zhi'min'du	0
支那内学院	zhi'na'nei'xue'yuan	0
至那仆底国	zhi'na'pu'di'guo	0
知讷	zhi'ne	0
支谦	zhi'qian	0
纸钱	zhi'qian	0
知事	zhi'shi	0
只手之声	zhi'shou'zhi'sheng	0
支提	zhi'ti	0
支提国	zhi'ti'guo	0
支提山	zhi'ti'shan	0
支提寺	zhi'ti'si	0
织田得能	zhi'tian'de'neng	0
只为有所以来	zhi'wei'you'suo'yi'lai	0
止行二善	zhi'xing'er'shan	0
知玄	zhi'xuan	0
智严学院	zhi'yan'xue'yuan	0
智谕	zhi'yu	0
止雨法	zhi'yu'fa	0
知苑	zhi'yuan	0
至元法宝勘同总录	zhi'yuan'fa'bao'kan'tong'zong'lu	0
指月录	zhi'yue'lu	0
智增	zhi'zeng	0
制咤迦童子	zhi'zha'jia'tong'zi	0
直指寺	zhi'zhi'si	0
致中	zhi'zhong	0
执着	zhi'zhuo	0
钟	zhong	0
中阿含经	zhong'a'han'jing	0
中般涅槃	zhong'ban'nie'pan	0
中本起经	zhong'ben'qi'jing	0
冢本启祥	zhong'ben'qi'xiang	0
冢本善隆	zhong'ben'shan'long	0
中部	zhong'bu	0
中村瑞隆	zhong'cun'rui'long	0
中村元	zhong'cun'yuan	0
中道	zhong'dao	0
中谛	zhong'di	0
中峰和尚广录	zhong'feng'he'shang'guang'lu	0
中宫寺	zhong'gong'si	0
中观部	zhong'guan'bu	0
中观论疏	zhong'guan'lun'shu	0
中观派	zhong'guan'pai	0
中观破迷执论	zhong'guan'po'mi'zhi'lun	0
中观心论颂	zhong'guan'xin'lun'song	0
中观庄严论	zhong'guan'zhuang'yan'lun	0
中国	zhong'guo	0
中国佛教	zhong'guo'fo'jiao	0
中国佛教会	zhong'guo'fo'jiao'hui	0
中国佛教协会	zhong'guo'fo'jiao'xie'hui	0
中国佛寺志	zhong'guo'fo'si'zhi	0
中国太原武医禅院	zhong'guo'tai'yuan'wu'yi'chan'yuan	0
众合地狱	zhong'he'di'yu	0
中华大藏经	zhong'hua'da'zang'jing	0
中间静虑	zhong'jian'jing'lv	0
重解悟与重证悟	zhong'jie'wu'yu'zhong'zheng'wu	0
中津	zhong'jin	0
重龙山摩崖造像	zhong'long'shan'mo'ya'zao'xiang	0
中论	zhong'lun	0
终南山	zhong'nan'shan	0
中宁大佛殿	zhong'ning'da'fo'dian	0
中普陀寺	zhong'pu'tuo'si	0
中神宗	zhong'shen'zong	0
中圣	zhong'sheng	0
众圣点记	zhong'sheng'dian'ji	0
重松俊章	zhong'song'jun'zhang	0
仲算	zhong'suan	0
中台八叶院	zhong'tai'ba'ye'yuan	0
中天竺	zhong'tian'zhu	0
中天竺舍卫国祇洹寺图经	zhong'tian'zhu'she'wei'guo'chi'huan'si'tu'jing	0
众同分	zhong'tong'fen	0
中外日报	zhong'wai'ri'bao	0
中西牛郎	zhong'xi'niu'lang	0
重显	zhong'xian	0
种性	zhong'xing	0
种姓制度	zhong'xing'zhi'du	0
众许摩诃帝经	zhong'xu'mo'he'di'jing	0
众学法	zhong'xue'fa	0
忠寻	zhong'xun	0
中亚佛教	zhong'ya'fo'jiao	0
中巖派	zhong'yan'pai	0
中野达慧	zhong'ye'da'hui	0
中野义照	zhong'ye'yi'zhao	0
中阴经	zhong'yin'jing	0
中阴救度法	zhong'yin'jiu'du'fa	0
中有	zhong'you	0
种智院大学	zhong'zhi'yuan'da'xue	0
种子	zhong'zi	0
中尊	zhong'zun	0
中尊寺	zhong'zun'si	0
咒	zhou	0
粥	zhou	0
周安士	zhou'an'shi	0
周伯戡	zhou'bo'kan	0
周及	zhou'ji	0
周利槃陀迦	zhou'li'pan'tuo'jia	0
周良	zhou'liang	0
舟桥一哉	zhou'qiao'yi'zai	0
周叔迦	zhou'shu'jia	0
周信	zhou'xin	0
周宣德	zhou'xuan'de	0
周顒	zhou'yong	0
粥与茶	zhou'yu'cha	0
咒愿	zhou'yuan	0
周知册	zhou'zhi'ce	0
主巴噶举派	zhu'ba'ga'ju'pai	0
竹篦	zhu'bi	0
住持	zhu'chi	0
竹窗随笔	zhu'chuang'sui'bi	0
住定菩萨	zhu'ding'pu'sa	0
竺法护	zhu'fa'hu	0
竺法兰	zhu'fa'lan	0
竺法汰	zhu'fa'tai	0
诸法无行经	zhu'fa'wu'xing'jing	0
竺法雅	zhu'fa'ya	0
朱斐	zhu'fei	0
诸佛不欺	zhu'fo'bu'qi	0
诸行无常	zhu'hang'wu'chang	0
诸经要集	zhu'jing'yao'ji	0
朱利安	zhu'li'an	0
住莲	zhu'lian	0
竹林派	zhu'lin'pai	0
竹林寺	zhu'lin'si	0
竺摩	zhu'mo	0
助念	zhu'nian	0
竺潜	zhu'qian	0
朱伞	zhu'san	0
竺沙雅章	zhu'sha'ya'zhang	0
祝圣寺	zhu'sheng'si	0
朱士行	zhu'shi'xing	0
竺叔兰	zhu'shu'lan	0
诸说不同记	zhu'shuo'bu'tong'ji	0
诸天传	zhu'tian'chuan	0
驻锡	zhu'xi	0
竹溪寺	zhu'xi'si	0
炷香增福	zhu'xiang'zeng'fu	0
注心赋	zhu'xin'fu	0
茱萸寺	zhu'yu'si	0
煮云	zhu'yun	0
转变	zhuan'bian	0
转道	zhuan'dao	0
转法轮	zhuan'fa'lun	0
转逢	zhuan'feng	0
转根	zhuan'gen	0
撰集百缘经	zhuan'ji'bai'yuan'jing	0
转经	zhuan'jing	0
转女成男	zhuan'nv'cheng'nan	0
转识	zhuan'shi	0
转识得智	zhuan'shi'de'zhi	0
转依	zhuan'yi	0
幢	zhuang	0
庄严	zhuang'yan	0
庄严寺	zhuang'yan'si	0
撞钟征收令	zhuang'zhong'zheng'shou'ling	0
庄周梦蝶	zhuang'zhou'meng'die	0
准提菩萨	zhun'ti'pu'sa	0
准提咒	zhun'ti'zhou	0
拙火定	zhuo'huo'ding	0
卓尼寺	zhuo'ni'si	0
涿州市海禅林寺	zhuo'zhou'shi'hai'chan'lin'si	0
涿州市天国寺	zhuo'zhou'shi'tian'guo'si	0
紫柏尊者全集	zi'bai'zun'zhe'quan'ji	0
自忏忏他	zi'chan'chan'ta	0
自超	zi'chao	0
子淳	zi'chun	0
子聪	zi'cong	0
自得禅师语录	zi'de'chan'shi'yu'lu	0
子合国	zi'he'guo	0
自教相违过	zi'jiao'xiang'wei'guo	0
字界	zi'jie	0
自觉	zi'jue	0
自利	zi'li	0
自力	zi'li	0
自立论证派	zi'li'lun'zheng'pai	0
资粮	zi'liang	0
字轮观	zi'lun'guan	0
字门	zi'men	0
缁门崇行录	zi'men'chong'xing'lu	0
缁门警训	zi'men'jing'xun	0
缁门世谱	zi'men'shi'pu	0
姊崎正治	zi'qi'zheng'zhi	0
自然风光	zi'ran'feng'guang	0
自然智	zi'ran'zhi	0
自如	zi'ru	0
自伞自度	zi'san'zi'du	0
自誓得戒	zi'shi'de'jie	0
自受法乐	zi'shou'fa'yue	0
自说经	zi'shuo'jing	0
子孙庙	zi'sun'miao	0
子昙	zi'tan	0
子温	zi'wen	0
自我偈	zi'wo'ji	0
自相	zi'xiang	0
字相	zi'xiang	0
自相惑	zi'xiang'huo	0
自性	zi'xing	0
自性分别	zi'xing'fen'bie	0
自性清净佛性观	zi'xing'qing'jing'fo'xing'guan	0
自性清净心	zi'xing'qing'jing'xin	0
自性身	zi'xing'shen	0
自性唯心	zi'xing'wei'xin	0
自性与法性	zi'xing'yu'fa'xing	0
子璇	zi'xuan	0
自业自得	zi'ye'zi'de	0
子仪	zi'yi	0
字义	zi'yi	0
紫衣	zi'yi	0
缁衣	zi'yi	0
自语相违过	zi'yu'xiang'wei'guo	0
子元	zi'yuan	0
字缘	zi'yuan	0
紫云寺	zi'yun'si	0
自在	zi'zai	0
自赞毁他	zi'zan'hui'ta	0
自知录	zi'zhi'lu	0
自恣	zi'zi	0
宗	zong	0
宗宝	zong'bao	0
总报	zong'bao	0
宗本	zong'ben	0
宗炳	zong'bing	0
总持寺	zong'chi'si	0
摠持宗	zong'chi'zong	0
宗范	zong'fan	0
宗杲	zong'gao	0
宗教	zong'jiao	0
宗教律诸家演派	zong'jiao'lv'zhu'jia'yan'pai	0
宗镜录	zong'jing'lu	0
宗喀巴	zong'ka'ba	0
宗喀巴心咒	zong'ka'ba'xin'zhou	0
宗泐	zong'le	0
宗利	zong'li	0
宗璘	zong'lin	0
宗门	zong'men	0
宗门改	zong'men'gai	0
宗门或问	zong'men'huo'wen	0
宗门拈古汇集	zong'men'nian'gu'hui'ji	0
宗门千字文	zong'men'qian'zi'wen	0
宗门十规论	zong'men'shi'gui'lun	0
宗门统要续集	zong'men'tong'yao'xu'ji	0
宗门武库	zong'men'wu'ku	0
宗门玄鉴图	zong'men'xuan'jian'tu	0
宗密	zong'mi	0
宗彭	zong'peng	0
宗体	zong'ti	0
宗通	zong'tong	0
宗统编年	zong'tong'bian'nian	0
宗同品	zong'tong'pin	0
宗晓	zong'xiao	0
宗性	zong'xing	0
宗仰	zong'yang	0
宗养	zong'yang	0
宗依	zong'yi	0
宗异品	zong'yi'pin	0
宗义书	zong'yi'shu	0
宗印	zong'yin	0
宗赜	zong'ze	0
宗旨人别帐	zong'zhi'ren'bie'zhang	0
走不回来的小和尚	zou'bu'hui'lai'de'xiao'he'shang	0
走火入魔	zou'huo'ru'mo	0
祖灯大统	zu'deng'da'tong	0
祖堂集	zu'tang'ji	0
祖庭	zu'ting	0
祖庭事苑	zu'ting'shi'yuan	0
罪	zui	0
最后身	zui'hou'shen	0
最上乘论	zui'shang'cheng'lun	0
罪业	zui'ye	0
尊婆须蜜菩萨所集论	zun'po'xu'mi'pu'sa'suo'ji'lun	0
尊胜法	zun'sheng'fa	0
遵式	zun'shi	0
坐	zuo	0
座	zuo	0
佐伯定胤	zuo'bo'ding'yin	0
坐禅	zuo'chan	0
坐禅三昧经	zuo'chan'san'mei'jing	0
坐禅用心记	zuo'chan'yong'xin'ji	0
佐和隆研	zuo'he'long'yan	0
作么生	zuo'me'sheng	0
做女婿	zuo'nv'xu	0
佐钦寺	zuo'qin'si	0
做人不难	zuo'ren'bu'nan	0
作坛法	zuo'tan'fa	0
佐藤达玄	zuo'teng'da'xuan	0
佐藤贤顺	zuo'teng'xian'shun	0
佐田介石	zuo'tian'jie'shi	0
作业	zuo'ye	0
作意	zuo'yi	0
做一个最好的你	zuo'yi'ge'zui'hao'de'ni	0
作用	zuo'yong	0
作者	zuo'zhe	0
佐佐木教悟	zuo'zuo'mu'jiao'wu	0
佐佐木现顺	zuo'zuo'mu'xian'shun	0
佐佐木月樵	zuo'zuo'mu'yue'qiao	0
佐佐木指月	zuo'zuo'mu'zhi'yue	0
