拔人之城而非攻也	ba'ren'zhi'cheng'er'fei'gong'ye	0
百姓之费	bai'xing'zhi'fei	0
卑而骄之	bei'er'jiao'zhi	0
倍则分之	bei'ze'fen'zhi	0
必以全争于天下	bi'yi'quan'zheng'yu'tian'xia	0
宾客之用	bin'ke'zhi'yong	0
兵法	bing'fa	0
兵众孰强	bing'zhong'shu'qiang	0
不贵久	bu'gui'jiu	0
不可不察也	bu'ke'bu'cha'ye	0
不可先传也	bu'ke'xian'chuan'ye	0
不若则能避之	bu'ruo'ze'neng'bi'zhi	0
不战而屈人之兵	bu'zhan'er'qu'ren'zhi'bing	0
不知彼而知己	bu'zhi'bi'er'zhi'ji	0
不知军之不可以进而谓之进	bu'zhi'jun'zhi'bu'ke'yi'jin'er'wei'zhi'jin	0
不知军之不可以退而谓之退	bu'zhi'jun'zhi'bu'ke'yi'tui'er'wei'zhi'tui	0
不知三军之权而同三军之任	bu'zhi'san'jun'zhi'quan'er'tong'san'jun'zhi'ren	0
不知三军之事而同三军之政	bu'zhi'san'jun'zhi'shi'er'tong'san'jun'zhi'zheng	0
不知之者不胜	bu'zhi'zhi'zhe'bu'sheng	0
财竭则急于丘役	cai'jie'ze'ji'yu'qiu'yi	0
车甲之奉	che'jia'zhi'feng	0
车杂而乘之	che'za'er'cheng'zhi	0
车战得车十乘以上	che'zhan'de'che'shi'cheng'yi'shang	0
驰车千驷	chi'che'qian'si	0
出其不意	chu'qi'bu'yi	0
此兵家之胜	ci'bing'jia'zhi'sheng	0
此攻之灾也	ci'gong'zhi'zai'ye	0
此谋攻之法也	ci'mou'gong'zhi'fa'ye	0
此五者	ci'wu'zhe	0
存亡之道	cun'wang'zhi'dao	0
大敌之擒也	da'di'zhi'qin'ye	0
带甲十万	dai'jia'shi'wan	0
当吾二十石	dang'wu'er'shi'shi	0
当吾二十钟	dang'wu'er'shi'zhong	0
道者	dao'zhe	0
得算多也	de'suan'duo'ye	0
得算少也	de'suan'shao'ye	0
敌则能战之	di'ze'neng'zhan'zhi	0
地者	di'zhe	0
多算胜少算	duo'suan'sheng'shao'suan	0
而不危也	er'bu'wei'ye	0
而城不拔者	er'cheng'bu'ba'zhe	0
而况于无算乎	er'kuang'yu'wu'suan'hu	0
而索其情	er'suo'qi'qing	0
二曰天	er'yue'tian	0
法令孰行	fa'ling'shu'xing	0
法者	fa'zhe	0
凡此五者	fan'ci'wu'zhe	0
凡用兵之法	fan'yong'bing'zhi'fa	0
非善之善也	fei'shan'zhi'shan'ye	0
夫兵久而国利者	fu'bing'jiu'er'guo'li'zhe	0
夫钝兵挫锐	fu'dun'bing'cuo'rui	0
夫将者	fu'jiang'zhe	0
夫未战而庙算胜者	fu'wei'zhan'er'miao'suan'sheng'zhe	0
辅隙则国必弱	fu'xi'ze'guo'bi'ruo	0
夫用兵之法	fu'yong'bing'zhi'fa	0
辅周则国必强	fu'zhou'ze'guo'bi'qiang	0
杆一石	gan'yi'dan	0
革车千乘	ge'che'qian'sheng	0
攻城则力屈	gong'cheng'ze'li'qu	0
攻城之法	gong'cheng'zhi'fa	0
公家之费	gong'jia'zhi'fei	0
攻其无备	gong'qi'wu'bei	0
故兵不顿而利可全	gu'bing'bu'dun'er'li'ke'quan	0
故兵贵胜	gu'bing'gui'sheng	0
故兵闻拙速未睹巧之久也	gu'bing'wen'zhuo'su'wei'du'qiao'zhi'jiu'ye	0
故不尽知用兵之害者	gu'bu'jin'zhi'yong'bing'zhi'hai'zhe	0
故经之以五事	gu'jing'zhi'yi'wu'shi	0
故军食可足也	gu'jun'shi'ke'zu'ye	0
故君之所以患于军者三	gu'jun'zhi'suo'yi'huan'yu'jun'zhe'san	0
故能而示之不能	gu'neng'er'shi'zhi'bu'neng	0
故杀敌者	gu'sha'di'zhe	0
故善用兵者	gu'shan'yong'bing'zhe	0
故上兵伐谋	gu'shang'bing'fa'mou	0
故小敌之坚	gu'xiao'di'zhi'jian	0
故校之以计	gu'xiao'zhi'yi'ji	0
故用兵之法	gu'yong'bing'zhi'fa	0
故知兵之将	gu'zhi'bing'zhi'jiang	0
故智将务食于敌	gu'zhi'jiang'wu'shi'yu'di	0
故知胜有五	gu'zhi'sheng'you'wu	0
官道	guan'dao	0
广狭	guang'xia	0
诡道也	gui'dao'ye	0
贵卖则百姓财竭	gui'mai'ze'bai'xing'cai'jie	0
国家安危之主也	guo'jia'an'wei'zhi'zhu'ye	0
国之大事	guo'zhi'da'shi	0
国之辅也	guo'zhi'fu'ye	0
国之贫于师者远输	guo'zhi'pin'yu'shi'zhe'yuan'shu	0
毁人之国而非久也	hui'ren'zhi'guo'er'fei'jiu'ye	0
货也	huo'ye	0
戟盾矛橹	ji'dun'mao'lu	0
计利以听	ji'li'yi'ting	0
甲胄矢弓	jia'zhou'shi'gong	0
将不胜其忿而蚁附之	jiang'bu'sheng'qi'fen'er'yi'fu'zhi	0
将莫不闻	jiang'mo'bu'wen	0
将能而君不御者胜	jiang'neng'er'jun'bu'yu'zhe'sheng	0
将孰有能	jiang'shu'you'neng	0
将听吾计	jiang'ting'wu'ji	0
将者	jiang'zhe	0
胶漆之材	jiao'qi'zhi'cai	0
近而示之远	jin'er'shi'zhi'yuan	0
近师者贵卖	jin'shi'zhe'gui'mai	0
久暴师则国用不足	jiu'bao'shi'ze'guo'yong'bu'zu	0
距堙	ju'yin	0
可与之生	ke'yu'zhi'sheng	0
可与之死	ke'yu'zhi'si	0
利而诱之	li'er'you'zhi	0
力屈中原	li'qu'zhong'yuan	0
粮不三载	liang'bu'san'zai	0
令民于上同意	ling'min'yu'shang'tong'yi	0
留之将不听吾计	liu'zhi'jiang'bu'ting'wu'ji	0
乱而取之	luan'er'qu'zhi	0
民之司命	min'zhi'si'ming	0
谋攻第三	mou'gong'di'san	0
乃为之势	nai'wei'zhi'shi	0
内虚于家	nei'xu'yu'jia	0
怒而挠之	nu'er'nao'zhi	0
怒也	nu'ye	0
破国次之	po'guo'ci'zhi	0
破军罢马	po'jun'ba'ma	0
破军次之	po'jun'ci'zhi	0
破伍次之	po'wu'ci'zhi	0
破卒次之	po'zu'ci'zhi	0
其次伐兵	qi'ci'fa'bing	0
其次伐交	qi'ci'fa'jiao	0
其下攻城	qi'xia'gong'cheng	0
其用战也	qi'yong'zhan'ye	0
千里馈粮	qian'li'kui'liang	0
强而避之	qiang'er'bi'zhi	0
亲而离之	qin'er'li'zhi	0
丘牛大车	qiu'niu'da'che	0
取敌之利者	qu'di'zhi'li'zhe	0
屈力殚货	qu'li'dan'huo	0
屈人之兵而非战也	qu'ren'zhi'bing'er'fei'zhan'ye	0
取用于国	qu'yong'yu'guo	0
去之	qu'zhi	0
曲制	qu'zhi	0
全国为上	quan'guo'wei'shang	0
全军为上	quan'jun'wei'shang	0
全旅为上破旅次之	quan'lv'wei'shang'po'lv'ci'zhi	0
全伍为上	quan'wu'wei'shang	0
全卒为上	quan'zu'wei'shang	0
然后十万之师举矣	ran'hou'shi'wan'zhi'shi'ju'yi	0
日费千金	ri'fei'qian'jin	0
三军既惑且疑	san'jun'ji'huo'qie'yi	0
三曰地	san'yue'di	0
三月而后成	san'yue'er'hou'cheng	0
杀士卒三分之一	sha'shi'zu'san'fen'zhi'yi	0
善用兵者	shan'yong'bing'zhe	0
善之善者也	shan'zhi'shan'zhe'ye	0
赏罚孰明	shang'fa'shu'ming	0
赏其先得者而更其旌旗	shang'qi'xian'de'zhe'er'geng'qi'jing'qi	0
上下同欲者胜	shang'xia'tong'yu'zhe'sheng	0
少则能逃之	shao'ze'neng'tao'zhi	0
胜负见矣	sheng'fu'jian'yi	0
胜久则钝兵挫锐	sheng'jiu'ze'dun'bing'cuo'rui	0
食敌一钟	shi'di'yi'zhong	0
实而备之	shi'er'bei'zhi	0
是故百战百胜	shi'gu'bai'zhan'bai'sheng	0
始计第一	shi'ji'di'yi	0
十去其六	shi'qu'qi'liu	0
十去其七	shi'qu'qi'qi	0
是谓乱军引胜	shi'wei'luan'jun'yin'sheng	0
是谓縻军	shi'wei'mi'jun	0
是谓胜敌而益强	shi'wei'sheng'di'er'yi'qiang	0
十则围之	shi'ze'wei'zhi	0
势者	shi'zhe	0
识众寡之用者胜	shi'zhong'gua'zhi'yong'zhe'sheng	0
士卒孰练	shi'zu'shu'lian	0
死生也	si'sheng'ye	0
死生之地	si'sheng'zhi'di	0
四曰将	si'yue'jiang	0
虽有智者不能善其后矣	sui'you'zhi'zhe'bu'neng'shan'qi'hou'yi	0
天地孰得	tian'di'shu'de	0
天者时制也	tian'zhe'shi'zhi'ye	0
为不得已	wei'bu'de'yi	0
未战而庙算不胜者	wei'zhan'er'miao'suan'bu'sheng'zhe	0
未之有也	wei'zhi'you'ye	0
吾以此观之	wu'yi'ci'guan'zhi	0
吾以此知胜负矣	wu'yi'ci'zhi'sheng'fu'yi	0
五曰法	wu'yue'fa	0
五则攻之	wu'ze'gong'zhi	0
险易	xian'yi	0
校之以计	xiao'zhi'yi'ji	0
修橹具器械	xiu'lu'ju'qi'xie	0
役不再籍	yi'bu'zai'ji	0
佚而劳之	yi'er'lao'zhi	0
以虞待不虞者胜	yi'yu'dai'bu'yu'zhe'sheng	0
一曰道	yi'yue'dao	0
以佐其外	yi'zuo'qi'wai	0
因利而制权也	yin'li'er'zhi'quan'ye	0
因粮于敌	yin'liang'yu'di	0
用而示之不用	yong'er'shi'zhi'bu'yong	0
用之必败	yong'zhi'bi'bai	0
用之必胜	yong'zhi'bi'sheng	0
又三月而后已	you'san'yue'er'hou'yi	0
远而示之近	yuan'er'shi'zhi'jin	0
远输则百姓贫	yuan'shu'ze'bai'xing'pin	0
则不能尽知用兵之利也	ze'bu'neng'jin'zhi'yong'bing'zhi'li'ye	0
则军士惑矣	ze'jun'shi'huo'yi	0
则军士疑矣	ze'jun'shi'yi'yi	0
则内外之费	ze'nei'wai'zhi'fei	0
则诸侯乘其弊而起	ze'zhu'hou'cheng'qi'bi'er'qi	0
则诸侯之难至矣	ze'zhu'hou'zhi'nan'zhi'yi	0
知己知彼百战不贻	zhi'ji'zhi'bi'bai'zhan'bu'yi	0
知可以战与不可以战者胜	zhi'ke'yi'zhan'yu'bu'ke'yi'zhan'zhe'sheng	0
知胜之道也	zhi'sheng'zhi'dao'ye	0
智信仁勇严也	zhi'xin'ren'yong'yan'ye	0
知之者胜	zhi'zhi'zhe'sheng	0
主孰有道	zhu'shu'you'dao	0
主用也	zhu'yong'ye	0
卒善而养之	zu'shan'er'yang'zhi	0
作战第二	zuo'zhan'di'er	0
