按股分红	an'gu'fen'hong	0
按劳分红	an'lao'fen'hong	0
安全生产责任制	an'quan'sheng'chan'ze'ren'zhi	0
巴克制	ba'ke'zhi	0
八小时工作制	ba'xiao'shi'gong'zuo'zhi	0
半失业	ban'shi'ye	0
本企业工龄	ben'qi'ye'gong'ling	0
编制定员	bian'zhi'ding'yuan	0
不劳动者不得食	bu'lao'dong'zhe'bu'de'shi	0
超额劳动报酬	chao'e'lao'dong'bao'chou	0
城镇劳动力平衡表	cheng'zhen'lao'dong'li'ping'heng'biao	0
出勤率	chu'qin'lv	0
待业人员	dai'ye'ren'yuan	0
定员	ding'yuan	0
定员标准	ding'yuan'biao'zhun	0
定员方法	ding'yuan'fang'fa	0
法定假日	fa'ding'jia'ri	0
非定额时间	fei'ding'e'shi'jian	0
非工伤	fei'gong'shang	0
非工伤事故	fei'gong'shang'shi'gu	0
非劳动收入	fei'lao'dong'shou'ru	0
非直接生产人员	fei'zhi'jie'sheng'chan'ren'yuan	0
各尽所能按劳分配	ge'jin'suo'neng'an'lao'fen'pei	0
各尽所能按需分配	ge'jin'suo'neng'an'xu'fen'pei	0
个体劳动者	ge'ti'lao'dong'zhe	0
工票	gong'piao	0
工日	gong'ri	0
工伤	gong'shang	0
工时	gong'shi	0
工时定额	gong'shi'ding'e	0
工时利用率	gong'shi'li'yong'lv	0
公务员制度	gong'wu'yuan'zhi'du	0
工序	gong'xu	0
工种	gong'zhong	0
工作时间	gong'zuo'shi'jian	0
固定工制度	gu'ding'gong'zhi'du	0
国家职工人数计划	guo'jia'zhi'gong'ren'shu'ji'hua	0
技工培训计划	ji'gong'pei'xun'ji'hua	0
计划外用工	ji'hua'wai'yong'gong	0
家务劳动	jia'wu'lao'dong	0
结构性失业	jie'gou'xing'shi'ye	0
就业率	jiu'ye'lv	0
考勤制度	kao'qin'zhi'du	0
劳动	lao'dong	0
劳动报酬	lao'dong'bao'chou	0
劳动保护	lao'dong'bao'hu	0
劳动保险	lao'dong'bao'xian	0
劳动定员	lao'dong'ding'yuan	0
劳动二重性	lao'dong'er'chong'xing	0
劳动负荷量	lao'dong'fu'he'liang	0
劳动服务公司	lao'dong'fu'wu'gong'si	0
劳动工作	lao'dong'gong'zuo	0
劳动管理	lao'dong'guan'li	0
劳动合同	lao'dong'he'tong	0
劳动计划	lao'dong'ji'hua	0
劳动积极性	lao'dong'ji'ji'xing	0
劳动纪律	lao'dong'ji'lv	0
劳动经济效益	lao'dong'jing'ji'xiao'yi	0
劳动就业	lao'dong'jiu'ye	0
劳动就业方针	lao'dong'jiu'ye'fang'zhen	0
劳动科学	lao'dong'ke'xue	0
劳动力分配	lao'dong'li'fen'pei	0
劳动力管理	lao'dong'li'guan'li	0
劳动力计划	lao'dong'li'ji'hua	0
劳动力流动	lao'dong'li'liu'dong	0
劳动力平衡表	lao'dong'li'ping'heng'biao	0
劳动力素质	lao'dong'li'su'zhi	0
劳动力调配	lao'dong'li'tiao'pei	0
劳动力资源	lao'dong'li'zi'yuan	0
劳动力资源量	lao'dong'li'zi'yuan'liang	0
劳动力资源率	lao'dong'li'zi'yuan'lv	0
劳动力资源总量	lao'dong'li'zi'yuan'zong'liang	0
劳动强度	lao'dong'qiang'du	0
劳动生产力	lao'dong'sheng'chan'li	0
劳动生产率计划	lao'dong'sheng'chan'lv'ji'hua	0
劳动生理学	lao'dong'sheng'li'xue	0
劳动熟练程度	lao'dong'shu'lian'cheng'du	0
劳动卫生	lao'dong'wei'sheng	0
劳动消耗	lao'dong'xiao'hao	0
劳动效益	lao'dong'xiao'yi	0
劳动心理学	lao'dong'xin'li'xue	0
劳动预备制度	lao'dong'yu'bei'zhi'du	0
劳动争议	lao'dong'zheng'yi	0
劳动制度	lao'dong'zhi'du	0
劳动组合	lao'dong'zu'he	0
劳务出口	lao'wu'chu'kou	0
劳务费	lao'wu'fei	0
劳务合作	lao'wu'he'zuo	0
劳务价格	lao'wu'jia'ge	0
利润分享	li'run'fen'xiang	0
离休	li'xiu	0
联产到劳	lian'chan'dao'lao	0
连续工龄	lian'xu'gong'ling	0
两种劳动制度	liang'zhong'lao'dong'zhi'du	0
聘任制	pin'ren'zhi	0
平均先进定额	ping'jun'xian'jin'ding'e	0
平准化法	ping'zhun'hua'fa	0
全员劳动生产率	quan'yuan'lao'dong'sheng'chan'lv	0
全员培训	quan'yuan'pei'xun	0
社会保险	she'hui'bao'xian	0
社会保障	she'hui'bao'zhang	0
社会保障制度	she'hui'bao'zhang'zhi'du	0
社会劳动力计划	she'hui'lao'dong'li'ji'hua	0
社会劳动力平衡表	she'hui'lao'dong'li'ping'heng'biao	0
社会劳动者	she'hui'lao'dong'zhe	0
实际工时	shi'ji'gong'shi	0
失业率	shi'ye'lv	0
特殊保护	te'shu'bao'hu	0
铁饭碗	tie'fan'wan	0
统包统配	tong'bao'tong'pei	0
同工同酬	tong'gong'tong'chou	0
退休	tui'xiu	0
退职	tui'zhi	0
先培训后就业	xian'pei'xun'hou'jiu'ye	0
医务劳动鉴定	yi'wu'lao'dong'jian'ding	0
用工制度	yong'gong'zhi'du	0
有效时间	you'xiao'shi'jian	0
职工自然减员	zhi'gong'zi'ran'jian'yuan	0
职业病	zhi'ye'bing	0
职业道德	zhi'ye'dao'de	0
