阿波罗之怒	a'bo'luo'zhi'nu	0
阿尔比河	a'er'bi'he	0
阿尔奎特	a'er'kui'te	0
艾米莉	ai'mi'li	0
艾塔矿石	ai'ta'kuang'shi	0
安德烈	an'de'lie	0
奥修	ao'xiu	0
巴兰榭庄园	ba'lan'xie'zhuang'yuan	0
拜尔罗	bai'er'luo	0
白金礼券	bai'jin'li'quan	0
暴龙短剑	bao'long'duan'jian	0
毕埃尔草原	bi'ai'er'cao'yuan	0
冰冻金枪鱼	bing'dong'jin'qiang'yu	0
冰封之地	bing'feng'zhi'di	0
冰蓝宝石之光	bing'lan'bao'shi'zhi'guang	0
冰魔塔	bing'mo'ta	0
冰魔雪域	bing'mo'xue'yu	0
冰蔷薇之刺	bing'qiang'wei'zhi'ci	0
冰雪圆舞之杖	bing'xue'yuan'wu'zhi'zhang	0
波尔德	bo'er'de	0
伯纳河支流	bo'na'he'zhi'liu	0
伯宁翰提督	bo'ning'han'ti'du	0
步枪枪刺	bu'qiang'qiang'ci	0
不死鸟拳套	bu'si'niao'quan'tao	0
采石场	cai'shi'chang	0
长斧守备	chang'fu'shou'bei	0
长剑守备	chang'jian'shou'bei	0
长剑双持	chang'jian'shuang'chi	0
炽晶释放者	chi'jing'shi'fang'zhe	0
炽热高原	chi're'gao'yuan	0
炽热之地	chi're'zhi'di	0
炽天使之吻	chi'tian'shi'zhi'wen	0
船長雷卡尔多	chuan'chang'lei'ka'er'duo	0
传送点守卫	chuan'song'dian'shou'wei	0
纯白之地	chun'bai'zhi'di	0
丛林前进基地	cong'lin'qian'jin'ji'di	0
大地毁灭者	da'di'hui'mie'zhe	0
大祭司权杖	da'ji'si'quan'zhang	0
大天使长之荣耀	da'tian'shi'chang'zhi'rong'yao	0
德弗利峡谷	de'fu'li'xia'gu	0
地精法杖	di'jing'fa'zhang	0
地下农场	di'xia'nong'chang	0
地狱尖啸	di'yu'jian'xiao	0
地狱熔岩尖刺	di'yu'rong'yan'jian'ci	0
毒弹之枪	du'dan'zhi'qiang	0
镀金霰弹枪	du'jin'xian'dan'qiang	0
毒之贪婪	du'zhi'tan'lan	0
多明戈	duo'ming'ge	0
恶灵法杖	e'ling'fa'zhang	0
恶魔击杀者	e'mo'ji'sha'zhe	0
恶魔山谷	e'mo'shan'gu	0
废弃码头	fei'qi'ma'tou	0
风灵射手	feng'ling'she'shou	0
弗雷西奥防御墙	fu'lei'xi'ao'fang'yu'qiang	0
弗雷西奥三岔口	fu'lei'xi'ao'san'cha'kou	0
格蕾丝	ge'lei'si	0
攻防平衡	gong'fang'ping'heng	0
光束枪	guang'shu'qiang	0
刽子手步枪	gui'zi'shou'bu'qiang	0
海神手镯	hai'shen'shou'zhuo	0
海王手镯	hai'wang'shou'zhuo	0
寒霜之刃	han'shuang'zhi'ren	0
和平使者	he'ping'shi'zhe	0
黑色休止符	hei'se'xiu'zhi'fu	0
黑铁凝固之力	hei'tie'ning'gu'zhi'li	0
黑叶	hei'ye	0
后膛燧发霰弹枪	hou'tang'sui'fa'xian'dan'qiang	0
黄金护腿	huang'jin'hu'tui	0
黄金礼券	huang'jin'li'quan	0
黄金铭文火炮	huang'jin'ming'wen'huo'pao	0
荒凉的绝壁	huang'liang'de'jue'bi	0
火树银花之环	huo'shu'yin'hua'zhi'huan	0
火焰之刃	huo'yan'zhi'ren	0
疾风腿法	ji'feng'tui'fa	0
击剑刺击	ji'jian'ci'ji	0
击剑横扫	ji'jian'heng'sao	0
击剑双持	ji'jian'shuang'chi	0
桀骜之刃	jie'ao'zhi'ren	0
杰克	jie'ke	0
金片	jin'pian	0
金蛇	jin'she	0
旧科贝拉港口	jiu'ke'bei'la'gang'kou	0
巨剑守备	ju'jian'shou'bei	0
巨剑之怒	ju'jian'zhi'nu	0
巨龙嘶吼之剑	ju'long'si'hou'zhi'jian	0
巨鸟长枪	ju'niao'chang'qiang	0
巨兽长枪	ju'shou'chang'qiang	0
角斗士之剑	jue'dou'shi'zhi'jian	0
军刀双持	jun'dao'shuang'chi	0
卡塞德拉矿石	ka'sai'de'la'kuang'shi	0
卡塔里瀑布	ka'ta'li'pu'bu	0
铠甲撕裂者	kai'jia'si'lie'zhe	0
凯特拉废墟	kai'te'la'fei'xu	0
凯特拉高原	kai'te'la'gao'yuan	0
凯特拉遗迹	kai'te'la'yi'ji	0
开拓王之剑	kai'tuo'wang'zhi'jian	0
抗剑劈砍	kang'jian'pi'kan	0
科贝拉	ke'bei'la	0
可可果	ke'ke'guo	0
克劳德	ke'lao'de	0
肯	ken	0
恐怖长戟死神镰刀	kong'bu'chang'ji'si'shen'lian'dao	0
恐龙嘶吼之剑	kong'long'si'hou'zhi'jian	0
恐龙屠杀者	kong'long'tu'sha'zhe	0
狂风切割者	kuang'feng'qie'ge'zhe	0
兰斯洛特之剑	lan'si'luo'te'zhi'jian	0
雷波多	lei'bo'duo	0
雷波多林顿男爵	lei'bo'duo'lin'dun'nan'jue	0
雷光剑	lei'guang'jian	0
雷霆战锤碎脊者	lei'ting'zhan'chui'sui'ji'zhe	0
雷霆之鸣	lei'ting'zhi'ming	0
雷霆之怒	lei'ting'zhi'nu	0
丽琦	li'qi	0
猎龙者步枪	lie'long'zhe'bu'qiang	0
猎龙者枪刺	lie'long'zhe'qiang'ci	0
猎魔之华月	lie'mo'zhi'hua'yue	0
猎鹰之月华	lie'ying'zhi'yue'hua	0
林顿	lin'dun	0
林顿男爵	lin'dun'nan'jue	0
隆德尔匕首	long'de'er'bi'shou	0
龙神弯刀	long'shen'wan'dao	0
龙鹰卫士	long'ying'wei'shi	0
龙之逆鳞	long'zhi'ni'lin	0
陆战攻城炮	lu'zhan'gong'cheng'pao	0
罗密欧	luo'mi'ou	0
玫瑰刀锋	mei'gui'dao'feng	0
猛龙护腿	meng'long'hu'tui	0
梦魇禁锢之环	meng'yan'jin'gu'zhi'huan	0
灭绝者皮萨罗	mie'jue'zhe'pi'sa'luo	0
冥王手镯	ming'wang'shou'zhuo	0
末日裁决者	mo'ri'cai'jue'zhe	0
女神之湖	nv'shen'zhi'hu	0
女巫峡谷	nv'wu'xia'gu	0
帕维亚	pa'wei'ya	0
强化守备	qiang'hua'shou'bei	0
切尼萨高原	qie'ni'sa'gao'yuan	0
轻吻之刃	qing'wen'zhi'ren	0
全自动霰弹枪	quan'zi'dong'xian'dan'qiang	0
萨里夫	sa'li'fu	0
塞莱斯湖	sai'lai'si'hu	0
杀人蜂刺	sha'ren'feng'ci	0
上古巨剑毁灭者	shang'gu'ju'jian'hui'mie'zhe	0
上古巨剑破天	shang'gu'ju'jian'po'tian	0
上古巨兽之臂	shang'gu'ju'shou'zhi'bi	0
摄魂者	she'hun'zhe	0
射手王道	she'shou'wang'dao	0
神秘护腿	shen'mi'hu'tui	0
神秘拳套	shen'mi'quan'tao	0
圣魂之刺	sheng'hun'zhi'ci	0
圣魂之宽恕	sheng'hun'zhi'kuan'shu	0
圣灵法杖	sheng'ling'fa'zhang	0
圣灵召唤	sheng'ling'zhao'huan	0
圣骑士之斧	sheng'qi'shi'zhi'fu	0
圣武士之锤	sheng'wu'shi'zhi'chui	0
死神侍者镰刀	si'shen'shi'zhe'lian'dao	0
苏浩	su'hao	0
塔尔格匕首	ta'er'ge'bi'shou	0
提斯丛林边缘	ti'si'cong'lin'bian'yuan	0
提斯丛林前部	ti'si'cong'lin'qian'bu	0
提斯丛林深处	ti'si'cong'lin'shen'chu	0
提斯丛林中部	ti'si'cong'lin'zhong'bu	0
天神之怒	tian'shen'zhi'nu	0
铁叉	tie'cha	0
挺枪守备	ting'qiang'shou'bei	0
铜片	tong'pian	0
突击者	tu'ji'zhe	0
突击者步枪	tu'ji'zhe'bu'qiang	0
图林根丛林	tu'lin'gen'cong'lin	0
拖剑劈砍	tuo'jian'pi'kan	0
弯刀劈砍	wan'dao'pi'kan	0
王宫花园	wang'gong'hua'yuan	0
亡灵狂徒之刃	wang'ling'kuang'tu'zhi'ren	0
亡灵战斧	wang'ling'zhan'fu	0
王者圣剑	wang'zhe'sheng'jian	0
星辰之痕	xing'chen'zhi'hen	0
星空使者	xing'kong'shi'zhe	0
雄狮平原	xiong'shi'ping'yuan	0
雄狮拳套	xiong'shi'quan'tao	0
旋风护腿	xuan'feng'hu'tui	0
雪崩手镯	xue'beng'shou'zhuo	0
雪人拳套	xue'ren'quan'tao	0
雪原护腿	xue'yuan'hu'tui	0
血月圆舞曲	xue'yue'yuan'wu'qu	0
雅克金火山口	ya'ke'jin'huo'shan'kou	0
雅克金巨斧	ya'ke'jin'ju'fu	0
雅克金巨剑	ya'ke'jin'ju'jian	0
雅克金熔岩高原	ya'ke'jin'rong'yan'gao'yuan	0
焰弯刀夜莺	yan'wan'dao'ye'ying	0
妖花恸哭之刺	yao'hua'tong'ku'zhi'ci	0
遗忘的废墟	yi'wang'de'fei'xu	0
银片	yin'pian	0
永恒百合	yong'heng'bai'he	0
永恒星辰	yong'heng'xing'chen	0
优质屠杀者	you'zhi'tu'sha'zhe	0
驭风枪	yu'feng'qiang	0
羽虹大剑	yu'hong'da'jian	0
远程狙击步枪	yuan'cheng'ju'ji'bu'qiang	0
远古的毒液	yuan'gu'de'du'ye	0
远古的恐怖	yuan'gu'de'kong'bu	0
远古的震撼	yuan'gu'de'zhen'han	0
越狱刀	yue'yu'dao	0
战锤守备	zhan'chui'shou'bei	0
针刺射手	zhen'ci'she'shou	0
征服者科特斯	zheng'fu'zhe'ke'te'si	0
征服者之锤	zheng'fu'zhe'zhi'chui	0
致命齿刃重剑	zhi'ming'chi'ren'zhong'jian	0
致命弯刀毒沙	zhi'ming'wan'dao'du'sha	0
终结者枪刺	zhong'jie'zhe'qiang'ci	0
自然拳法	zi'ran'quan'fa	0
自由搏击	zi'you'bo'ji	0
