阿贝多	a'bei'duo	0
阿贾克斯	a'jia'ke'si	0
阿莱夫	a'lai'fu	0
阿莫斯	a'mo'si	0
阿莫斯之弓	a'mo'si'zhi'gong	0
哀叙冰玉	ai'xu'bing'yu	0
安柏	an'bai	0
安德留斯	an'de'liu'si	0
奥藏山	ao'cang'shan	0
芭芭拉	ba'ba'la	0
巴巴托斯	ba'ba'tuo'si	0
霸体	ba'ti	0
白垩之章	bai'e'zhi'zhang	0
白垩之子	bai'e'zhi'zi	0
白影剑	bai'ying'jian	0
班尼特	ban'ni'te	0
爆弹丘丘人	bao'dan'qiu'qiu'ren	0
保底	bao'di	0
暴击	bao'ji	0
爆热旋律	bao're'xuan'lv	0
暴伤	bao'shang	0
爆炎树	bao'yan'shu	0
北斗	bei'dou	0
北风的魂匣	bei'feng'de'hun'xia	0
北风狼	bei'feng'lang	0
北风之环	bei'feng'zhi'huan	0
北风之王	bei'feng'zhi'wang	0
北风之尾	bei'feng'zhi'wei	0
被怜爱的少女	bei'lian'ai'de'shao'nv	0
贝特	bei'te	0
杯装之诗	bei'zhuang'zhi'shi	0
冰铳重卫士	bing'chong'zhong'wei'shi	0
冰弹丘丘人	bing'dan'qiu'qiu'ren	0
冰盾丘丘暴徒	bing'dun'qiu'qiu'bao'tu	0
冰风迷途的勇士	bing'feng'mi'tu'de'yong'shi	0
冰箭丘丘人	bing'jian'qiu'qiu'ren	0
冰丘丘萨满	bing'qiu'qiu'sa'man	0
冰雾花花朵	bing'wu'hua'hua'duo	0
冰萤术士	bing'ying'shu'shi	0
捕风瓶	bu'feng'ping	0
不祥的面具	bu'xiang'de'mian'ju	0
苍翠猎弓	cang'cui'lie'gong	0
藏金之花	cang'jin'zhi'hua	0
草丘丘萨满	cao'qiu'qiu'sa'man	0
层岩巨渊	ceng'yan'ju'yuan	0
长杓之章	chang'biao'zhi'zhang	0
长柄武器	chang'bing'wu'qi	0
常燃火种	chang'ran'huo'zhong	0
超导	chao'dao	0
超载	chao'zai	0
尘世闲游	chen'shi'xian'you	0
尘世之锁	chen'shi'zhi'suo	0
晨曦的暗面	chen'xi'de'an'mian	0
晨曦酒庄	chen'xi'jiu'zhuang	0
螭骨剑	chi'gu'jian	0
抽卡	chou'ka	0
传说任务	chuan'shuo'ren'wu	0
创世结晶	chuang'shi'jie'jing	0
纯水精灵	chun'shui'jing'ling	0
璀璨原钻	cui'can'yuan'zuan	0
翠玦坡	cui'jue'po	0
脆弱的骨片	cui'ruo'de'gu'pian	0
脆弱树脂	cui'ruo'shu'zhi	0
达达利亚	da'da'li'ya	0
达达乌帕谷	da'da'wu'pa'gu	0
大剑	da'jian	0
单手剑	dan'shou'jian	0
澹月	dan'yue	0
盗宝团	dao'bao'tuan	0
导能绘卷	dao'neng'hui'juan	0
迪奥娜	di'ao'na	0
荻花洲	di'hua'zhou	0
笛剑	di'jian	0
地灵龛	di'ling'kan	0
迪卢克	di'lu'ke	0
地脉	di'mai	0
地脉的旧枝	di'mai'de'jiu'zhi	0
地脉的枯叶	di'mai'de'ku'ye	0
地脉的新芽	di'mai'de'xin'ya	0
地脉异常	di'mai'yi'chang	0
地脉移涌	di'mai'yi'yong	0
地脉之花	di'mai'zhi'hua	0
地中之盐	di'zhong'zhi'yan	0
点赞哥	dian'zan'ge	0
迭卡拉庇安	die'ka'la'bi'an	0
冻冻回魂夜	dong'dong'hui'hun'ye	0
东风的吐息	dong'feng'de'tu'xi	0
东风之翎	dong'feng'zhi'ling	0
东风之爪	dong'feng'zhi'zhao	0
嘟嘟莲	du'du'lian	0
渡火	du'huo	0
杜林	du'lin	0
断罪皇女	duan'zui'huang'nv	0
遁玉陵	dun'yu'ling	0
法尔伽	fa'er'jia	0
法器	fa'qi	0
法书	fa'shu	0
繁荣的教导	fan'rong'de'jiao'dao	0
繁荣的指引	fan'rong'de'zhi'yin	0
绯红玉髓	fei'hong'yu'sui	0
菲谢尔	fei'xie'er	0
飞行冠军	fei'xing'guan'jun	0
芬德尼尔之顶	fen'de'ni'er'zhi'ding	0
风车菊	feng'che'ju	0
风晶蝶	feng'jing'die	0
风龙废墟	feng'long'fei'xu	0
封魔绘卷	feng'mo'hui'juan	0
风魔龙	feng'mo'long	0
风起地	feng'qi'di	0
风拳	feng'quan	0
风拳前锋军	feng'quan'qian'feng'jun	0
风色诗人	feng'se'shi'ren	0
风神瞳	feng'shen'tong	0
风神像	feng'shen'xiang	0
风鹰剑	feng'ying'jian	0
风之印	feng'zhi'yin	0
浮生孰来	fu'sheng'shu'lai	0
副属性	fu'shu'xing	0
覆雪之路	fu'xue'zhi'lu	0
福至五彩	fu'zhi'wu'cai	0
腐殖之剑	fu'zhi'zhi'jian	0
感电	gan'dian	0
甘雨	gan'yu	0
钢轮弓	gang'lun'gong	0
高塔孤王的残垣	gao'ta'gu'wang'de'can'yuan	0
高塔孤王的破瓦	gao'ta'gu'wang'de'po'wa	0
歌仙之章	ge'xian'zhi'zhang	0
弓藏	gong'cang	0
公子	gong'zi	0
钩钩果	gou'gou'guo	0
古恩希尔德	gu'en'xi'er'de	0
古华	gu'hua	0
古闻之章	gu'wen'zhi'zhang	0
孤云阁	gu'yun'ge	0
孤云寒林的光砂	gu'yun'han'lin'de'guang'sha	0
孤云凌霄之处	gu'yun'ling'xiao'zhi'chu	0
观测枢	guan'ce'shu	0
贯虹之槊	guan'hong'zhi'shuo	0
归离原	gui'li'yuan	0
果酒湖	guo'jiu'hu	0
海灯节	hai'deng'jie	0
寒风剑士	han'feng'jian'shi	0
寒天之钉	han'tian'zhi'ding	0
好感经验	hao'gan'jing'yan	0
核弹流	he'dan'liu	0
和璞鸢	he'pu'yuan	0
黑剑	hei'jian	0
黑铜号角	hei'tong'hao'jiao	0
黑岩长剑	hei'yan'chang'jian	0
黑岩刺枪	hei'yan'ci'qiang	0
黑岩绯玉	hei'yan'fei'yu	0
黑岩斩刀	hei'yan'zhan'dao	0
黑岩战弓	hei'yan'zhan'gong	0
恒常燃烧的巨藤	heng'chang'ran'shao'de'ju'teng	0
琥牢山	hu'lao'shan	0
胡桃	hu'tao	0
华池岩岫	hua'chi'yan'xiu	0
华光林	hua'guang'lin	0
黄金的教导	huang'jin'de'jiao'dao	0
黄金的哲学	huang'jin'de'zhe'xue	0
黄金的指引	huang'jin'de'zhi'yin	0
黄金屋	huang'jin'wu	0
皇女	huang'nv	0
徽记	hui'ji	0
混沌回路	hun'dun'hui'lu	0
混沌炉心	hun'dun'lu'xin	0
混沌装置	hun'dun'zhuang'zhi	0
火铳游击兵	huo'chong'you'ji'bing	0
火斧丘丘暴徒	huo'fu'qiu'qiu'bao'tu	0
火箭丘丘人	huo'jian'qiu'qiu'ren	0
急冻树	ji'dong'shu	0
机关棋谭	ji'guan'qi'tan	0
极寒的冰之花	ji'han'de'bing'zhi'hua	0
极寒之核	ji'han'zhi'he	0
祭礼残章	ji'li'can'zhang	0
祭礼大剑	ji'li'da'jian	0
祭礼弓	ji'li'gong	0
祭礼剑	ji'li'jian	0
基末尔	ji'mo'er	0
纪行	ji'xing	0
纪行经验	ji'xing'jing'yan	0
坚牢黄玉	jian'lao'huang'yu	0
降临之剑	jiang'lin'zhi'jian	0
结晶	jie'jing	0
结实的骨片	jie'shi'de'gu'pian	0
金珀	jin'po	0
锦织之章	jin'zhi'zhi'zhang	0
禁咒绘卷	jin'zhou'hui'juan	0
晶核	jing'he	0
静静绽放的霜花	jing'jing'zhan'fang'de'shuang'hua	0
净水之心	jing'shui'zhi'xin	0
鲸天之章	jing'tian'zhi'zhang	0
纠缠之缘	jiu'chan'zhi'yuan	0
飓风之种	ju'feng'zhi'zhong	0
决斗之枪	jue'dou'zhi'qiang	0
绝弦	jue'xian	0
绝云间	jue'yun'jian	0
绝云椒椒	jue'yun'jiao'jiao	0
凯亚	kai'ya	0
坎瑞亚	kan'rui'ya	0
抗争的教导	kang'zheng'de'jiao'dao	0
抗争的哲学	kang'zheng'de'zhe'xue	0
抗争的指引	kang'zheng'de'zhi'yin	0
可莉	ke'li	0
刻晴	ke'qing	0
孔雀羽之章	kong'que'yu'zhi'zhang	0
空之杯	kong'zhi'bei	0
口袋锚点	kou'dai'mao'dian	0
扩散	kuo'san	0
莱艮芬德	lai'gen'fen'de	0
狼末	lang'mo	0
狼少年	lang'shao'nian	0
牢固的箭簇	lao'gu'de'jian'cu	0
雷锤	lei'chui	0
雷锤前锋军	lei'chui'qian'feng'jun	0
雷光棱镜	lei'guang'leng'jing	0
雷箭丘丘人	lei'jian'qiu'qiu'ren	0
雷萤术士	lei'ying'shu'shi	0
雷泽	lei'ze	0
丽莎	li'sha	0
璃月	li'yue	0
理之冠	li'zhi'guan	0
猎兵祭刀	lie'bing'ji'dao	0
烈焰花	lie'yan'hua	0
凛风奔狼的裂齿	lin'feng'ben'lang'de'lie'chi	0
凛风奔狼的始龀	lin'feng'ben'lang'de'shi'chen	0
灵矩关	ling'ju'guan	0
零命	ling'ming	0
陵薮市朝	ling'sou'shi'chao	0
流放者	liu'fang'zhe	0
六翮奋彰	liu'he'fen'zhang	0
流浪大地乐团	liu'lang'da'di'yue'tuan	0
流浪乐章	liu'lang'yue'zhang	0
琉璃袋	liu'li'dai	0
流月针	liu'yue'zhen	0
龙脊长枪	long'ji'chang'qiang	0
龙脊雪山	long'ji'xue'shan	0
龙蜥寻踪	long'xi'xun'zong	0
渌华池	lu'hua'chi	0
卢姥爷	lu'lao'ye	0
洛蒂娅	luo'di'ya	0
落落莓	luo'luo'mei	0
罗莎莉亚	luo'sha'li'ya	0
旅行者	lv'xing'zhe	0
满命	man'ming	0
猫尾特调	mao'wei'te'tiao	0
冒险等阶	mao'xian'deng'jie	0
冒险家协会	mao'xian'jia'xie'hui	0
冒险阅历	mao'xian'yue'li	0
每日委托	mei'ri'wei'tuo	0
蒙德	meng'de	0
米哈游	mi'ha'you	0
秘境	mi'jing	0
米游社	mi'you'she	0
面板	mian'ban	0
眠龙谷	mian'long'gu	0
珉林	min'lin	0
明冠峡	ming'guan'xia	0
铭记之谷	ming'ji'zhi'gu	0
明霄升海平	ming'xiao'sheng'hai'ping	0
命运试金石	ming'yun'shi'jin'shi	0
明蕴镇	ming'yun'zhen	0
命之座	ming'zhi'zuo	0
摩拉	mo'la	0
摩拉克斯	mo'la'ke'si	0
莫娜	mo'na	0
魔女	mo'nv	0
魔神任务	mo'shen'ren'wu	0
木盾丘丘暴徒	mu'dun'qiu'qiu'bao'tu	0
慕风蘑菇	mu'feng'mo'gu	0
纳瓦	na'wa	0
南天门	nan'tian'men	0
霓裳花	ni'chang'hua	0
逆飞的流星	ni'fei'de'liu'xing	0
凝光	ning'guang	0
浓缩树脂	nong'suo'shu'zhi	0
怒放的火之花	nu'fang'de'huo'zhi'hua	0
诺艾尔	nuo'ai'er	0
派蒙	pai'meng	0
磐岩	pan'yan	0
配队	pei'dui	0
骗骗花	pian'pian'hua	0
骗骗花蜜	pian'pian'hua'mi	0
平雷	ping'lei	0
破损的面具	po'sun'de'mian'ju	0
普池	pu'chi	0
漆黑陨铁的一粒	qi'hei'yun'tie'de'yi'li	0
七七	qi'qi	0
启示之花	qi'shi'zhi'hua	0
七天神像	qi'tian'shen'xiang	0
祈愿	qi'yuan	0
千风神殿	qian'feng'shen'dian	0
蔷薇魔女	qiang'wei'mo'nv	0
勤劳的教导	qin'lao'de'jiao'dao	0
勤劳的哲学	qin'lao'de'zhe'xue	0
勤劳的指引	qin'lao'de'zhi'yin	0
轻策庄	qing'ce'zhuang	0
清泉镇	qing'quan'zhen	0
青墟浦	qing'xu'pu	0
庆云顶	qing'yun'ding	0
丘丘人	qiu'qiu'ren	0
丘丘霜铠王	qiu'qiu'shuang'kai'wang	0
丘丘岩盔王	qiu'qiu'yan'kui'wang	0
群玉阁	qun'yu'ge	0
染血骑士道	ran'xue'qi'shi'dao	0
燃愿玛瑙	ran'yuan'ma'nao	0
忍冬之果	ren'dong'zhi'guo	0
融化	rong'hua	0
如雷	ru'lei	0
锐利的箭簇	rui'li'de'jian'cu	0
若陀龙王	ruo'tuo'long'wang	0
萨满	sa'man	0
塞西莉亚花	sai'xi'li'ya'hua	0
塞西莉亚苗圃	sai'xi'li'ya'miao'pu	0
沙漏之章	sha'lou'zhi'zhang	0
砂糖	sha'tang	0
闪焰的驻足	shan'yan'de'zhu'zu	0
闪耀偶像	shan'yao'ou'xiang	0
少年春衫薄	shao'nian'chun'shan'bo	0
深境螺旋	shen'jing'luo'xuan	0
神里绫华	shen'li'ling'hua	0
深秘之息	shen'mi'zhi'xi	0
神铸赋形	shen'zhu'fu'xing	0
声望经验	sheng'wang'jing'yan	0
圣遗物	sheng'yi'wu	0
生之花	sheng'zhi'hua	0
士官的徽记	shi'guan'de'hui'ji	0
世界等级	shi'jie'deng'ji	0
世界任务	shi'jie'ren'wu	0
史莱姆	shi'lai'mu	0
史莱姆清	shi'lai'mu'qing	0
史莱姆原浆	shi'lai'mu'yuan'jiang	0
石门	shi'men	0
石珀	shi'po	0
诗文的教导	shi'wen'de'jiao'dao	0
诗文的哲学	shi'wen'de'zhe'xue	0
诗文的指引	shi'wen'de'zhi'yin	0
狮牙斗士的枷锁	shi'ya'dou'shi'de'jia'suo	0
狮牙骑士	shi'ya'qi'shi	0
誓言岬	shi'yan'jia	0
时之沙	shi'zhi'sha	0
试作斩岩	shi'zuo'zhan'yan	0
守护之心	shou'hu'zhi'xin	0
树脂	shu'zhi	0
双手剑	shuang'shou'jian	0
水铳重卫士	shui'chong'zhong'wei'shi	0
水丘丘萨满	shui'qiu'qiu'sa'man	0
四风守护	si'feng'shou'hu	0
四风原典	si'feng'yuan'dian	0
四叶草之章	si'ye'cao'zhi'zhang	0
死之羽	si'zhi'yu	0
碎冰	sui'bing	0
太山府	tai'shan'fu	0
逃跑的太阳	tao'pao'de'tai'yang	0
特工祭刀	te'gong'ji'dao	0
特瓦林	te'wa'lin	0
体力	ti'li	0
天地万象	tian'di'wan'xiang	0
天衡山	tian'heng'shan	0
天空岛	tian'kong'dao	0
天空之脊	tian'kong'zhi'ji	0
天空之卷	tian'kong'zhi'juan	0
天空之刃	tian'kong'zhi'ren	0
天空之翼	tian'kong'zhi'yi	0
天遒谷	tian'qiu'gu	0
铁蜂刺	tie'feng'ci	0
霆霓快雨	ting'ni'kuai'yu	0
吐息冰霜的巨藤	tu'xi'bing'shuang'de'ju'teng	0
万国诸海图谱	wan'guo'zhu'hai'tu'pu	0
万民百味	wan'min'bai'wei	0
望风角	wang'feng'jiao	0
望风山地	wang'feng'shan'di	0
忘却之峡	wang'que'zhi'xia	0
望舒客栈	wang'shu'ke'zhan	0
微光花蜜	wei'guang'hua'mi	0
未授勋之花	wei'shou'xun'zhi'hua	0
委托任务	wei'tuo'ren'wu	0
温迪	wen'di	0
无工之剑	wu'gong'zhi'jian	0
无害甜度	wu'hai'tian'du	0
雾海云间的汞丹	wu'hai'yun'jian'de'gong'dan	0
雾海云间的铅丹	wu'hai'yun'jian'de'qian'dan	0
污秽的面具	wu'hui'de'mian'ju	0
物理流	wu'li'liu	0
无冕的龙王	wu'mian'de'long'wang	0
无妄引咎密宫	wu'wang'yin'jiu'mi'gong	0
无相之风	wu'xiang'zhi'feng	0
无相之雷	wu'xiang'zhi'lei	0
无相之岩	wu'xiang'zhi'yan	0
雾虚草囊	wu'xu'cao'nang	0
雾虚灯芯	wu'xu'deng'xin	0
雾虚花粉	wu'xu'hua'fen	0
西风长枪	xi'feng'chang'qiang	0
西风大剑	xi'feng'da'jian	0
西风剑	xi'feng'jian	0
西风猎弓	xi'feng'lie'gong	0
西风秘典	xi'feng'mi'dian	0
西风骑士团	xi'feng'qi'shi'tuan	0
匣里龙吟	xia'li'long'yin	0
匣里灭辰	xia'li'mie'chen	0
匣里日月	xia'li'ri'yue	0
限定	xian'ding	0
仙灵	xian'ling	0
仙灵之庭	xian'ling'zhi'ting	0
香菱	xiang'ling	0
相遇之缘	xiang'yu'zhi'yuan	0
小灯草	xiao'deng'cao	0
小狼之章	xiao'lang'zhi'zhang	0
霄市	xiao'shi	0
小兔之章	xiao'tu'zhi'zhang	0
辛焱	xin'yan	0
星辉	xing'hui	0
星镰	xing'lian	0
星落湖	xing'luo'hu	0
行秋	xing'qiu	0
星天水镜	xing'tian'shui'jing	0
星银矿石	xing'yin'kuang'shi	0
须弥	xu'mi	0
玄岩之塔	xuan'yan'zhi'ta	0
雪融有踪	xue'rong'you'zong	0
雪葬的星银	xue'zang'de'xing'yin	0
雪葬之都	xue'zang'zhi'du	0
寻宝罗盘	xun'bao'luo'pan	0
寻宝鸦印	xun'bao'ya'yin	0
循循守月	xun'xun'shou'yue	0
亚尔伯里奇	ya'er'bo'li'qi	0
鸦印	ya'yin	0
岩盾丘丘暴徒	yan'dun'qiu'qiu'bao'tu	0
岩晶蝶	yan'jing'die	0
岩丘丘萨满	yan'qiu'qiu'sa'man	0
岩神瞳	yan'shen'tong	0
岩神像	yan'shen'xiang	0
岩使游击兵	yan'shi'you'ji'bing	0
岩王帝君	yan'wang'di'jun	0
掩月天权	yan'yue'tian'quan	0
岩之印	yan'zhi'yin	0
瑶光滩	yao'guang'tan	0
摇曳的炽热火花	yao'ye'de'chi're'huo'hua	0
夜泊石	ye'bo'shi	0
夜枭之章	ye'xiao'zhi'zhang	0
椰羊	ye'yang	0
遗迹猎者	yi'ji'lie'zhe	0
遗迹守卫	yi'ji'shou'wei	0
应急食品	ying'ji'shi'pin	0
映天之章	ying'tian'zhi'zhang	0
鹰翔海滩	ying'xiang'hai'tan	0
幼师之章	you'shi'zhi'zhang	0
雨裁	yu'cai	0
羽球节	yu'qiu'jie	0
愚人众	yu'ren'zhong	0
愚人众先遣队	yu'ren'zhong'xian'qian'dui	0
原粹树脂	yuan'cui'shu'zhi	0
原胚	yuan'pei	0
原神	yuan'shen	0
原石	yuan'shi	0
元素爆发	yuan'su'bao'fa	0
元素充能效率	yuan'su'chong'neng'xiao'lv	0
元素附着	yuan'su'fu'zhuo	0
原素花蜜	yuan'su'hua'mi	0
元素精通	yuan'su'jing'tong	0
元素扩散	yuan'su'kuo'san	0
元素视野	yuan'su'shi'ye	0
元素战技	yuan'su'zhan'ji	0
渊星	yuan'xing	0
渊月螺旋	yuan'yue'luo'xuan	0
渊月祝福	yuan'yue'zhu'fu	0
云来海	yun'lai'hai	0
陨铁	yun'tie	0
暂别冬都	zan'bie'dong'dou	0
债务处理人	zhai'wu'chu'li'ren	0
摘星崖	zhai'xing'ya	0
昭心	zhao'xin	0
震雷连山密宫	zhen'lei'lian'shan'mi'gong	0
蒸发	zheng'fa	0
正义人	zheng'yi'ren	0
至冬	zhi'dong	0
治疗效果	zhi'liao'xiao'guo	0
智识之冕	zhi'shi'zhi'mian	0
钟剑	zhong'jian	0
钟离	zhong'li	0
仲夏庭园	zhong'xia'ting'yuan	0
重云	zhong'yun	0
主词条	zhu'ci'tiao	0
斫峰之刃	zhuo'feng'zhi'ren	0
自由的教导	zi'you'de'jiao'dao	0
自由的哲学	zi'you'de'zhe'xue	0
自由的指引	zi'you'de'zhi'yin	0
自在松石	zi'zai'song'shi	0
宗室	zong'shi	0
宗室长弓	zong'shi'chang'gong	0
宗室长剑	zong'shi'chang'jian	0
宗室大剑	zong'shi'da'jian	0
宗室猎枪	zong'shi'lie'qiang	0
宗室秘法录	zong'shi'mi'fa'lu	0
最胜紫晶	zui'sheng'zi'jing	0
