柏俏	bai'qiao	0
多特蒙德金麦	duo'te'meng'de'jin'mai	0
劲旅	jing'lv	0
开胃山楂汁	kai'wei'shan'zha'zhi	0
冷锅毛肚	leng'guo'mao'du	0
榴芒披萨	liu'mang'pi'sa	0
齐唯	qi'wei	0
斯格顿	si'ge'dun	0
铁木真羊排	tie'mu'zhen'yang'pai	0
我家烧烤无油烟	wo'jia'shao'kao'wu'you'yan	0
寻范	xun'fan	0
窑啊窑	yao'a'yao	0
窑啊窑蜜汁梅肉	yao'a'yao'mi'zhi'mei'rou	0
窑烤大虾	yao'kao'da'xia	0
窑烤大羊肉串	yao'kao'da'yang'rou'chuan	0
窑烤手撕鸡胗	yao'kao'shou'si'ji'zhen	0
窑烤蒜香梅肉	yao'kao'suan'xiang'mei'rou	0
窑炉烧烤	yao'lu'shao'kao	0
窑炉肘子辣	yao'lu'zhou'zi'la	0
逸鼠顿	yi'shu'dun	0
战斧牛方	zhan'fu'niu'fang	0
中堂	zhong'tang	0
