爱氏丽翁	ai'shi'li'weng	0
八千代	ba'qian'dai	0
白霜莲	bai'shuang'lian	0
白檀	bai'tan	0
白檀属	bai'tan'shu	0
白雪晃	bai'xue'huang	0
白云鸾凤玉	bai'yun'luan'feng'yu	0
棒叶不死鸟	bang'ye'bu'si'niao	0
奔龙	ben'long	0
碧彩柱	bi'cai'zhu	0
碧彩柱属	bi'cai'zhu'shu	0
碧方玉	bi'fang'yu	0
碧琉璃鸾凤玉	bi'liu'li'luan'feng'yu	0
扁园盘玉	bian'yuan'pan'yu	0
冰莓	bing'mei	0
冰蓉	bing'rong	0
菠萝球	bo'luo'qiu	0
菠萝球属	bo'luo'qiu'shu	0
般若	bo're	0
薄雪万年草	bo'xue'wan'nian'cao	0
超兜	chao'dou	0
赤化象牙球	chi'hua'xiang'ya'qiu	0
吹雪柱	chui'xue'zhu	0
刺萼柱	ci'e'zhu	0
刺萼柱属	ci'e'zhu'shu	0
大和锦	da'he'jin	0
大红卷绢	da'hong'juan'juan	0
帝玉露	di'yu'lu	0
顶花球	ding'hua'qiu	0
顶花球属	ding'hua'qiu'shu	0
恩塚鸾凤玉	en'zhong'luan'feng'yu	0
恩冢瑞凤皮	en'zhong'rui'feng'pi	0
飞龙柱	fei'long'zhu	0
飞龙柱属	fei'long'zhu'shu	0
绯筒球	fei'tong'qiu	0
绯筒球属	fei'tong'qiu'shu	0
粉红台阁	fen'hong'tai'ge	0
凤玉锦	feng'yu'jin	0
佛甲草	fo'jia'cao	0
佛甲草锦	fo'jia'cao'jin	0
复隆鸾凤玉	fu'long'luan'feng'yu	0
公子丸	gong'zi'wan	0
管花柱	guan'hua'zhu	0
管花柱属	guan'hua'zhu'shu	0
灌木柱	guan'mu'zhu	0
灌木柱属	guan'mu'zhu'shu	0
观音莲	guan'yin'lian	0
龟甲碧琉璃鸾凤玉	gui'jia'bi'liu'li'luan'feng'yu	0
龟甲牡丹	gui'jia'mu'dan	0
黑法师	hei'fa'shi	0
黑芒丸	hei'mang'wan	0
黑士冠	hei'shi'guan	0
黑兔耳	hei'tu'er	0
黑王球	hei'wang'qiu	0
黑王球属	hei'wang'qiu'shu	0
黑王丸	hei'wang'wan	0
黑王子	hei'wang'zi	0
黑象丸	hei'xiang'wan	0
红霜莲	hong'shuang'lian	0
红叶鸾	hong'ye'luan	0
红叶鸾凤玉	hong'ye'luan'feng'yu	0
虹之玉	hong'zhi'yu	0
虹之玉锦	hong'zhi'yu'jin	0
厚叶旭鹤	hou'ye'xu'he	0
花冠柱	hua'guan'zhu	0
花冠柱属	hua'guan'zhu'shu	0
花铠柱	hua'kai'zhu	0
花铠柱属	hua'kai'zhu'shu	0
花园兜	hua'yuan'dou	0
华妆翁	hua'zhuang'weng	0
华妆翁属	hua'zhuang'weng'shu	0
黄金纽	huang'jin'niu	0
黄金万年草	huang'jin'wan'nian'cao	0
黄丽	huang'li	0
火祭	huo'ji	0
姬胧月	ji'long'yue	0
姬秋丽	ji'qiu'li	0
姬星美人	ji'xing'mei'ren	0
姬玉露	ji'yu'lu	0
锦晃星	jin'huang'xing	0
金毛花冠柱	jin'mao'hua'guan'zhu	0
金钱木	jin'qian'mu	0
金狮子	jin'shi'zi	0
静夜	jing'ye	0
巨人柱	ju'ren'zhu	0
巨人柱属	ju'ren'zhu'shu	0
菊丸	ju'wan	0
恐龙角	kong'long'jiao	0
恐龙角属	kong'long'jiao'shu	0
宽叶不死鸟	kuan'ye'bu'si'niao	0
蓝豆	lan'dou	0
狼爪玉	lang'zhua'yu	0
狼爪玉属	lang'zhua'yu'shu	0
雷血丸	lei'xue'wan	0
连星	lian'xing	0
鳞花柱	lin'hua'zhu	0
鳞花柱属	lin'hua'zhu'shu	0
柳叶椒草	liu'ye'jiao'cao	0
柳叶莲华	liu'ye'lian'hua	0
龙角牡丹	long'jiao'mu'dan	0
龙角丸	long'jiao'wan	0
龙舌牡丹	long'she'mu'dan	0
龙爪球	long'zhua'qiu	0
龙爪球属	long'zhua'qiu'shu	0
龙爪玉	long'zhua'yu	0
鹿角海棠	lu'jiao'hai'tang	0
露娜莲	lu'na'lian	0
鲁氏石莲	lu'shi'shi'lian	0
鲁氏石莲花	lu'shi'shi'lian'hua	0
鸾凤玉	luan'feng'yu	0
萝藦	luo'mo	0
罗纱锦	luo'sha'jin	0
罗纱锦属	luo'sha'jin'shu	0
梦露玉	meng'lu'yu	0
米粒花	mi'li'hua	0
冥王丸	ming'wang'wan	0
铭月	ming'yue	0
墨法师	mo'fa'shi	0
牡丹	mu'dan	0
南美翁柱	nan'mei'weng'zhu	0
南美翁柱属	nan'mei'weng'zhu'shu	0
拟石莲花	ni'shi'lian'hua	0
凝脂莲	ning'zhi'lian	0
皮氏石莲	pi'shi'shi'lian	0
皮氏石莲花	pi'shi'shi'lian'hua	0
七宝树锦	qi'bao'shu'jin	0
奇特丸	qi'te'wan	0
钱串	qian'chuan	0
千佛手	qian'fo'shou	0
茜球	qian'qiu	0
茜球属	qian'qiu'shu	0
茜之塔	qian'zhi'ta	0
茜之塔锦	qian'zhi'ta'jin	0
情人泪	qing'ren'lei	0
庆松玉	qing'song'yu	0
青铜龙	qing'tong'long	0
青铜龙属	qing'tong'long'shu	0
秋丽	qiu'li	0
群凤玉	qun'feng'yu	0
群蛇柱	qun'she'zhu	0
群蛇柱属	qun'she'zhu'shu	0
绒针	rong'zhen	0
茸针	rong'zhen	0
瑞典魔南	rui'dian'mo'nan	0
三角鸾凤玉	san'jiao'luan'feng'yu	0
十字军锦	shi'zi'jun'jin	0
属花笼	shu'hua'long	0
鼠尾掌	shu'wei'zhang	0
鼠尾掌属	shu'wei'zhang'shu	0
水晶玉露	shui'jing'yu'lu	0
四海波	si'hai'bo	0
四角鸾凤玉	si'jiao'luan'feng'yu	0
松露玉	song'lu'yu	0
松露玉属	song'lu'yu'shu	0
昙花	tan'hua	0
桃美人	tao'mei'ren	0
天轮柱	tian'lun'zhu	0
天轮柱属	tian'lun'zhu'shu	0
天司丸	tian'si'wan	0
筒叶不死鸟	tong'ye'bu'si'niao	0
筒叶花月	tong'ye'hua'yue	0
透窗玉露	tou'chuang'yu'lu	0
瓦苇	wa'wei	0
王玉珠帘	wang'yu'zhu'lian	0
翁丸	weng'wan	0
翁柱	weng'zhu	0
翁柱属	weng'zhu'shu	0
五十铃玉	wu'shi'ling'yu	0
吸财树	xi'cai'shu	0
虾之玉	xia'zhi'yu	0
象牙丸	xiang'ya'wan	0
小合锦	xiao'he'jin	0
小人祭	xiao'ren'ji	0
小天狗	xiao'tian'gou	0
蟹爪钳	xie'zhua'qian	0
新玉缀	xin'yu'zhui	0
星球	xing'qiu	0
星球属	xing'qiu'shu	0
猩猩冠柱	xing'xing'guan'zhu	0
猩猩冠柱属	xing'xing'guan'zhu'shu	0
熊童子锦	xiong'tong'zi'jin	0
雪光	xue'guang	0
雪光属	xue'guang'shu	0
熏大将	xun'da'jiang	0
熏大将属	xun'da'jiang'shu	0
岩牡丹	yan'mu'dan	0
岩牡丹属	yan'mu'dan'shu	0
岩石狮子	yan'shi'shi'zi	0
乙姬牡丹	yi'ji'mu'dan	0
银剑	yin'jian	0
隐柱昙花	yin'zhu'tan'hua	0
隐柱昙花属	yin'zhu'tan'hua'shu	0
银装龙	yin'zhuang'long	0
银装龙属	yin'zhuang'long'shu	0
有刺萼	you'ci'e	0
有刺萼属	you'ci'e'shu	0
有星大凤玉	you'xing'da'feng'yu	0
玉吊钟	yu'diao'zhong	0
玉蝶	yu'die	0
鱼鳞玉	yu'lin'yu	0
玉翁	yu'weng	0
圆盘玉	yuan'pan'yu	0
圆盘玉属	yuan'pan'yu'shu	0
圆筒仙人掌	yuan'tong'xian'ren'zhang	0
圆筒仙人掌属	yuan'tong'xian'ren'zhang'shu	0
枝干番杏	zhi'gan'fan'xing	0
蜘蛛丸	zhi'zhu'wan	0
钟花柱	zhong'hua'zhu	0
钟花柱属	zhong'hua'zhu'shu	0
皱棱球	zhou'leng'qiu	0
蛛丝卷绢	zhu'si'juan'juan	0
子持莲华	zi'chi'lian'hua	0
紫娟卷	zi'juan'juan	0
紫牡丹	zi'mu'dan	0
紫纽伦堡紫珍	zi'niu'lun'bao'zi'zhen	0
紫弦月	zi'xian'yue	0
