薄壁钢规	bao'bi'gang'gui	0
边坡规	bian'po'gui	0
城桥抗规	cheng'qiao'kang'gui	0
城市桥规	cheng'shi'qiao'gui	0
城市桥梁抗震设计规范	cheng'shi'qiao'liang'kang'zhen'she'ji'gui'fan	0
城市桥梁设计规范	cheng'shi'qiao'liang'she'ji'gui'fan	0
地处规	di'chu'gui	0
地规	di'gui	0
地基加固规	di'ji'jia'gu'gui	0
地验规	di'yan'gui	0
电施	dian'shi	0
二级注册结构工程师	er'ji'zhu'ce'jie'gou'gong'cheng'shi	0
二级注册结构工程师专业考试	er'ji'zhu'ce'jie'gou'gong'cheng'shi'zhuan'ye'kao'shi	0
防火规范	fang'huo'gui'fan	0
钢标	gang'biao	0
钢焊接规	gang'han'jie'gui	0
刚架	gang'jia	0
钢结构高强度螺栓连接技术规程	gang'jie'gou'gao'qiang'du'luo'shuan'lian'jie'ji'shu'gui'cheng	0
钢结构工程施工质量验收规范	gang'jie'gou'gong'cheng'shi'gong'zhi'liang'yan'shou'gui'fan	0
钢结构焊接规范	gang'jie'gou'han'jie'gui'fan	0
钢结构设计标准	gang'jie'gou'she'ji'biao'zhun	0
钢结构施工图	gang'jie'gou'shi'gong'tu	0
钢施	gang'shi	0
高层建筑混凝土结构技术规程	gao'ceng'jian'zhu'hun'ning'tu'jie'gou'ji'shu'gui'cheng	0
高层民用建筑钢结构技术规程	gao'ceng'min'yong'jian'zhu'gang'jie'gou'ji'shu'gui'cheng	0
高钢规	gao'gang'gui	0
高规	gao'gui	0
公路桥涵设计通用规范	gong'lu'qiao'han'she'ji'tong'yong'gui'fan	0
公路桥梁抗震设计细则	gong'lu'qiao'liang'kang'zhen'she'ji'xi'ze	0
公桥混规	gong'qiao'hun'gui	0
公桥抗则	gong'qiao'kang'ze	0
公桥通规	gong'qiao'tong'gui	0
规范简称	gui'fan'jian'cheng	0
荷规	he'gui	0
混规	hun'gui	0
混加固规	hun'jia'gu'gui	0
混凝土结构加固设计规范	hun'ning'tu'jie'gou'jia'gu'she'ji'gui'fan	0
混凝土结构设计规范	hun'ning'tu'jie'gou'she'ji'gui'fan	0
混凝土异形柱结构技术规程	hun'ning'tu'yi'xing'zhu'jie'gou'ji'shu'gui'cheng	0
混验规	hun'yan'gui	0
既有建筑地基基础加固技术规范	ji'you'jian'zhu'di'ji'ji'chu'jia'gu'ji'shu'gui'fan	0
建施	jian'shi	0
建筑边坡工程技术规范	jian'zhu'bian'po'gong'cheng'ji'shu'gui'fan	0
建筑地基处理技术规范	jian'zhu'di'ji'chu'li'ji'shu'gui'fan	0
建筑地基基础设计规范	jian'zhu'di'ji'ji'chu'she'ji'gui'fan	0
建筑工程抗浮技术标准	jian'zhu'gong'cheng'kang'fu'ji'shu'biao'zhun	0
建筑工程抗震设防分类标准	jian'zhu'gong'cheng'kang'zhen'she'fang'fen'lei'biao'zhun	0
建筑结构荷载规范	jian'zhu'jie'gou'he'zai'gui'fan	0
建筑结构可靠性设计统一标准	jian'zhu'jie'gou'ke'kao'xing'she'ji'tong'yi'biao'zhun	0
建筑抗震设计规范	jian'zhu'kang'zhen'she'ji'gui'fan	0
建筑设计防火规范	jian'zhu'she'ji'fang'huo'gui'fan	0
建筑桩基技术规范	jian'zhu'zhuang'ji'ji'shu'gui'fan	0
结构施工图	jie'gou'shi'gong'tu	0
结施	jie'shi	0
抗浮锚杆技术规程	kang'fu'mao'gan'ji'shu'gui'cheng	0
抗规	kang'gui	0
可靠性标准	ke'kao'xing'biao'zhun	0
空间网格结构技术规程	kong'jian'wang'ge'jie'gou'ji'shu'gui'cheng	0
冷弯薄壁型钢结构技术规范	leng'wan'bao'bi'xing'gang'jie'gou'ji'shu'gui'fan	0
螺栓规程	luo'shuan'gui'cheng	0
门刚	men'gang	0
门刚规	men'gang'gui	0
门式刚架	men'shi'gang'jia	0
木标	mu'biao	0
木结构设计标准	mu'jie'gou'she'ji'biao'zhun	0
暖施	nuan'shi	0
砌规	qi'gui	0
砌体结构工程施工质量验收规范	qi'ti'jie'gou'gong'cheng'shi'gong'zhi'liang'yan'shou'gui'fan	0
砌体结构设计规范	qi'ti'jie'gou'she'ji'gui'fan	0
砌验规	qi'yan'gui	0
设防分类标准	she'fang'fen'lei'biao'zhun	0
湿陷性黄土地区建筑标准	shi'xian'xing'huang'tu'di'qu'jian'zhu'biao'zhun	0
水施	shui'shi	0
天桥规范	tian'qiao'gui'fan	0
挑梁	tiao'liang	0
网格规程	wang'ge'gui'cheng	0
烟囱规	yan'cong'gui	0
烟囱设计规范	yan'cong'she'ji'gui'fan	0
一级注册结构工程师	yi'ji'zhu'ce'jie'gou'gong'cheng'shi	0
一级注册结构工程师专业考试	yi'ji'zhu'ce'jie'gou'gong'cheng'shi'zhuan'ye'kao'shi	0
异形柱规	yi'xing'zhu'gui	0
盈建科	ying'jian'ke	0
雨篷	yu'peng	0
朱炳寅	zhu'bing'yin	0
桩规	zhuang'gui	0
组合规	zu'he'gui	0
组合结构技术规程	zu'he'jie'gou'ji'shu'gui'cheng	0
