昂扬珠	ang'yang'zhu	0
拔刀珠	ba'dao'zhu	0
爆鳞龙	bao'lin'long	0
爆破珠	bao'po'zhu	0
爆师珠	bao'shi'zhu	0
贝斯摩斯	bei'si'mo'si	0
贝爷	bei'ye	0
痹毒龙	bi'du'long	0
痹贼龙	bi'zei'long	0
标本珠	biao'ben'zhu	0
冰豺狼	bing'chai'lang	0
冰结珠	bing'jie'zhu	0
冰牙龙	bing'ya'long	0
冰鱼龙	bing'yu'long	0
冰呪龙	bing'zhou'long	0
波波	bo'bo	0
采配珠	cai'pei'zhu	0
超心珠	chao'xin'zhu	0
赤冥龙	chi'ming'long	0
持续珠	chi'xu'zhu	0
达人珠	da'ren'zhu	0
底力珠	di'li'zhu	0
地学珠	di'xue'zhu	0
冬翼龙	dong'yi'long	0
毒珠	du'zhu	0
夺气珠	duo'qi'zhu	0
防风珠	fang'feng'zhu	0
防音珠	fang'yin'zhu	0
防御珠	fang'yu'zhu	0
飞燕珠	fei'yan'zhu	0
风漂龙	feng'piao'long	0
浮眠龙	fu'mian'long	0
攻击珠	gong'ji'zhu	0
鼓笛珠	gu'di'zhu	0
黑轰龙	hei'hong'long	0
黑角爹	hei'jiao'die	0
黑狼鸟	hei'lang'niao	0
红莲爆鳞龙	hong'lian'bao'lin'long	0
轰龙	hong'long	0
轰炸机	hong'zha'ji	0
滑走珠	hua'zou'zhu	0
环境珠	huan'jing'zhu	0
惶怒恐暴龙	huang'nu'kong'bao'long	0
回避珠	hui'bi'zhu	0
浑身珠	hun'shen'zhu	0
火炎珠	huo'yan'zhu	0
激昂金狮子	ji'ang'jin'shi'zi	0
极贝	ji'bei	0
击晕珠	ji'yun'zhu	0
加护珠	jia'hu'zhu	0
歼世灭尽龙	jian'shi'mie'jin'long	0
酱瓜	jiang'gua	0
匠珠	jiang'zhu	0
角爹	jiao'die	0
解放珠	jie'fang'zhu	0
节食珠	jie'shi'zhu	0
金火龙	jin'huo'long	0
金狮子	jin'shi'zi	0
绝路珠	jue'lu'zhu	0
雷颚龙	lei'e'long	0
雷光珠	lei'guang'zhu	0
雷狼龙	lei'lang'long	0
历战	li'zhan	0
历战娜娜	li'zhan'na'na	0
历战王	li'zhan'wang	0
历战炎喵	li'zhan'yan'miao	0
流水珠	liu'shui'zhu	0
硫斩龙	liu'zhan'long	0
麻痹珠	ma'bi'zhu	0
猛牛龙	meng'niu'long	0
溟波龙	ming'bo'long	0
耐爆珠	nai'bao'zhu	0
耐冰珠	nai'bing'zhu	0
耐冲珠	nai'chong'zhu	0
耐毒珠	nai'du'zhu	0
耐防珠	nai'fang'zhu	0
耐寒珠	nai'han'zhu	0
耐火珠	nai'huo'zhu	0
耐绝珠	nai'jue'zhu	0
耐雷珠	nai'lei'zhu	0
耐裂珠	nai'lie'zhu	0
耐龙珠	nai'long'zhu	0
耐麻珠	nai'ma'zhu	0
耐眠珠	nai'mian'zhu	0
耐属珠	nai'shu'zhu	0
耐暑珠	nai'shu'zhu	0
耐水珠	nai'shui'zhu	0
耐瘴珠	nai'zhang'zhu	0
耐震珠	nai'zhen'zhu	0
逆境珠	ni'jing'zhu	0
逆上珠	ni'shang'zhu	0
炮手珠	pao'shou'zhu	0
炮术珠	pao'shu'zhu	0
破龙珠	po'long'zhu	0
潜伏珠	qian'fu'zhu	0
强弓珠	qiang'gong'zhu	0
强走珠	qiang'zou'zhu	0
全开珠	quan'kai'zhu	0
茸好珠	rong'hao'zhu	0
搔鸟	sao'niao	0
守势珠	shou'shi'zhu	0
霜翼风漂龙	shuang'yi'feng'piao'long	0
睡眠珠	shui'mian'zhu	0
水妖鸟	shui'yao'niao	0
速纳珠	su'na'zhu	0
碎龙	sui'long	0
缩短珠	suo'duan'zhu	0
特射珠	te'she'zhu	0
体力珠	ti'li'zhu	0
体术珠	ti'shu'zhu	0
天地煌啼龙	tian'di'huang'ti'long	0
跳跃珠	tiao'yue'zhu	0
挑战珠	tiao'zhan'zhu	0
铁壁珠	tie'bi'zhu	0
痛击珠	tong'ji'zhu	0
投石珠	tou'shi'zhu	0
土砂龙	tu'sha'long	0
威吓珠	wei'he'zhu	0
无伤珠	wu'shang'zhu	0
无食珠	wu'shi'zhu	0
雾瘴尸套龙	wu'zhang'shi'tao'long	0
凶爪龙	xiong'zhao'long	0
绚辉龙	xuan'hui'long	0
眩鸟	xuan'niao	0
雪鹿	xue'lu	0
迅龙	xun'long	0
研磨珠	yan'mo'zhu	0
炎王喵	yan'wang'miao	0
银火龙	yin'huo'long	0
永霜冻土	yong'shuang'dong'tu	0
友爱珠	you'ai'zhu	0
狱狼龙	yu'lang'long	0
早复珠	zao'fu'zhu	0
早食珠	zao'shi'zhu	0
战痕黑狼鸟	zhan'hen'hei'lang'niao	0
斩龙	zhan'long	0
沼渡珠	zhao'du'zhu	0
整备珠	zheng'bei'zhu	0
植学珠	zhi'xue'zhu	0
治愈珠	zhi'yu'zhu	0
重击珠	zhong'ji'zhu	0
转福珠	zhuan'fu'zhu	0
