半扣	ban'kou	0
傳髪世家	chuan'fa'shi'jia	0
傳髪世家补发店	chuan'fa'shi'jia'bu'fa'dian	0
递针顶头套	di'zhen'ding'tou'tao	0
递针工艺	di'zhen'gong'yi	0
递针旋头套	di'zhen'xuan'tou'tao	0
递针扎针	di'zhen'zha'zhen	0
反半扣	fan'ban'kou	0
翻毛工艺	fan'mao'gong'yi	0
翻毛旋头套	fan'mao'xuan'tou'tao	0
硅胶医疗头套	gui'jiao'yi'liao'tou'tao	0
假发新秀发	jia'fa'xin'xiu'fa	0
咖啡色网	ka'fei'se'wang	0
墨匠品牌	mo'jiang'pin'pai	0
男士网发快	nan'shi'wang'fa'kuai	0
曲度	qu'du	0
生物头皮	sheng'wu'tou'pi	0
甜媚儿品牌	tian'mei'er'pin'pai	0
新秀发	xin'xiu'fa	0
新秀发补发片	xin'xiu'fa'bu'fa'pian	0
新秀发假发	xin'xiu'fa'jia'fa	0
新秀发旗舰店	xin'xiu'fa'qi'jian'dian	0
医疗硅胶头套	yi'liao'gui'jiao'tou'tao	0
扎针工艺	zha'zhen'gong'yi	0
真发补发制品	zhen'fa'bu'fa'zhi'pin	0
真发头套	zhen'fa'tou'tao	0
自然黑	zi'ran'hei	0
自然色	zi'ran'se	0
