阿波	a'bo	0
阿部正次	a'bu'zheng'ci	0
阿茶局	a'cha'ju	0
阿初	a'chu	0
阿市	a'shi	0
阿松	a'song	0
阿苏惟将	a'su'wei'jiang	0
安部政吉	an'bu'zheng'ji	0
安东爱季	an'dong'ai'ji	0
安东高季	an'dong'gao'ji	0
安房	an'fang	0
安国寺惠琼	an'guo'si'hui'qiong	0
安见直政	an'jian'zhi'zheng	0
安井道顿	an'jing'dao'dun	0
安藤良整	an'teng'liang'zheng	0
安藤守就	an'teng'shou'jiu	0
安藤直次	an'teng'zhi'ci	0
安藤重信	an'teng'zhong'xin	0
安田长秀	an'tian'chang'xiu	0
安田显元	an'tian'xian'yuan	0
安土	an'tu	0
安土桃山	an'tu'tao'shan	0
安西又助	an'xi'you'zhu	0
安艺	an'yi	0
安芸国虎	an'yun'guo'hu	0
安宅冬康	an'zhai'dong'kang	0
安宅信康	an'zhai'xin'kang	0
奥村荣明	ao'cun'rong'ming	0
奥村永福	ao'cun'yong'fu	0
奥平信昌	ao'ping'xin'chang	0
八板金兵卫	ba'ban'jin'bing'wei	0
八王子	ba'wang'zi	0
百地三太夫	bai'di'san'tai'fu	0
白石宗实	bai'shi'zong'shi	0
百武贤兼	bai'wu'xian'jian	0
拜乡家嘉	bai'xiang'jia'jia	0
板部冈江雪斋	ban'bu'gang'jiang'xue'zhai	0
板仓胜重	ban'cang'sheng'zhong	0
坂井政尚	ban'jing'zheng'shang	0
坂崎直盛	ban'qi'zhi'sheng	0
坂田源右卫门	ban'tian'yuan'you'wei'men	0
板垣信方	ban'yuan'xin'fang	0
保科正俊	bao'ke'zheng'jun	0
宝藏院胤荣	bao'zang'yuan'yin'rong	0
备后	bei'hou	0
北陆道	bei'lu'dao	0
北陆孤狼	bei'lu'gu'lang	0
备前	bei'qian	0
北畠教具	bei'tian'jiao'ju	0
北畠具房	bei'tian'ju'fang	0
北畠具教	bei'tian'ju'jiao	0
北畠晴具	bei'tian'qing'ju	0
北条纲成	bei'tiao'gang'cheng	0
北条高广	bei'tiao'gao'guang	0
北条幻庵	bei'tiao'huan'an	0
北条景广	bei'tiao'jing'guang	0
北条氏邦	bei'tiao'shi'bang	0
北条氏定	bei'tiao'shi'ding	0
北条氏繁	bei'tiao'shi'fan	0
北条氏规	bei'tiao'shi'gui	0
北条氏康	bei'tiao'shi'kang	0
北条氏胜	bei'tiao'shi'sheng	0
北条氏秀	bei'tiao'shi'xiu	0
北条氏照	bei'tiao'shi'zhao	0
北条氏政	bei'tiao'shi'zheng	0
北条氏直	bei'tiao'shi'zhi	0
北条早云	bei'tiao'zao'yun	0
北乡氏久	bei'xiang'shi'jiu	0
北信爱	bei'xin'ai	0
北政所	bei'zheng'suo	0
备中	bei'zhong	0
本多小松	ben'duo'xiao'song	0
本多正纯	ben'duo'zheng'chun	0
本多正信	ben'duo'zheng'xin	0
本多政重	ben'duo'zheng'zhong	0
本多忠朝	ben'duo'zhong'chao	0
本多忠纯	ben'duo'zhong'chun	0
本多重次	ben'duo'zhong'ci	0
本多忠高	ben'duo'zhong'gao	0
本多忠胜	ben'duo'zhong'sheng	0
本多忠真	ben'duo'zhong'zhen	0
本多忠政	ben'duo'zhong'zheng	0
本能寺之变	ben'neng'si'zhi'bian	0
本山茂宗	ben'shan'mao'zong	0
本因坊算砂	ben'yin'fang'suan'sha	0
本愿寺	ben'yuan'si	0
本愿寺教如	ben'yuan'si'jiao'ru	0
本愿寺显如	ben'yuan'si'xian'ru	0
本愿寺证如	ben'yuan'si'zheng'ru	0
本愿寺准如	ben'yuan'si'zhun'ru	0
本庄繁长	ben'zhuang'fan'chang	0
比叡山	bi'rui'shan	0
别所长治	bie'suo'chang'zhi	0
滨松	bin'song	0
并和氏续	bing'he'shi'xu	0
兵农合一	bing'nong'he'yi	0
波多野晴通	bo'duo'ye'qing'tong	0
波多野秀尚	bo'duo'ye'xiu'shang	0
波多野秀治	bo'duo'ye'xiu'zhi	0
波多野稙通	bo'duo'ye'zhi'tong	0
播磨	bo'mo	0
播磨屋宗德	bo'mo'wu'zong'de	0
伯耆	bo'qi	0
薄田兼相	bo'tian'jian'xiang	0
不破光治	bu'po'guang'zhi	0
不破直光	bu'po'zhi'guang	0
藏田五郎左	cang'tian'wu'lang'zuo	0
曾根昌世	ceng'gen'chang'shi	0
茶茶	cha'cha	0
茶屋四郎次郎	cha'wu'si'lang'ci'lang	0
茶屋又四郎	cha'wu'you'si'lang	0
柴田胜丰	chai'tian'sheng'feng	0
柴田胜家	chai'tian'sheng'jia	0
长坂长闲	chang'ban'chang'xian	0
长坂胜繁	chang'ban'sheng'fan	0
长船纲直	chang'chuan'gang'zhi	0
长船贞亲	chang'chuan'zhen'qin	0
长谷川等伯	chang'gu'chuan'deng'bo	0
长井道利	chang'jing'dao'li	0
长连龙	chang'lian'long	0
常陆	chang'lu	0
长门	chang'men	0
长束正家	chang'shu'zheng'jia	0
长尾景虎	chang'wei'jing'hu	0
长尾晴景	chang'wei'qing'jing	0
长尾为景	chang'wei'wei'jing	0
长尾政景	chang'wei'zheng'jing	0
长享	chang'xiang	0
长筱合战	chang'xiao'he'zhan	0
长续连	chang'xu'lian	0
长野具藤	chang'ye'ju'teng	0
长野业盛	chang'ye'ye'sheng	0
长野业正	chang'ye'ye'zheng	0
长宗我部国亲	chang'zong'wo'bu'guo'qin	0
长宗我部亲吉	chang'zong'wo'bu'qin'ji	0
长宗我部盛亲	chang'zong'wo'bu'sheng'qin	0
长宗我部信亲	chang'zong'wo'bu'xin'qin	0
长宗我部元亲	chang'zong'wo'bu'yuan'qin	0
朝比奈泰朝	chao'bi'nai'tai'chao	0
朝仓景恒	chao'cang'jing'heng	0
朝仓景健	chao'cang'jing'jian	0
朝仓景镜	chao'cang'jing'jing	0
朝仓景连	chao'cang'jing'lian	0
朝仓孝景	chao'cang'xiao'jing	0
朝仓义景	chao'cang'yi'jing	0
朝仓宗滴	chao'cang'zong'di	0
车悬	che'xuan	0
成富茂安	cheng'fu'mao'an	0
城井镇房	cheng'jing'zhen'fang	0
成松信胜	cheng'song'xin'sheng	0
成田长泰	cheng'tian'chang'tai	0
成田长忠	cheng'tian'chang'zhong	0
成田氏长	cheng'tian'shi'chang	0
赤池长任	chi'chi'chang'ren	0
赤井直正	chi'jing'zhi'zheng	0
池赖和	chi'lai'he	0
赤松义佑	chi'song'yi'you	0
赤松政秀	chi'song'zheng'xiu	0
赤松政则	chi'song'zheng'ze	0
池田恒兴	chi'tian'heng'xing	0
池田辉政	chi'tian'hui'zheng	0
池田物左卫门	chi'tian'wu'zuo'wei'men	0
池田元助	chi'tian'yuan'zhu	0
赤尾清纲	chi'wei'qing'gang	0
赤穴盛清	chi'xue'sheng'qing	0
初井教业	chu'jing'jiao'ye	0
出浦盛清	chu'pu'sheng'qing	0
出羽	chu'yu	0
出云	chu'yun	0
出云阿国	chu'yun'a'guo	0
出云的阿国	chu'yun'de'a'guo	0
出云之鹿	chu'yun'zhi'lu	0
川上久朗	chuan'shang'jiu'lang	0
川上忠坚	chuan'shang'zhong'jian	0
川上忠智	chuan'shang'zhong'zhi	0
川中岛合战	chuan'zhong'dao'he'zhan	0
春日局	chun'ri'ju	0
春日山	chun'ri'shan	0
村井长赖	cun'jing'chang'lai	0
村井长明	cun'jing'chang'ming	0
村井贞胜	cun'jing'zhen'sheng	0
村上国清	cun'shang'guo'qing	0
村上武吉	cun'shang'wu'ji	0
村上义清	cun'shang'yi'qing	0
村上元吉	cun'shang'yuan'ji	0
大阪	da'ban	0
大阪冬之阵	da'ban'dong'zhi'zhen	0
大阪七星将	da'ban'qi'xing'jiang	0
大阪夏之阵	da'ban'xia'zhi'zhen	0
大宝寺义氏	da'bao'si'yi'shi	0
大村纯忠	da'cun'chun'zhong	0
大道寺政繁	da'dao'si'zheng'fan	0
大谷吉继	da'gu'ji'ji	0
大国实赖	da'guo'shi'lai	0
大和	da'he	0
大久保长安	da'jiu'bao'chang'an	0
大久保忠教	da'jiu'bao'zhong'jiao	0
大久保忠邻	da'jiu'bao'zhong'lin	0
大久保忠世	da'jiu'bao'zhong'shi	0
大久保忠员	da'jiu'bao'zhong'yuan	0
大久保忠佐	da'jiu'bao'zhong'zuo	0
大内定纲	da'nei'ding'gang	0
大内辉弘	da'nei'hui'hong	0
大内隆宏	da'nei'long'hong	0
大内义长	da'nei'yi'chang	0
大内义隆	da'nei'yi'long	0
大内义兴	da'nei'yi'xing	0
大内政弘	da'nei'zheng'hong	0
大崎义隆	da'qi'yi'long	0
大崎义直	da'qi'yi'zhi	0
大石智久	da'shi'zhi'jiu	0
大熊朝秀	da'xiong'chao'xiu	0
大须贺康高	da'xu'he'kang'gao	0
大野治长	da'ye'zhi'chang	0
大野治房	da'ye'zhi'fang	0
大野治胤	da'ye'zhi'yin	0
大永	da'yong	0
大友亲盛	da'you'qin'sheng	0
大友亲家	da'you'qing'jia	0
大友晴英	da'you'qing'ying	0
大友义鑑	da'you'yi'jian	0
大友义统	da'you'yi'tong	0
大友义镇	da'you'yi'zhen	0
大友宗麟	da'you'zong'lin	0
大隅	da'yu	0
大月景秀	da'yue'jing'xiu	0
丹波	dan'bo	0
丹波鬼	dan'bo'gui	0
丹后	dan'hou	0
淡路	dan'lu	0
但马	dan'ma	0
丹羽长秀	dan'yu'chang'xiu	0
丹羽长重	dan'yu'chang'zhong	0
道川兵卫三郎	dao'chuan'bing'wei'san'lang	0
稻富一梦	dao'fu'yi'meng	0
稻姬	dao'ji	0
岛津丰久	dao'jin'feng'jiu	0
岛津贵久	dao'jin'gui'jiu	0
岛津家久	dao'jin'jia'jiu	0
岛津龙伯	dao'jin'long'bo	0
岛津日新斋	dao'jin'ri'xin'zhai	0
岛津尚久	dao'jin'shang'jiu	0
岛津实久	dao'jin'shi'jiu	0
岛津岁久	dao'jin'sui'jiu	0
岛津义弘	dao'jin'yi'hong	0
岛津义虎	dao'jin'yi'hu	0
岛津义久	dao'jin'yi'jiu	0
岛津征久	dao'jin'zheng'jiu	0
岛津忠恒	dao'jin'zhong'heng	0
岛津忠将	dao'jin'zhong'jiang	0
岛津忠良	dao'jin'zhong'liang	0
岛井宗室	dao'jing'zong'shi	0
岛清兴	dao'qing'xing	0
岛胜猛	dao'sheng'meng	0
刀狩	dao'shou	0
稻叶一铁	dao'ye'yi'tie	0
稻叶贞通	dao'ye'zhen'tong	0
稻叶正成	dao'ye'zheng'cheng	0
岛左近	dao'zuo'jin	0
德川家光	de'chuan'jia'guang	0
德川家康	de'chuan'jia'kang	0
德川赖房	de'chuan'lai'fang	0
德川赖宣	de'chuan'lai'xuan	0
德川信康	de'chuan'xin'kang	0
德川秀忠	de'chuan'xiu'zhong	0
德川义直	de'chuan'yi'zhi	0
得居通之	de'ju'tong'zhi	0
德永寿昌	de'yong'shou'chang	0
地黄八幡	di'huang'ba'fan	0
淀君	dian'jun	0
淀屋长安	dian'wu'chang'an	0
钓野伏	diao'ye'fu	0
东海道	dong'hai'dao	0
东海道第一弓取	dong'hai'dao'di'yi'gong'qu	0
东山道	dong'shan'dao	0
东乡重位	dong'xiang'zhong'wei	0
渡边勘兵卫	du'bian'kan'bing'wei	0
渡边守纲	du'bian'shou'gang	0
笃十藏	du'shi'cang	0
独眼龙政宗	du'yan'long'zheng'zong	0
对马	dui'ma	0
盾冈满茂	dun'gang'man'mao	0
多罗尾光俊	duo'luo'wei'guang'jun	0
多田满赖	duo'tian'man'lai	0
二本松义继	er'ben'song'yi'ji	0
二宫就辰	er'gong'jiu'chen	0
二阶崩之变	er'jie'beng'zhi'bian	0
二阶堂辉行	er'jie'tang'hui'xing	0
二阶堂盛义	er'jie'tang'sheng'yi	0
二阶堂照行	er'jie'tang'zhao'xing	0
二曲轮之助	er'qu'lun'zhi'zhu	0
儿玉就英	er'yu'jiu'ying	0
繁尺元氏	fan'chi'yuan'shi	0
饭富虎昌	fan'fu'hu'chang	0
饭田觉兵卫	fan'tian'jue'bing'wei	0
饭田直政	fan'tian'zhi'zheng	0
饭尾连龙	fan'wei'lian'long	0
芳春院	fang'chun'yuan	0
芳贺高定	fang'he'gao'ding	0
芳贺高继	fang'he'gao'ji	0
肥后	fei'hou	0
肥前	fei'qian	0
肥前之熊	fei'qian'zhi'xiong	0
飞驒	fei'tuo	0
分部光嘉	fen'bu'guang'jia	0
丰臣国松	feng'chen'guo'song	0
丰臣完子	feng'chen'wan'zi	0
丰臣秀长	feng'chen'xiu'chang	0
丰臣秀次	feng'chen'xiu'ci	0
丰臣秀吉	feng'chen'xiu'ji	0
丰臣秀赖	feng'chen'xiu'lai	0
丰臣秀胜	feng'chen'xiu'sheng	0
丰臣秀信	feng'chen'xiu'xin	0
丰后	feng'hou	0
风魔小太郎	feng'mo'xiao'tai'lang	0
丰前	feng'qian	0
蜂屋赖隆	feng'wu'lai'long	0
蜂须贺家政	feng'xu'he'jia'zheng	0
蜂须贺小六	feng'xu'he'xiao'liu	0
蜂须贺正胜	feng'xu'he'zheng'sheng	0
服部半藏	fu'bu'ban'zang	0
福岛正则	fu'dao'zheng'ze	0
福留亲政	fu'liu'qin'zheng	0
福留仪重	fu'liu'yi'zhong	0
富山	fu'shan	0
富田景胜	fu'tian'jing'sheng	0
富田景政	fu'tian'jing'zheng	0
富田隆实	fu'tian'long'shi	0
富田势源	fu'tian'shi'yuan	0
富田重政	fu'tian'zhong'zheng	0
富永山随	fu'yong'shan'sui	0
福原贞俊	fu'yuan'zhen'jun	0
府中三人众	fu'zhong'san'ren'zhong	0
肝付兼护	gan'fu'jian'hu	0
肝付兼亮	gan'fu'jian'liang	0
肝付兼续	gan'fu'jian'xu	0
肝付良兼	gan'fu'liang'jian	0
甘利昌忠	gan'li'chang'zhong	0
甘利虎泰	gan'li'hu'tai	0
甘糟景持	gan'zao'jing'chi	0
甘糟景继	gan'zao'jing'ji	0
冈本禅哲	gang'ben'chan'zhe	0
冈本赖氏	gang'ben'lai'shi	0
冈本随缘斋	gang'ben'sui'yuan'zhai	0
冈部元信	gang'bu'yuan'xin	0
冈部贞纲	gang'bu'zhen'gang	0
冈部正纲	gang'bu'zheng'gang	0
冈吉正	gang'ji'zheng	0
冈利胜	gang'li'sheng	0
冈崎	gang'qi	0
冈田重孝	gang'tian'zhong'xiao	0
高坂昌信	gao'ban'chang'xin	0
高坂甚内	gao'ban'shen'nei	0
高岛政重	gao'dao'zheng'zhong	0
高力清长	gao'li'qing'chang	0
高梨政赖	gao'li'zheng'lai	0
高木清长	gao'mu'qing'chang	0
高桥鉴种	gao'qiao'jian'zhong	0
高桥绍运	gao'qiao'shao'yun	0
高山右近	gao'shan'you'jin	0
高山友照	gao'shan'you'zhao	0
高山重友	gao'shan'zhong'you	0
高台院	gao'tai'yuan	0
镐团右卫门	gao'tuan'you'wei'men	0
高野山	gao'ye'shan	0
高远赖继	gao'yuan'lai'ji	0
镐直政	gao'zhi'zheng	0
葛山氏元	ge'shan'shi'yuan	0
葛西晴信	ge'xi'qing'xin	0
根岸兔角	gen'an'tu'jiao	0
根津甚八	gen'jin'shen'ba	0
根来寺	gen'lai'si	0
亘理元宗	gen'li'yuan'zong	0
宫本传太夫	gong'ben'chuan'tai'fu	0
宫本武藏	gong'ben'wu'zang	0
宫部继润	gong'bu'ji'run	0
攻弹正	gong'dan'zheng	0
沟口秀胜	gou'kou'xiu'sheng	0
沟尾庄兵卫	gou'wei'zhuang'bing'wei	0
古河公方	gu'he'gong'fang	0
古河御所	gu'he'yu'suo	0
古田重然	gu'tian'zhong'ran	0
谷忠澄	gu'zhong'cheng	0
关东管领	guan'dong'guan'ling	0
关口氏广	guan'kou'shi'guang	0
关盛信	guan'sheng'xin	0
关一政	guan'yi'zheng	0
关原合战	guan'yuan'he'zhan	0
龟井兹矩	gui'jing'zi'ju	0
鬼美浓	gui'mei'nong	0
鬼庭纲元	gui'ting'gang'yuan	0
鬼庭左月	gui'ting'zuo'yue	0
鬼小岛弥太郎	gui'xiao'dao'mi'tai'lang	0
鬼玄蕃	gui'xuan'fan	0
鲑延秀纲	gui'yan'xiu'gang	0
桂元澄	gui'yuan'cheng	0
鬼之半藏	gui'zhi'ban'cang	0
鬼作左	gui'zuo'zuo	0
锅岛胜茂	guo'dao'sheng'mao	0
锅岛直茂	guo'dao'zhi'mao	0
国司元相	guo'si'yuan'xiang	0
果心居士	guo'xin'ju'shi	0
国友善兵卫	guo'you'shan'bing'wei	0
海北纲亲	hai'bei'gang'qin	0
海道第一弓	hai'dao'di'yi'gong	0
海野栋纲	hai'ye'dong'gang	0
海野六郎	hai'ye'liu'lang	0
海野信亲	hai'ye'xin'qin	0
豪姬	hao'ji	0
河尻秀隆	he'kao'xiu'long	0
河内	he'nei	0
和泉	he'quan	0
和田惟政	he'tian'wei'zheng	0
河田长亲	he'tian'zhang'qin	0
和田昭为	he'tian'zhao'wei	0
河野通春	he'ye'tong'chun	0
河野通宣	he'ye'tong'xuan	0
河野通直	he'ye'tong'zhi	0
黑田长政	hei'tian'chang'zheng	0
黑田官兵卫	hei'tian'guan'bing'wei	0
黑田如水	hei'tian'ru'shui	0
黑田孝高	hei'tian'xiao'gao	0
黑田职隆	hei'tian'zhi'long	0
横谷左近	heng'gu'zuo'jin	0
横山喜内	heng'shan'xi'nei	0
横田高松	heng'tian'gao'song	0
鸿池新六	hong'chi'xin'liu	0
弘治	hong'zhi	0
后柏原天皇	hou'bai'yuan'tian'huang	0
后花园上皇	hou'hua'yuan'shang'huang	0
后奈良天皇	hou'nai'liang'tian'huang	0
后水尾天皇	hou'shui'wei'tian'huang	0
后藤基次	hou'teng'ji'ci	0
后藤贤丰	hou'teng'xian'feng	0
后藤信康	hou'teng'xin'kang	0
后藤又兵卫	hou'teng'you'bing'wei	0
后土御门天皇	hou'tu'yu'men'tian'huang	0
后阳成天皇	hou'yang'cheng'tian'huang	0
户川达安	hu'chuan'da'an	0
户川秀安	hu'chuan'xiu'an	0
户次川之战	hu'ci'chuan'zhi'zhan	0
户次鑑连	hu'ci'jian'lian	0
户石崩	hu'shi'beng	0
湖衣姬	hu'yi'ji	0
户沢盛安	hu'ze'sheng'an	0
花房正成	hua'fang'zheng'cheng	0
花房正幸	hua'fang'zheng'xing	0
花房职秀	hua'fang'zhi'xiu	0
花之御所	hua'zhi'yu'suo	0
荒木村重	huang'mu'cun'zhong	0
荒木氏纲	huang'mu'shi'gang	0
会津	hui'jin	0
会津征伐	hui'jin'zheng'fa	0
迹部胜资	ji'bu'sheng'zi	0
吉川广家	ji'chuan'guang'jia	0
吉川经家	ji'chuan'jing'jia	0
吉川元长	ji'chuan'yuan'chang	0
吉川元春	ji'chuan'yuan'chun	0
吉冈长增	ji'gang'chang'zeng	0
吉冈传七郎	ji'gang'chuan'qi'lang	0
吉冈清十郎	ji'gang'qing'shi'lang	0
吉冈宪法	ji'gang'xian'fa	0
吉弘鉴理	ji'hong'jian'li	0
吉弘镇种	ji'hong'zhen'zhong	0
吉见正赖	ji'jian'zheng'lai	0
吉江景资	ji'jiang'jing'zi	0
吉江宗信	ji'jiang'zong'xin	0
吉良亲实	ji'liang'qin'shi	0
吉良亲贞	ji'liang'qin'zhen	0
姬路	ji'lu	0
畿内	ji'nei	0
季琼真蕊	ji'qiong'zhen'rui	0
吉田郡山	ji'tian'jun'shan	0
吉田康俊	ji'tian'kang'jun	0
吉田孝赖	ji'tian'xiao'lai	0
吉田印西	ji'tian'yin'xi	0
吉田政重	ji'tian'zheng'zhong	0
吉田重俊	ji'tian'zhong'jun	0
矶野员昌	ji'ye'yuan'chang	0
纪伊	ji'yi	0
甲斐	jia'fei	0
甲斐之虎	jia'fei'zhi'hu	0
甲斐宗运	jia'fei'zong'yun	0
加贺	jia'he	0
甲贺	jia'he	0
加贺征伐	jia'he'zheng'fa	0
加藤段藏	jia'teng'duan'cang	0
加藤光泰	jia'teng'guang'tai	0
加藤嘉明	jia'teng'jia'ming	0
加藤清正	jia'teng'qing'zheng	0
甲阳军鉴	jia'yang'jun'jian	0
菅达长	jian'da'chang	0
坚田元庆	jian'tian'yuan'qing	0
贱岳合战	jian'yue'he'zhan	0
贱岳七本枪	jian'yue'qi'ben'qiang	0
菅沼定盈	jian'zhao'ding'ying	0
江村亲家	jiang'cun'qing'jia	0
江里口信常	jiang'li'kou'xin'chang	0
江马辉盛	jiang'ma'hui'sheng	0
角仓了以	jiao'cang'le'yi	0
角仓素庵	jiao'cang'su'an	0
角隈石宗	jiao'wei'shi'zong	0
角屋七郎次郎	jiao'wu'qi'lang'ci'lang	0
结城晴朝	jie'cheng'qing'chao	0
结城秀康	jie'cheng'xiu'kang	0
结城政胜	jie'cheng'zheng'sheng	0
堺港	jie'gang	0
今川氏丰	jin'chuan'shi'feng	0
今川氏辉	jin'chuan'shi'hui	0
今川氏亲	jin'chuan'shi'qin	0
今川氏真	jin'chuan'shi'zhen	0
津川义冬	jin'chuan'yi'dong	0
今川义元	jin'chuan'yi'yuan	0
今川义忠	jin'chuan'yi'zhong	0
近江	jin'jiang	0
今井宗久	jin'jing'zong'jiu	0
今井宗薰	jin'jing'zong'xun	0
津轻为信	jin'qing'wei'xin	0
金森长近	jin'sen'chang'jin	0
金上盛备	jin'shang'sheng'bei	0
近藤义武	jin'teng'yi'wu	0
津田监物	jin'tian'jian'wu	0
津田信澄	jin'tian'xin'cheng	0
津田宗及	jin'tian'zong'ji	0
津野亲忠	jin'ye'qin'zhong	0
金泽	jin'ze	0
金子元春	jin'zi'yuan'chun	0
金子元宅	jin'zi'yuan'zhai	0
京极高次	jing'ji'gao'ci	0
京极高吉	jing'ji'gao'ji	0
京极高知	jing'ji'gao'zhi	0
京极龙子	jing'ji'long'zi	0
井伊直政	jing'yi'zhi'zheng	0
臼杵俭速	jiu'chu'jian'su	0
九鬼广隆	jiu'gui'guang'long	0
九鬼嘉隆	jiu'gui'jia'long	0
九鬼守隆	jiu'gui'shou'long	0
九户政实	jiu'hu'zheng'shi	0
酒井家次	jiu'jing'jia'ci	0
酒井忠次	jiu'jing'zhong'ci	0
酒井忠胜	jiu'jing'zhong'sheng	0
酒井忠世	jiu'jing'zhong'shi	0
久武亲信	jiu'wu'qin'xin	0
久武亲直	jiu'wu'qin'zhi	0
九州岛	jiu'zhou'dao	0
九州征伐	jiu'zhou'zheng'fa	0
菊姬	ju'ji	0
菊亭晴季	ju'ting'qing'ji	0
崛立直正	jue'li'zhi'zheng	0
崛内氏善	jue'nei'shi'shan	0
崛尾忠氏	jue'wei'zhong'shi	0
崛直政	jue'zhi'zheng	0
骏府	jun'fu	0
骏河	jun'he	0
可儿才藏	ke'er'cai'cang	0
口羽通良	kou'yu'tong'liang	0
堀尾吉晴	ku'wei'ji'qing	0
堀秀政	ku'xiu'zheng	0
堀秀治	ku'xiu'zhi	0
堀越公方	ku'yue'gong'fang	0
来岛通康	lai'dao'tong'kang	0
来岛通总	lai'dao'tong'zong	0
濑田扫部	lai'tian'sao'bu	0
立花道雪	li'hua'dao'xue	0
立花誾千代	li'hua'yin'qian'dai	0
立花直次	li'hua'zhi'ci	0
立花宗茂	li'hua'zong'mao	0
里见义弘	li'jian'yi'hong	0
里见义康	li'jian'yi'kang	0
里见义赖	li'jian'yi'lai	0
里见义尧	li'jian'yi'yao	0
栗林政赖	li'lin'zheng'lai	0
蛎崎季广	li'qi'ji'guang	0
蛎崎庆广	li'qi'qing'guang	0
利休七哲	li'xiu'qi'zhe	0
立原久纲	li'yuan'jiu'gang	0
笠原政尧	li'yuan'zheng'yao	0
镰仓公方	lian'cang'gong'fang	0
镰仓御所	lian'cang'yu'suo	0
林崎甚助	lin'qi'shen'zhu	0
林通胜	lin'tong'sheng	0
林秀贞	lin'xiu'zhen	0
铃木元信	ling'mu'yuan'xin	0
铃木重朝	ling'mu'zhong'chao	0
铃木重秀	ling'mu'zhong'xiu	0
铃木重意	ling'mu'zhong'yi	0
铃木佐大夫	ling'mu'zuo'dai'fu	0
六角承祯	liu'jiao'cheng'zhen	0
六角定赖	liu'jiao'ding'lai	0
六角高赖	liu'jiao'gao'lai	0
六角义贤	liu'jiao'yi'xian	0
六角义治	liu'jiao'yi'zhi	0
柳生兵库助	liu'sheng'bing'ku'zhu	0
柳生十兵卫	liu'sheng'shi'bing'wei	0
柳生宗矩	liu'sheng'zong'ju	0
柳生宗严	liu'sheng'zong'yan	0
留守政景	liu'shou'zheng'jing	0
柳原户兵卫	liu'yuan'hu'bing'wei	0
泷本寺非有	long'ben'si'fei'you	0
泷川雄利	long'chuan'xiong'li	0
泷川一益	long'chuan'yi'yi	0
泷川益重	long'chuan'yi'zhong	0
笼手田安经	long'shou'tian'an'jing	0
笼手田安一	long'shou'tian'an'yi	0
龙造寺长信	long'zao'si'chang'xin	0
龙造寺家就	long'zao'si'jia'jiu	0
龙造寺隆信	long'zao'si'long'xin	0
龙造寺信周	long'zao'si'xin'zhou	0
龙造寺政家	long'zao'si'zheng'jia	0
陆奥	lu'ao	0
芦名盛隆	lu'ming'sheng'long	0
芦名盛氏	lu'ming'sheng'shi	0
芦名盛兴	lu'ming'sheng'xing	0
芦名盛重	lu'ming'sheng'zhong	0
吕宋助左卫门	lv'song'zhu'zuo'wei'men	0
马场信房	ma'chang'xin'fang	0
毛利辉元	mao'li'hui'yuan	0
毛利隆元	mao'li'long'yuan	0
毛利胜永	mao'li'sheng'yong	0
毛利新助	mao'li'xin'zhu	0
毛利秀广	mao'li'xiu'guang	0
毛利元就	mao'li'yuan'jiu	0
毛利重能	mao'li'zhong'neng	0
毛受胜照	mao'shou'sheng'zhao	0
美浓	mei'nong	0
梅岳承芳	mei'yue'cheng'fang	0
美作	mei'zuo	0
祢寝重长	mi'qin'zhong'chang	0
名古屋山三郎	ming'gu'wu'shan'san'lang	0
明石全登	ming'shi'quan'deng	0
明应	ming'ying	0
明应之变	ming'ying'zhi'bian	0
明智光秀	ming'zhi'guang'xiu	0
明智秀满	ming'zhi'xiu'man	0
明智玉子	ming'zhi'yu'zi	0
末吉孙左卫门	mo'ji'sun'zuo'wei'men	0
末森城之战	mo'sen'cheng'zhi'zhan	0
木曾义昌	mu'ceng'yi'chang	0
木曾义康	mu'ceng'yi'kang	0
牧村兵部	mu'cun'bing'bu	0
木村重成	mu'cun'zhong'cheng	0
木津城	mu'jin'cheng	0
母里太兵卫	mu'li'tai'bing'wei	0
母里友信	mu'li'you'xin	0
木崎原之战	mu'qi'yuan'zhi'zhan	0
木下昌直	mu'xia'chang'zhi	0
木下家定	mu'xia'jia'ding	0
木下利匡	mu'xia'li'kuang	0
木下利直	mu'xia'li'zhi	0
木下藤吉郎	mu'xia'teng'ji'lang	0
木造具政	mu'zao'ju'zheng	0
那古野	na'gu'ye	0
那须资晴	na'xu'zi'qing	0
乃美宗胜	nai'mei'zong'sheng	0
奈佐日本助	nai'zuo'ri'ben'zhu	0
南部利直	nan'bu'li'zhi	0
南部晴政	nan'bu'qing'zheng	0
南部信直	nan'bu'xin'zhi	0
楠长谙	nan'chang'an	0
南海道	nan'hai'dao	0
内管领	nei'guan'ling	0
内藤昌丰	nei'teng'chang'feng	0
内藤如安	nei'teng'ru'an	0
内藤正成	nei'teng'zheng'cheng	0
能登	neng'deng	0
尼子经久	ni'zi'jing'jiu	0
尼子晴久	ni'zi'qing'jiu	0
尼子胜久	ni'zi'sheng'jiu	0
尼子义久	ni'zi'yi'jiu	0
鲇贝宗重	nian'bei'zong'zhong	0
鸟居强右卫门	niao'ju'qiang'you'wei'men	0
鸟居元忠	niao'ju'yuan'zhong	0
鸟居忠吉	niao'ju'zhong'ji	0
宁宁	ning'ning	0
牛尾幸清	niu'wei'xing'qing	0
浓姬	nong'ji	0
毘沙门天	pi'sha'men'tian	0
片仓景纲	pian'cang'jing'gang	0
片桐且元	pian'tong'qie'yuan	0
平冈房实	ping'gang'fang'shi	0
平贺元相	ping'he'yuan'xiang	0
平氏	ping'shi	0
平手汎秀	ping'shou'fa'xiu	0
平手经治	ping'shou'jing'zhi	0
平手政秀	ping'shou'zheng'xiu	0
平岩亲吉	ping'yan'qin'ji	0
平野长泰	ping'ye'chang'tai	0
破竹柴田	po'zhu'chai'tian	0
蒲池鉴盛	pu'chi'jian'sheng	0
蒲池镇涟	pu'chi'zhen'lian	0
浦上宗景	pu'shang'zong'jing	0
蒲生定秀	pu'sheng'ding'xiu	0
蒲生赖乡	pu'sheng'lai'xiang	0
蒲生氏乡	pu'sheng'shi'xiang	0
蒲生贤秀	pu'sheng'xian'xiu	0
蒲生乡舍	pu'sheng'xiang'she	0
蒲生秀行	pu'sheng'xiu'xing	0
七里赖周	qi'li'lai'zhou	0
七条兼仲	qi'tiao'jian'zhong	0
七尾	qi'wei	0
千坂景亲	qian'ban'jing'qin	0
前波吉继	qian'bo'ji'ji	0
千贺孙兵卫	qian'he'sun'bing'wei	0
浅井长时	qian'jing'chang'shi	0
浅井长政	qian'jing'chang'zheng	0
浅井井赖	qian'jing'jing'lai	0
浅井久政	qian'jing'jiu'zheng	0
浅井亮政	qian'jing'liang'zheng	0
浅利胜赖	qian'li'sheng'lai	0
千利休	qian'li'xiu	0
前田安胜	qian'tian'an'sheng	0
前田利长	qian'tian'li'chang	0
前田利常	qian'tian'li'chang	0
前田利昌	qian'tian'li'chang	0
前田利家	qian'tian'li'jia	0
前田利久	qian'tian'li'jiu	0
前田利益	qian'tian'li'yi	0
前田利政	qian'tian'li'zheng	0
前田庆次	qian'tian'qing'ci	0
前田松	qian'tian'song	0
前田秀继	qian'tian'xiu'ji	0
前田玄以	qian'tian'xuan'yi	0
千叶邦胤	qian'ye'bang'yin	0
前野长康	qian'ye'chang'kang	0
浅野长晟	qian'ye'chang'sheng	0
浅野长政	qian'ye'chang'zheng	0
浅野幸长	qian'ye'xing'chang	0
千叶胤富	qian'ye'yin'fu	0
千宗易	qian'zong'yi	0
枪弹正	qiang'dan'zheng	0
枪之又左	qiang'zhi'you'zuo	0
庆长	qing'chang	0
倾奇者	qing'qi'zhe	0
青山忠成	qing'shan'zhong'cheng	0
清水康英	qing'shui'kang'ying	0
清水宗治	qing'shui'zong'zhi	0
清洲	qing'zhou	0
秋山信友	qiu'shan'xin'you	0
秋上久家	qiu'shang'jiu'jia	0
秋田实季	qiu'tian'shi'ji	0
曲直濑道三	qu'zhi'lai'dao'san	0
犬童赖安	quan'tong'lai'an	0
泉泽久秀	quan'ze'jiu'xiu	0
仁科盛信	ren'ke'sheng'xin	0
日本七柱枪	ri'ben'qi'zhu'qiang	0
日根野弘就	ri'gen'ye'hong'jiu	0
日向	ri'xiang	0
日野富子	ri'ye'fu'zi	0
若林镇兴	ruo'lin'zhen'xing	0
若狭	ruo'xia	0
萨摩	sa'mo	0
三村家亲	san'cun'jia'qin	0
三村元亲	san'cun'yuan'qin	0
三弹正	san'dan'zheng	0
三刀屋久佑	san'dao'wu'jiu'you	0
三方原会战	san'fang'yuan'hui'zhan	0
三好长庆	san'hao'chang'qing	0
三好长逸	san'hao'chang'yi	0
三好长治	san'hao'chang'zhi	0
三好康长	san'hao'kang'chang	0
三好三人众	san'hao'san'ren'zhong	0
三好实休	san'hao'shi'xiu	0
三好笑岩	san'hao'xiao'yan	0
三好义继	san'hao'yi'ji	0
三好义贤	san'hao'yi'xian	0
三好义兴	san'hao'yi'xing	0
三好元长	san'hao'yuan'chang	0
三好政康	san'hao'zheng'kang	0
三好政胜	san'hao'zheng'sheng	0
三河	san'he	0
三河魂	san'he'hun	0
三条公赖	san'tiao'gong'lai	0
三云成持	san'yun'cheng'chi	0
三枝守友	san'zhi'shou'you	0
三中老	san'zhong'lao	0
桑名吉成	sang'ming'ji'cheng	0
桑山重晴	sang'shan'zhong'qing	0
色部胜长	se'bu'sheng'chang	0
色部长实	se'bu'zhang'shi	0
森长可	sen'chang'ke	0
森村春	sen'cun'chun	0
森可成	sen'ke'cheng	0
森兰丸	sen'lan'wan	0
森下道与	sen'xia'dao'yu	0
森忠政	sen'zhong'zheng	0
杀生关白	sha'sheng'guan'bai	0
山岸尚家	shan'an'shang'jia	0
山本勘助	shan'ben'kan'zhu	0
山本寺定长	shan'ben'si'ding'chang	0
山城	shan'cheng	0
杉谷善住坊	shan'gu'shan'zhu'fang	0
山科言继	shan'ke'yan'ji	0
山名禅高	shan'ming'chan'gao	0
山名持丰	shan'ming'chi'feng	0
山名佑丰	shan'ming'you'feng	0
山名政丰	shan'ming'zheng'feng	0
山名宗全	shan'ming'zong'quan	0
山内千代	shan'nei'qian'dai	0
山内一丰	shan'nei'yi'feng	0
山浦国清	shan'pu'guo'qing	0
山崎长德	shan'qi'chang'de	0
山崎片家	shan'qi'pian'jia	0
山上宗二	shan'shang'zong'er	0
山田长政	shan'tian'chang'zheng	0
山田匡德	shan'tian'kuang'de	0
山田有信	shan'tian'you'xin	0
山县昌景	shan'xian'chang'jing	0
山阳道	shan'yang'dao	0
山阴道	shan'yin'dao	0
杉之坊照算	shan'zhi'fang'zhao'suan	0
山中俊好	shan'zhong'jun'hao	0
山中鹿介	shan'zhong'lu'jie	0
山中幸盛	shan'zhong'xing'sheng	0
上井觉兼	shang'jing'jue'jian	0
上洛	shang'luo	0
上泉信纲	shang'quan'xin'gang	0
上杉定宪	shang'shan'ding'xian	0
上杉辉虎	shang'shan'hui'hu	0
上杉景虎	shang'shan'jing'hu	0
上杉景胜	shang'shan'jing'sheng	0
上杉景信	shang'shan'jing'xin	0
上杉谦信	shang'shan'qian'xin	0
上杉宪政	shang'shan'xian'zheng	0
上条政繁	shang'tiao'zheng'fan	0
上野	shang'ye	0
上州第一枪	shang'zhou'di'yi'qiang	0
上总	shang'zong	0
涉谷与右卫门	she'gu'yu'you'wei'men	0
摄津	she'jin	0
神保氏张	shen'bao'shi'zhang	0
神保长城	shen'bao'zhang'cheng	0
神保长职	shen'bao'zhang'zhi	0
神保长住	shen'bao'zhang'zhu	0
神户具盛	shen'hu'ju'sheng	0
深水长智	shen'shui'chang'zhi	0
神屋宗湛	shen'wu'zong'zhan	0
神西元通	shen'xi'yuan'tong	0
深泽利重	shen'ze'li'zhong	0
生驹吉乃	sheng'ju'ji'nai	0
生驹亲正	sheng'ju'qin'zheng	0
生驹一正	sheng'ju'yi'zheng	0
石川高信	shi'chuan'gao'xin	0
市川经好	shi'chuan'jing'hao	0
石川数正	shi'chuan'shu'zheng	0
石川五右卫门	shi'chuan'wu'you'wei'men	0
石川昭光	shi'chuan'zhao'guang	0
室町幕府	shi'ding'mu'fu	0
室町御所	shi'ding'yu'suo	0
师冈一羽	shi'gang'yi'yu	0
世鬼政时	shi'gui'zheng'shi	0
十河存保	shi'he'cun'bao	0
十河一存	shi'he'yi'cun	0
氏家卜全	shi'jia'bu'quan	0
氏家光氏	shi'jia'guang'shi	0
氏家守栋	shi'jia'shou'dong	0
氏家行广	shi'jia'xing'guang	0
氏家直元	shi'jia'zhi'yuan	0
石见	shi'jian	0
世濑藏人	shi'lai'cang'ren	0
石母田景赖	shi'mu'tian'jing'lai	0
柿崎景家	shi'qi'jing'jia	0
柿崎晴家	shi'qi'qing'jia	0
石山御坊	shi'shan'yu'fang	0
石田三成	shi'tian'san'cheng	0
石田重家	shi'tian'zhong'jia	0
施药院全宗	shi'yao'yuan'quan'zong	0
矢沢赖纲	shi'ze'lai'gang	0
矢沢赖康	shi'ze'lai'kang	0
寿桂尼	shou'gui'ni	0
守护代	shou'hu'dai	0
狩野永德	shou'ye'yong'de	0
水谷胤重	shui'gu'yin'zhong	0
水野胜成	shui'ye'sheng'cheng	0
水野信元	shui'ye'xin'yuan	0
水野忠重	shui'ye'zhong'zhong	0
斯波诠真	si'bo'quan'zhen	0
斯波诠直	si'bo'quan'zhi	0
斯波义达	si'bo'yi'da	0
斯波义廉	si'bo'yi'lian	0
斯波义良	si'bo'yi'liang	0
斯波义敏	si'bo'yi'min	0
斯波义统	si'bo'yi'tong	0
斯波义银	si'bo'yi'yin	0
四国征伐	si'guo'zheng'fa	0
松波义亲	song'bo'yi'qin	0
松仓重信	song'cang'zhong'xin	0
松仓重政	song'cang'zhong'zheng	0
松井康之	song'jing'kang'zhi	0
松井友闲	song'jing'you'xian	0
松平广忠	song'ping'guang'zhong	0
松平清康	song'ping'qing'kang	0
松平信康	song'ping'xin'kang	0
松平元康	song'ping'yuan'kang	0
松平忠辉	song'ping'zhong'hui	0
松平忠吉	song'ping'zhong'ji	0
松浦隆信	song'pu'long'xin	0
松浦镇信	song'pu'zhen'xin	0
松前庆广	song'qian'qing'guang	0
松田宪秀	song'tian'xian'xiu	0
松下加兵卫	song'xia'jia'bing'wei	0
松永久通	song'yong'jiu'tong	0
松永久秀	song'yong'jiu'xiu	0
穗井田元清	sui'jing'tian'yuan'qing	0
太田长知	tai'tian'chang'zhi	0
太田道灌	tai'tian'dao'guan	0
太田牛一	tai'tian'niu'yi	0
太田三乐斋	tai'tian'san'le'zhai	0
太田氏资	tai'tian'shi'zi	0
太田宗正	tai'tian'zong'zheng	0
太原雪斋	tai'yuan'xue'zhai	0
太政大臣	tai'zheng'da'chen	0
汤浅五助	tang'qian'wu'zhu	0
逃弹正	tao'dan'zheng	0
陶晴贤	tao'qing'xian	0
藤堂高虎	teng'tang'gao'hu	0
鹈殿长照	ti'dian'chang'zhao	0
鹈殿氏长	ti'dian'shi'chang	0
鹈饲孙六	ti'si'sun'liu	0
田北镇周	tian'bei'zhen'zhou	0
天草四郎	tian'cao'si'lang	0
田村清显	tian'cun'qing'xian	0
田村重显	tian'cun'zhong'xian	0
畠山高政	tian'shan'gao'zheng	0
畠山义纲	tian'shan'yi'gang	0
畠山义就	tian'shan'yi'jiu	0
畠山义续	tian'shan'yi'xu	0
畠山政长	tian'shan'zheng'chang	0
畠山政国	tian'shan'zheng'guo	0
畠山植长	tian'shan'zhi'chang	0
天文	tian'wen	0
天文之乱	tian'wen'zhi'luan	0
天秀尼	tian'xiu'ni	0
天野康景	tian'ye'kang'jing	0
天野隆重	tian'ye'long'zhong	0
田原亲贤	tian'yuan'qin'xian	0
天正	tian'zheng	0
田中吉政	tian'zhong'ji'zheng	0
田中胜助	tian'zhong'sheng'zhu	0
筒井定次	tong'jing'ding'ci	0
筒井顺庆	tong'jing'shun'qing	0
桶狭间会战	tong'xia'jian'hui'zhan	0
土井利胜	tu'jing'li'sheng	0
土居宗珊	tu'ju'zong'shan	0
土岐成赖	tu'qi'cheng'lai	0
土岐赖次	tu'qi'lai'ci	0
土岐赖艺	tu'qi'lai'yi	0
土桥平次	tu'qiao'ping'ci	0
土田御前	tu'tian'yu'qian	0
土屋昌次	tu'wu'chang'ci	0
土屋昌恒	tu'wu'chang'heng	0
土佐	tu'zuo	0
拓植三之丞	tuo'zhi'san'zhi'cheng	0
丸目长惠	wan'mu'chang'hui	0
望月六郎	wang'yue'liu'lang	0
娓原景宗	wei'yuan'jing'zong	0
尾张	wei'zhang	0
尾张之虎	wei'zhang'zhi'hu	0
文龟	wen'gui	0
温井景隆	wen'jing'jing'long	0
文禄	wen'lu	0
文明	wen'ming	0
问驻所统景	wen'zhu'suo'tong'jing	0
五大老	wu'da'lao	0
屋代景赖	wu'dai'jing'lai	0
五代友喜	wu'dai'you'xi	0
五奉行	wu'feng'xing	0
武井夕庵	wu'jing'xi'an	0
五轮书	wu'lun'shu	0
武田胜赖	wu'tian'sheng'lai	0
武田逍遥轩	wu'tian'xiao'yao'xuan	0
武田信繁	wu'tian'xin'fan	0
武田信丰	wu'tian'xin'feng	0
武田信虎	wu'tian'xin'hu	0
武田信吉	wu'tian'xin'ji	0
武田信廉	wu'tian'xin'lian	0
武田信胜	wu'tian'xin'sheng	0
武田信玄	wu'tian'xin'xuan	0
武田义信	wu'tian'yi'xin	0
武田元明	wu'tian'yuan'ming	0
武野绍鸥	wu'ye'shao'ou	0
雾隐才藏	wu'yin'cai'cang	0
武藏	wu'zang	0
细川高国	xi'chuan'gao'guo	0
细川晴元	xi'chuan'qing'yuan	0
西川仁右卫门	xi'chuan'ren'you'wei'men	0
细川三斋	xi'chuan'san'zhai	0
细川胜元	xi'chuan'sheng'yuan	0
细川氏纲	xi'chuan'shi'gang	0
细川藤孝	xi'chuan'teng'xiao	0
细川幽斋	xi'chuan'you'zhai	0
细川元常	xi'chuan'yuan'chang	0
细川昭元	xi'chuan'zhao'yuan	0
细川政元	xi'chuan'zheng'yuan	0
细川忠兴	xi'chuan'zhong'xing	0
西国无双的大将	xi'guo'wu'shuang'de'da'jiang	0
西国之雄	xi'guo'zhi'xiong	0
西海道	xi'hai'dao	0
喜入季久	xi'ru'ji'jiu	0
西园寺公广	xi'yuan'si'gong'guang	0
下间赖廉	xia'jian'lai'lian	0
下间赖照	xia'jian'lai'zhao	0
下间仲孝	xia'jian'zhong'xiao	0
下克上	xia'ke'shang	0
夏目晴信	xia'mu'qing'xin	0
下野	xia'ye	0
虾夷	xia'yi	0
下总	xia'zong	0
仙石秀久	xian'shi'xiu'jiu	0
仙桃院	xian'tao'yuan	0
香川亲和	xiang'chuan'qin'he	0
香川元景	xiang'chuan'yuan'jing	0
香川之景	xiang'chuan'zhi'jing	0
向井正纲	xiang'jing'zheng'gang	0
相良义阳	xiang'liang'yi'yang	0
享禄	xiang'lu	0
相马盛胤	xiang'ma'sheng'yin	0
相马显胤	xiang'ma'xian'yin	0
相马义胤	xiang'ma'yi'yin	0
相模	xiang'mo	0
相模的狮子	xiang'mo'de'shi'zi	0
香宗我部亲泰	xiang'zong'wo'bu'qin'tai	0
小滨景隆	xiao'bin'jing'long	0
筱部堪二郎	xiao'bu'kan'er'lang	0
小岛职镇	xiao'dao'zhi'zhen	0
小豆坂合战	xiao'dou'ban'he'zhan	0
小督	xiao'du	0
小幡虎盛	xiao'fan'hu'sheng	0
小幡堪兵卫	xiao'fan'kan'bing'wei	0
小谷	xiao'gu	0
小崛远洲	xiao'jue'yuan'zhou	0
小濑甫庵	xiao'lai'fu'an	0
小笠原长时	xiao'li'yuan'chang'shi	0
小笠原少斋	xiao'li'yuan'shao'zhai	0
小梁川盛宗	xiao'liang'chuan'sheng'zong	0
小牧山长久手之战	xiao'mu'shan'chang'jiu'shou'zhi'zhan	0
小山田信茂	xiao'shan'tian'xin'mao	0
小山田信有	xiao'shan'tian'xin'you	0
小寺政职	xiao'si'zheng'zhi	0
小田氏治	xiao'tian'shi'zhi	0
小田原	xiao'tian'yuan	0
小田原征伐	xiao'tian'yuan'zheng'fa	0
小西行长	xiao'xi'hang'zhang	0
小西隆佐	xiao'xi'long'zuo	0
小野善鬼	xiao'ye'shan'gui	0
小野寺辉道	xiao'ye'si'hui'dao	0
小野寺义道	xiao'ye'si'yi'dao	0
小野镇幸	xiao'ye'zhen'xing	0
小野忠明	xiao'ye'zhong'ming	0
筱原长房	xiao'yuan'zhang'fang	0
小早川隆景	xiao'zao'chuan'long'jing	0
小早川秀包	xiao'zao'chuan'xiu'bao	0
小早川秀秋	xiao'zao'chuan'xiu'qiu	0
胁阪安治	xie'ban'an'zhi	0
新发田长敦	xin'fa'tian'chang'dun	0
新发田重家	xin'fa'tian'zhong'jia	0
新纳忠元	xin'na'zhong'yuan	0
信浓	xin'nong	0
熊谷信直	xiong'gu'xin'zhi	0
朽木元纲	xiu'mu'yuan'gang	0
须田满亲	xu'tian'man'qin	0
穴户隆家	xue'hu'long'jia	0
穴户梅轩	xue'hu'mei'xuan	0
穴户元续	xue'hu'yuan'xu	0
穴山梅雪	xue'shan'mei'xue	0
穴山小助	xue'shan'xiao'zhu	0
穴山信君	xue'shan'xin'jun	0
岩城常隆	yan'cheng'chang'long	0
岩成友通	yan'cheng'you'tong	0
延德	yan'de	0
岩剑城之战	yan'jian'cheng'zhi'zhan	0
延历寺	yan'li'si	0
塩市丸	yan'shi'wan	0
一乘谷	yi'cheng'gu	0
伊达成实	yi'da'cheng'shi	0
伊达辉宗	yi'da'hui'zong	0
伊达晴宗	yi'da'qing'zong	0
伊达实元	yi'da'shi'yuan	0
伊达政宗	yi'da'zheng'zong	0
伊达稙宗	yi'da'zhi'zong	0
伊丹康直	yi'dan'kang'zhi	0
伊地知重兴	yi'di'zhi'chong'xing	0
伊地知重秀	yi'di'zhi'zhong'xiu	0
伊东义佑	yi'dong'yi'you	0
伊东佑安	yi'dong'you'an	0
伊东佑兵	yi'dong'you'bing	0
伊豆	yi'dou	0
依冈左京	yi'gang'zuo'jing	0
伊贺	yi'he	0
伊贺崎道顺	yi'he'qi'dao'shun	0
伊集院忠仓	yi'ji'yuan'zhong'cang	0
伊集院忠栋	yi'ji'yuan'zhong'dong	0
一领具足	yi'ling'ju'zu	0
一门众	yi'men'zhong	0
伊木忠次	yi'mu'zhong'ci	0
伊奈忠次	yi'nai'zhong'ci	0
壹岐	yi'qi	0
一色义道	yi'se'yi'dao	0
一色义定	yi'se'yi'ding	0
一色义清	yi'se'yi'qing	0
一色义直	yi'se'yi'zhi	0
伊势	yi'shi	0
伊势盛时	yi'shi'sheng'shi	0
伊势贞亲	yi'shi'zhen'qin	0
一粟放牛	yi'su'fang'niu	0
伊藤物十郎	yi'teng'wu'shi'lang	0
伊藤一刀斋	yi'teng'yi'dao'zhai	0
益田元祥	yi'tian'yuan'xiang	0
一条兼定	yi'tiao'jian'ding	0
一条信龙	yi'tiao'xin'long	0
一万田鉴实	yi'wan'tian'jian'shi	0
一向一揆	yi'xiang'yi'kui	0
一向宗	yi'xiang'zong	0
以心崇纭	yi'xin'chong'yun	0
伊予	yi'yu	0
因幡	yin'fan	0
隐岐	yin'qi	0
樱井晴吉	ying'jing'qing'ji	0
应仁	ying'ren	0
应仁之乱	ying'ren'zhi'luan	0
鹰司孝子	ying'si'xiao'zi	0
鹰司信房	ying'si'xin'fang	0
颖娃久虎	ying'wa'jiu'hu	0
永禄	yong'lu	0
永田德本	yong'tian'de'ben	0
永正	yong'zheng	0
由比正雪	you'bi'zheng'xue	0
由布姬	you'bu'ji	0
由利镰之助	you'li'lian'zhi'zhu	0
有马晴信	you'ma'qing'xin	0
友野二郎兵卫	you'ye'er'lang'bing'wei	0
游佐长教	you'zuo'chang'jiao	0
游佐续光	you'zuo'xu'guang	0
羽柴秀长	yu'chai'xiu'chang	0
羽柴秀次	yu'chai'xiu'ci	0
羽柴秀吉	yu'chai'xiu'ji	0
羽柴秀胜	yu'chai'xiu'sheng	0
宇都宫广纲	yu'du'gong'guang'gang	0
宇都宫国纲	yu'du'gong'guo'gang	0
御馆之乱	yu'guan'zhi'luan	0
宇久纯定	yu'jiu'chun'ding	0
宇久纯玄	yu'jiu'chun'xuan	0
雨森弥兵卫	yu'sen'mi'bing'wei	0
宇山久兼	yu'shan'jiu'jian	0
御宿堪兵卫	yu'su'kan'bing'wei	0
宇喜多秀家	yu'xi'duo'xiu'jia	0
宇喜多直家	yu'xi'duo'zhi'jia	0
宇喜多忠家	yu'xi'duo'zhong'jia	0
宇野藤右卫门	yu'ye'teng'you'wei'men	0
宇佐美定满	yu'zuo'mei'ding'man	0
原长赖	yuan'chang'lai	0
原昌胤	yuan'chang'yin	0
圆城寺信胤	yuan'cheng'si'xin'yin	0
猿渡信光	yuan'du'xin'guang	0
猿飞佐助	yuan'fei'zuo'zhu	0
元龟	yuan'gui	0
元和	yuan'he	0
原虎胤	yuan'hu'yin	0
远江	yuan'jiang	0
远山纲景	yuan'shan'gang'jing	0
远山景任	yuan'shan'jing'ren	0
远山康光	yuan'shan'kang'guang	0
源氏	yuan'shi	0
远藤基信	yuan'teng'ji'xin	0
远藤直经	yuan'teng'zhi'jing	0
原田宗时	yuan'tian'zong'shi	0
垣屋光成	yuan'wu'guang'cheng	0
愿证寺证惠	yuan'zheng'si'zheng'hui	0
越后	yue'hou	0
越后之龙	yue'hou'zhi'long	0
越前	yue'qian	0
越中	yue'zhong	0
杂贺孙市	za'he'sun'shi	0
杂贺孙一	za'he'sun'yi	0
讃岐	zan'qi	0
糟屋武则	zao'wu'wu'ze	0
增田长盛	zeng'tian'chang'sheng	0
斋村政广	zhai'cun'zheng'guang	0
斋藤朝信	zhai'teng'chao'xin	0
斋藤传鬼坊	zhai'teng'chuan'gui'fang	0
斋藤道三	zhai'teng'dao'san	0
斋藤归蝶	zhai'teng'gui'die	0
斋藤利三	zhai'teng'li'san	0
斋藤龙兴	zhai'teng'long'xing	0
斋藤义龙	zhai'teng'yi'long	0
沼田佑光	zhao'tian'you'guang	0
真壁氏干	zhen'bi'shi'gan	0
真柄直澄	zhen'bing'zhi'cheng	0
真柄直隆	zhen'bing'zhi'long	0
真田昌辉	zhen'tian'chang'hui	0
真田昌幸	zhen'tian'chang'xing	0
真田大助	zhen'tian'da'zhu	0
真田十勇士	zhen'tian'shi'yong'shi	0
真田丸	zhen'tian'wan	0
真田信昌	zhen'tian'xin'chang	0
真田信繁	zhen'tian'xin'fan	0
真田信纲	zhen'tian'xin'gang	0
真田信吉	zhen'tian'xin'ji	0
真田信幸	zhen'tian'xin'xing	0
真田信政	zhen'tian'xin'zheng	0
真田信之	zhen'tian'xin'zhi	0
真田幸昌	zhen'tian'xing'chang	0
真田幸村	zhen'tian'xing'cun	0
真田幸隆	zhen'tian'xing'long	0
正木赖忠	zheng'mu'lai'zhong	0
正木时茂	zheng'mu'shi'mao	0
正木时忠	zheng'mu'shi'zhong	0
正亲町天皇	zheng'qin'ding'tian'huang	0
支仓常长	zhi'cang'chang'chang	0
志村光安	zhi'cun'guang'an	0
志贺亲次	zhi'he'qin'ci	0
志贺亲守	zhi'he'qin'shou	0
直江兼续	zhi'jiang'jian'xu	0
直江景纲	zhi'jiang'jing'gang	0
直江实纲	zhi'jiang'shi'gang	0
直江信纲	zhi'jiang'xin'gang	0
直江状	zhi'jiang'zhuang	0
志摩	zhi'mo	0
芝迁清右卫门	zhi'qian'qing'you'wei'men	0
芝山监物	zhi'shan'jian'wu	0
织田长次	zhi'tian'chang'ci	0
织田长益	zhi'tian'chang'yi	0
织田犬	zhi'tian'quan	0
织田胜长	zhi'tian'sheng'chang	0
织田市	zhi'tian'shi	0
织田信安	zhi'tian'xin'an	0
织田信包	zhi'tian'xin'bao	0
织田信长	zhi'tian'xin'chang	0
织田信定	zhi'tian'xin'ding	0
织田信高	zhi'tian'xin'gao	0
织田信光	zhi'tian'xin'guang	0
织田信广	zhi'tian'xin'guang	0
织田信好	zhi'tian'xin'hao	0
织田信吉	zhi'tian'xin'ji	0
织田信胜	zhi'tian'xin'sheng	0
织田信贤	zhi'tian'xin'xian	0
织田信孝	zhi'tian'xin'xiao	0
织田信行	zhi'tian'xin'xing	0
织田信兴	zhi'tian'xin'xing	0
织田信雄	zhi'tian'xin'xiong	0
织田信秀	zhi'tian'xin'xiu	0
织田信友	zhi'tian'xin'you	0
织田信贞	zhi'tian'xin'zhen	0
织田信正	zhi'tian'xin'zheng	0
织田信忠	zhi'tian'xin'zhong	0
织田秀孝	zhi'tian'xiu'xiao	0
织田秀信	zhi'tian'xiu'xin	0
织田有乐斋	zhi'tian'you'le'zhai	0
踯躅崎馆	zhi'zhu'qi'guan	0
中川光重	zhong'chuan'guang'zhong	0
中川清秀	zhong'chuan'qing'xiu	0
中村一荣	zhong'cun'yi'rong	0
中村一氏	zhong'cun'yi'shi	0
中村一忠	zhong'cun'yi'zhong	0
中岛可之助	zhong'dao'ke'zhi'zhu	0
中岛重房	zhong'dao'zhong'fang	0
钟卷自斋	zhong'juan'zi'zhai	0
中山朝正	zhong'shan'chao'zheng	0
中条景泰	zhong'tiao'jing'tai	0
中野宗时	zhong'ye'zong'shi	0
冢原卜传	zhong'yuan'bu'chuan	0
种子岛久时	zhong'zi'dao'jiu'shi	0
种子岛时尧	zhong'zi'dao'shi'yao	0
周防	zhou'fang	0
筑后	zhu'hou	0
诸角虎定	zhu'jiao'hu'ding	0
猪苗代盛国	zhu'miao'dai'sheng'guo	0
筑前	zhu'qian	0
筑田藤左兵卫	zhu'tian'teng'zuo'bing'wei	0
猪俣邦宪	zhu'yu'bang'xian	0
竹俣庆纲	zhu'yu'qing'gang	0
竹中半兵卫	zhu'zhong'ban'bing'wei	0
竹中重门	zhu'zhong'zhong'men	0
竹中重治	zhu'zhong'zhong'zhi	0
猪子兵介	zhu'zi'bing'jie	0
椎名康胤	zhui'ming'kang'yin	0
姊小路赖纲	zi'xiao'lu'lai'gang	0
宗义调	zong'yi'tiao	0
宗义智	zong'yi'zhi	0
诹访大明神	zou'fang'da'ming'shen	0
诹访湖	zou'fang'hu	0
诹访赖高	zou'fang'lai'gao	0
诹访赖满	zou'fang'lai'man	0
诹访赖重	zou'fang'lai'zhong	0
诹访御料人	zou'fang'yu'liao'ren	0
足利成氏	zu'li'cheng'shi	0
足利义材	zu'li'yi'cai	0
足利义澄	zu'li'yi'cheng	0
足利义辉	zu'li'yi'hui	0
足利义晴	zu'li'yi'qing	0
足利义荣	zu'li'yi'rong	0
足利义尚	zu'li'yi'shang	0
足利义视	zu'li'yi'shi	0
足利义氏	zu'li'yi'shi	0
足利义维	zu'li'yi'wei	0
足利义寻	zu'li'yi'xun	0
足利义昭	zu'li'yi'zhao	0
足利义政	zu'li'yi'zheng	0
足利义稙	zu'li'yi'zhi	0
足利政知	zu'li'zheng'zhi	0
足田丰五郎	zu'tian'feng'wu'lang	0
组屋源四郎	zu'wu'yuan'si'lang	0
最上义光	zui'shang'yi'guang	0
最上义姬	zui'shang'yi'ji	0
最上义时	zui'shang'yi'shi	0
最上义守	zui'shang'yi'shou	0
佐伯惟定	zuo'bo'wei'ding	0
佐渡	zuo'du	0
佐分利猪之助	zuo'fen'li'zhu'zhi'zhu	0
佐贺山	zuo'he'shan	0
佐甲藤太郎	zuo'jia'teng'tai'lang	0
佐久间盛政	zuo'jiu'jian'sheng'zheng	0
佐久间盛重	zuo'jiu'jian'sheng'zhong	0
佐久间信盛	zuo'jiu'jian'xin'sheng	0
佐世元嘉	zuo'shi'yuan'jia	0
佐田彦四郎	zuo'tian'yan'si'lang	0
佐胁良之	zuo'xie'liang'zhi	0
佐野房纲	zuo'ye'fang'gang	0
佐治信方	zuo'zhi'xin'fang	0
佐治一成	zuo'zhi'yi'cheng	0
佐竹义久	zuo'zhu'yi'jiu	0
佐竹义宣	zuo'zhu'yi'xuan	0
佐竹义昭	zuo'zhu'yi'zhao	0
佐竹义重	zuo'zhu'yi'zhong	0
佐佐成政	zuo'zuo'cheng'zheng	0
佐佐木小次郎	zuo'zuo'mu'xiao'ci'lang	0
佐佐政次	zuo'zuo'zheng'ci	0
