爱川杏里季	ai'chuan'xing'li'ji	0
爱香瞬	ai'xiang'shun	0
安倍麻美	an'bei'ma'mei	0
安倍夏树	an'bei'xia'shu	0
安齐美绪	an'qi'mei'xu	0
安藤有里	an'teng'you'li	0
白岛智惠子	bai'dao'zhi'hui'zi	0
白石瞳	bai'shi'tong	0
卑弥呼	bei'mi'hu	0
北山惠理	bei'shan'hui'li	0
北原梨奈	bei'yuan'li'nai	0
滨崎步	bin'qi'bu	0
柴田亚由美	chai'tian'ya'you'mei	0
朝冈实岭	chao'gang'shi'ling	0
初美智佳子	chu'mei'zhi'jia'zi	0
雏形明子	chu'xing'ming'zi	0
川村千里	chuan'cun'qian'li	0
川村亚纪	chuan'cun'ya'ji	0
川岛和津实	chuan'dao'he'jin'shi	0
川合里美	chuan'he'li'mei	0
川崎爱	chuan'qi'ai	0
川原洋子	chuan'yuan'yang'zi	0
大城美和	da'cheng'mei'he	0
大内亚里沙	da'nei'ya'li'sha	0
大浦安娜	da'pu'an'na	0
大石彩香	da'shi'cai'xiang	0
渡濑晶	du'lai'jing	0
二宫步美	er'gong'bu'mei	0
二宫优	er'gong'you	0
饭岛爱	fan'dao'ai	0
风吹亚吉拉	feng'chui'ya'ji'la	0
丰丸	feng'wan	0
福井裕佳梨	fu'jing'yu'jia'li	0
福永	fu'yong	0
冈仓鲇	gang'cang'nian	0
冈元厚子	gang'yuan'hou'zi	0
高部	gao'bu	0
高木加织	gao'mu'jia'zhi	0
高樹千佳子	gao'shu'qian'jia'zi	0
宫下杏奈	gong'xia'xing'nai	0
桂木亚沙美	gui'mu'ya'sha'mei	0
河村彩	he'cun'cai	0
河合绫	he'he'ling	0
和希沙也	he'xi'sha'ye	0
河中麻系	he'zhong'ma'xi	0
黑木香	hei'mu'xiang	0
黒崎	hei'qi	0
黑崎彩	hei'qi'cai	0
横山知枝	heng'shan'zhi'zhi	0
戶田惠梨香	hu'tian'hui'li'xiang	0
吉川綾乃	ji'chuan'ling'nai	0
吉田亜咲	ji'tian'ya'xiao	0
加藤爱	jia'teng'ai	0
近藤和美	jin'teng'he'mei	0
金泽明子	jin'ze'ming'zi	0
金泽文子	jin'ze'wen'zi	0
京乃	jing'nai	0
久保亚沙香	jiu'bao'ya'sha'xiang	0
酒井彩名	jiu'jing'cai'ming	0
酒井瑛里	jiu'jing'ying'li	0
濑户朝香	lai'hu'chao'xiang	0
来栖淳子	lai'qi'chun'zi	0
凉木桃香	liang'mu'tao'xiang	0
铃木麻奈美	ling'mu'ma'nai'mei	0
鈴木茜	ling'mu'qian	0
铃木史华	ling'mu'shi'hua	0
铃木亚美	ling'mu'ya'mei	0
柳明日香	liu'ming'ri'xiang	0
麻美	ma'mei	0
麻生早苗	ma'sheng'zao'miao	0
梅宫	mei'gong	0
美里真里	mei'li'zhen'li	0
美穗由纪	mei'sui'you'ji	0
木村衣里	mu'cun'yi'li	0
木内晶	mu'nei'jing	0
木内晶子	mu'nei'jing'zi	0
木下亚由美	mu'xia'ya'you'mei	0
南波杏	nan'bo'xing	0
內田沙也加	nei'tian'sha'ye'jia	0
片濑亚纪	pian'lai'ya'ji	0
平山绫	ping'shan'ling	0
七生奈央	qi'sheng'nai'yang	0
浅仓舞	qian'cang'wu	0
青沼知朝	qing'zhao'zhi'chao	0
秋菜枫	qiu'cai'feng	0
秋山惠	qiu'shan'hui	0
秋元彩香	qiu'yuan'cai'xiang	0
秋元友美	qiu'yuan'you'mei	0
曲山英里	qu'shan'ying'li	0
日吉亚衣	ri'ji'ya'yi	0
若槻千夏	ruo'gui'qian'xia	0
三浦爱	san'pu'ai	0
三浦绮音	san'pu'qi'yin	0
三浦智佳	san'pu'zhi'jia	0
三田爱	san'tian'ai	0
森下千里	sen'xia'qian'li	0
纱山恵理	sha'shan'hui'li	0
山本惠美	shan'ben'hui'mei	0
杉本知春	shan'ben'zhi'chun	0
山本梓	shan'ben'zi	0
山口敦子	shan'kou'dun'zi	0
上戸彩	shang'hu'cai	0
涉谷	she'gu	0
神乃麻美	shen'nai'ma'mei	0
生稻晃子	sheng'dao'huang'zi	0
生驹惠理子	sheng'ju'hui'li'zi	0
石川惠理	shi'chuan'hui'li	0
矢田亚希子	shi'tian'ya'xi'zi	0
树麻里子	shu'ma'li'zi	0
水崎綾女	shui'qi'ling'nv	0
水泽千夏写真图片	shui'ze'qian'xia'xie'zhen'tu'pian	0
松阪季实子	song'ban'ji'shi'zi	0
松本江梨花	song'ben'jiang'li'hua	0
松井沙也香	song'jing'sha'ye'xiang	0
松浦亚弥	song'pu'ya'mi	0
藤本绫	teng'ben'ling	0
藤本美贵	teng'ben'mei'gui	0
田原步	tian'yuan'bu	0
桐岛绘里香	tong'dao'hui'li'xiang	0
细川百合子	xi'chuan'bai'he'zi	0
细川文惠	xi'chuan'wen'hui	0
夕树舞子	xi'shu'wu'zi	0
夏川纯	xia'chuan'chun	0
相川美沙绪	xiang'chuan'mei'sha'xu	0
相马茜	xiang'ma'qian	0
相田桃	xiang'tian'tao	0
小仓亚莉丝	xiao'cang'ya'li'si	0
小池荣子	xiao'chi'rong'zi	0
小林惠美	xiao'lin'hui'mei	0
小林瞳	xiao'lin'tong	0
小室友里	xiao'shi'you'li	0
小松彩夏	xiao'song'cai'xia	0
小松千春	xiao'song'qian'chun	0
小田有紗	xiao'tian'you'sha	0
小泽奈美	xiao'ze'nai'mei	0
小泽圆	xiao'ze'yuan	0
新山爱里	xin'shan'ai'li	0
新山千春	xin'shan'qian'chun	0
杏小百合	xing'xiao'bai'he	0
星野光	xing'ye'guang	0
星野亚希	xing'ye'ya'xi	0
淹尺乃南	yan'chi'nai'nan	0
叶山丽子	ye'shan'li'zi	0
伊藤	yi'teng	0
音咲绚	yin'xiao'xuan	0
隐者	yin'zhe	0
樱井风花	ying'jing'feng'hua	0
樱树露衣	ying'shu'lu'yi	0
樱庭凉子	ying'ting'liang'zi	0
英知文子	ying'zhi'wen'zi	0
樱朱音	ying'zhu'yin	0
忧木瞳	you'mu'tong	0
有栖川志乃	you'qi'chuan'zhi'nai	0
宇田川绫子	yu'tian'chuan'ling'zi	0
元村	yuan'cun	0
原千晶	yuan'qian'jing	0
原史奈图片	yuan'shi'nai'tu'pian	0
泽尻绘理香	ze'kao'hui'li'xiang	0
真锅薰	zhen'guo'xun	0
真山	zhen'shan	0
中川翔子	zhong'chuan'xiang'zi	0
中村知世	zhong'cun'zhi'shi	0
中岛史惠	zhong'dao'shi'hui	0
仲千菜美	zhong'qian'cai'mei	0
佐藤江梨子	zuo'teng'jiang'li'zi	0
佐藤蓝子	zuo'teng'lan'zi	0
