暗红色	an'hong'se	0
白色	bai'se	0
半流质饮食	ban'liu'zhi'yin'shi	0
半卧位	ban'wo'wei	0
钡剂灌肠	bei'ji'guan'chang	0
便血	bian'xie	0
冰枕降温	bing'zhen'jiang'wen	0
搏动良好	bo'dong'liang'hao	0
补液	bu'ye	0
彩超	cai'chao	0
草绿色	cao'lv'se	0
拆线	chai'xian	0
肠镜	chang'jing	0
充填式	chong'tian'shi	0
出汗	chu'han	0
床上活动	chuang'shang'huo'dong	0
大便次数	da'bian'ci'shu	0
大便次数增加	da'bian'ci'shu'zeng'jia	0
大便形状变细	da'bian'xing'zhuang'bian'xi	0
带动良好	dai'dong'liang'hao	0
淡红色	dan'hong'se	0
淡黄色	dan'huang'se	0
骶丛麻	di'cong'ma	0
滴分	di'fen	0
低盐饮食	di'yan'yin'shi	0
低脂低盐饮食	di'zhi'di'yan'yin'shi	0
低脂饮食	di'zhi'yin'shi	0
电脑洗肠	dian'nao'xi'chang	0
窦性心律	dou'xing'xin'lv	0
对答不切题	dui'da'bu'qie'ti	0
对答切题	dui'da'qie'ti	0
对症	dui'zheng	0
恶心感	e'xin'gan	0
二级护理	er'ji'hu'li	0
乏力	fa'li	0
发音正常	fa'yin'zheng'chang	0
翻身拍背	fan'shen'pai'bei	0
房颤心率	fang'chan'xin'lv	0
腹股沟	fu'gu'gou	0
腹腔引流管	fu'qiang'yin'liu'guan	0
腹腔引流液	fu'qiang'yin'liu'ye	0
腹痛	fu'tong	0
腹胀	fu'zhang	0
肛周	gang'zhou	0
高热	gao're	0
灌肠	guan'chang	0
光亮	guang'liang	0
褐色	he'se	0
黑便	hei'bian	0
呼吸促	hu'xi'cu	0
呼吸平稳	hu'xi'ping'wen	0
患者	huan'zhe	0
患者表示理解	huan'zhe'biao'shi'li'jie	0
患者能配合	huan'zhe'neng'pei'he	0
患肢制动	huan'zhi'zhi'dong	0
黄褐色	huang'he'se	0
黄绿色	huang'lv'se	0
黄色	huang'se	0
黄色水样便	huang'se'shui'yang'bian	0
黄色稀便	huang'se'xi'bian	0
基础代谢率	ji'chu'dai'xie'lv	0
急性痛苦面容	ji'xing'tong'ku'mian'rong	0
加压包扎	jia'ya'bao'za	0
降糖	jiang'tang	0
降压	jiang'ya	0
绞痛	jiao'tong	0
金黄色	jin'huang'se	0
禁食水	jin'shi'shui	0
颈部无肿大	jing'bu'wu'zhong'da	0
颈部引流管	jing'bu'yin'liu'guan	0
颈部引流液	jing'bu'yin'liu'ye	0
经腹腔镜下	jing'fu'qiang'jing'xia	0
颈过伸体位	jing'guo'shen'ti'wei	0
精神状态良好	jing'shen'zhuang'tai'liang'hao	0
颈项强直	jing'xiang'qiang'zhi	0
拒接抢救	ju'jie'qiang'jiu	0
倦怠	juan'dai	0
绝对卧床休息	jue'dui'wo'chuang'xiu'xi	0
抗炎	kang'yan	0
咳嗽咳痰	ke'sou'ke'tan	0
扩容	kuo'rong	0
留置胃管	liu'zhi'wei'guan	0
流质饮食	liu'zhi'yin'shi	0
律不齐	lv'bu'qi	0
律齐	lv'qi	0
麻木感	ma'mu'gan	0
每小时尿量	mei'xiao'shi'niao'liang	0
扪及	men'ji	0
门诊	men'zhen	0
门诊随访	men'zhen'sui'fang	0
面色苍白	mian'se'cang'bai	0
面罩吸氧	mian'zhao'xi'yang	0
目的	mu'di	0
粘稠	nian'chou	0
捻发音	nian'fa'yin	0
尿储留	niao'chu'liu	0
尿管	niao'guan	0
尿色黄	niao'se'huang	0
呕吐	ou'tu	0
排气	pai'qi	0
排气排便	pai'qi'pai'bian	0
盆腔引流管	pen'qiang'yin'liu'guan	0
盆腔引流液	pen'qiang'yin'liu'ye	0
皮肤清洁干燥	pi'fu'qing'jie'gan'zao	0
脾窝引流管	pi'wo'yin'liu'guan	0
脾窝引流液	pi'wo'yin'liu'ye	0
平卧位	ping'wo'wei	0
普食	pu'shi	0
起搏心率	qi'bo'xin'lv	0
强心利尿	qiang'xin'li'niao	0
切口敷料干燥	qie'kou'fu'liao'gan'zao	0
切口沙袋压迫	qie'kou'sha'dai'ya'po	0
清洁洗肠	qing'jie'xi'chang	0
清水样便	qing'shui'yang'bian	0
蚯蚓状	qiu'yin'zhuang	0
去枕平卧位	qu'zhen'ping'wo'wei	0
全麻	quan'ma	0
全麻已清醒	quan'ma'yi'qing'xing	0
全身皮肤巩膜黄染	quan'shen'pi'fu'gong'mo'huang'ran	0
软食	ruan'shi	0
三级护理	san'ji'hu'li	0
神志清楚	shen'zhi'qing'chu	0
升分	sheng'fen	0
升压	sheng'ya	0
食欲及二便正常	shi'yu'ji'er'bian'zheng'chang	0
食欲下降	shi'yu'xia'jiang	0
手足抽搐	shou'zu'chou'chu	0
术前准备	shu'qian'zhun'bei	0
输血	shu'xue	0
输血浆	shu'xue'jiang	0
输液限速	shu'ye'xian'su	0
糖尿病饮食	tang'niao'bing'yin'shi	0
体温下降	ti'wen'xia'jiang	0
体重下降	ti'zhong'xia'jiang	0
条索状	tiao'suo'zhuang	0
停止排气排便	ting'zhi'pai'qi'pai'bian	0
通畅	tong'chang	0
瞳孔对光反射消失	tong'kong'dui'guang'fan'she'xiao'shi	0
瞳孔散大	tong'kong'san'da	0
头低脚高位	tou'di'jiao'gao'wei	0
外露肠管	wai'lu'chang'guan	0
完善	wan'shan	0
胃肠道造影	wei'chang'dao'zao'ying	0
胃肠减压	wei'chang'jian'ya	0
胃管	wei'guan	0
胃镜	wei'jing	0
胃内容物	wei'nei'rong'wu	0
胃液	wei'ye	0
温盐水清洁洗肠	wen'yan'shui'qing'jie'xi'chang	0
卧床休息	wo'chuang'xiu'xi	0
无诉不适	wu'su'bu'shi	0
无张力疝修补术	wu'zhang'li'shan'xiu'bu'shu	0
吸痰	xi'tan	0
吸氧	xi'yang	0
小时出入量	xiao'shi'chu'ru'liang	0
小时尿量	xiao'shi'niao'liang	0
心电监护	xin'dian'jian'hu	0
心肺复苏	xin'fei'fu'su	0
心率	xin'lv	0
心率快	xin'lv'kuai	0
心跳呼吸停止	xin'tiao'hu'xi'ting'zhi	0
胸腔闭式引流	xiong'qiang'bi'shi'yin'liu	0
胸腔引流管	xiong'qiang'yin'liu'guan	0
胸腔引流液	xiong'qiang'yin'liu'ye	0
血糖	xue'tang	0
血糖低	xue'tang'di	0
血糖高	xue'tang'gao	0
血压	xue'ya	0
血压低	xue'ya'di	0
血压高	xue'ya'gao	0
血氧饱和度	xue'yang'bao'he'du	0
血运良好	xue'yun'liang'hao	0
腰麻	yao'ma	0
一级护理	yi'ji'hu'li	0
意识模糊	yi'shi'mo'hu	0
抑酸	yi'suan	0
引流	yin'liu	0
引流通畅	yin'liu'tong'chang	0
阴囊无肿大	yin'nang'wu'zhong'da	0
硬膜外麻	ying'mo'wai'ma	0
硬膜外中转全麻	ying'mo'wai'zhong'zhuan'quan'ma	0
用药指导	yong'yao'zhi'dao	0
右侧	you'ce	0
造瘘护理	zao'lou'hu'li	0
造瘘口	zao'lou'kou	0
早期下床活动	zao'qi'xia'chuang'huo'dong	0
针尖样	zhen'jian'yang	0
指导口服用药	zhi'dao'kou'fu'yong'yao	0
止吐	zhi'tu	0
中心静脉压	zhong'xin'jing'mai'ya	0
中药保留灌肠	zhong'yao'bao'liu'guan'chang	0
肿胀	zhong'zhang	0
注意事项	zhu'yi'shi'xiang	0
转移性右下腹痛	zhuan'yi'xing'you'xia'fu'tong	0
紫绀	zi'gan	0
足背动脉	zu'bei'dong'mai	0
左侧	zuo'ce	0
