板球棍	ban'qiu'gun	0
棒球棍	bang'qiu'gun	0
爆破子弹	bao'po'zi'dan	0
丙烷瓶	bing'wan'ping	0
长筒霰弹枪	chang'tong'xian'dan'qiang	0
电击器	dian'ji'qi	0
电吉他	dian'ji'ta	0
电锯	dian'ju	0
东洋刀	dong'yang'dao	0
格洛克	ge'luo'ke	0
激光瞄准	ji'guang'miao'zhun	0
急救包	ji'jiu'bao	0
警棍	jing'gun	0
砍刀	kan'dao	0
榴弹发射器	liu'dan'fa'she'qi	0
马格南手枪	ma'ge'nan'shou'qiang	0
平底锅	ping'di'guo	0
汽油桶	qi'you'tong	0
撬棍	qiao'gun	0
燃烧瓶	ran'shao'ping	0
燃烧子弹	ran'shao'zi'dan	0
土制炸弹	tu'zhi'zha'dan	0
胃液炸弹	wei'ye'zha'dan	0
消防斧	xiao'fang'fu	0
氧气瓶	yang'qi'ping	0
