阿氏拖网	a'shi'tuo'wang	0
埃克曼层	ai'ke'man'ceng	0
埃克曼抽吸	ai'ke'man'chou'xi	0
埃克曼螺旋	ai'ke'man'luo'xuan	0
埃克曼深度	ai'ke'man'shen'du	0
埃克曼输送	ai'ke'man'shu'song	0
岸冰	an'bing	0
岸礁	an'jiao	0
澳大利亚	ao'da'li'ya	0
白浪	bai'lang	0
半潮面	ban'chao'mian	0
半岛	ban'dao	0
斑礁	ban'jiao	0
板块	ban'kuai	0
板块边界	ban'kuai'bian'jie	0
斑块分布	ban'kuai'fen'bu	0
板块构造学	ban'kuai'gou'zao'xue	0
板块会聚	ban'kuai'hui'ju	0
板块碰撞	ban'kuai'peng'zhuang	0
板内火山活动	ban'nei'huo'shan'huo'dong	0
半潜式钻井装置	ban'qian'shi'zuan'jing'zhuang'zhi	0
半日潮	ban'ri'chao	0
瓣鳃类幼体	ban'sai'lei'you'ti	0
半咸水种	ban'xian'shui'zhong	0
半远洋沉积	ban'yuan'yang'chen'ji	0
板桩	ban'zhuang	0
饱和度异常	bao'he'du'yi'chang	0
饱和潜水	bao'he'qian'shui	0
饱和深度	bao'he'shen'du	0
堡礁	bao'jiao	0
抱球虫软泥	bao'qiu'chong'ruan'ni	0
暴涛	bao'tao	0
暴涌	bao'yong	0
北冰洋	bei'bing'yang	0
倍潮	bei'chao	0
北大西洋深层水	bei'da'xi'yang'shen'ceng'shui	0
被动大陆边缘	bei'dong'da'lu'bian'yuan	0
北方两洋分布	bei'fang'liang'yang'fen'bu	0
北极水	bei'ji'shui	0
贝类学	bei'lei'xue	0
北美洲板块	bei'mei'zhou'ban'kuai	0
贝尼奥夫带	bei'ni'ao'fu'dai	0
北太浮游生物网	bei'tai'fu'you'sheng'wu'wang	0
崩碎波	beng'sui'bo	0
比碱度	bi'jian'du	0
比容偏差	bi'rong'pian'cha	0
变温动物	bian'wen'dong'wu	0
边缘波	bian'yuan'bo	0
边缘海	bian'yuan'hai	0
边缘盆地	bian'yuan'pen'di	0
表层流	biao'ceng'liu	0
表层取样器	biao'ceng'qu'yang'qi	0
表层水	biao'ceng'shui	0
表观耗氧量	biao'guan'hao'yang'liang	0
标记	biao'ji	0
标志	biao'zhi	0
标准海水	biao'zhun'hai'shui	0
滨外坝	bin'wai'ba	0
冰川效应	bing'chuan'xiao'ying	0
冰盖	bing'gai	0
冰厚	bing'hou	0
冰架	bing'jia	0
冰间水道	bing'jian'shui'dao	0
冰壳	bing'ke	0
冰期	bing'qi	0
冰山	bing'shan	0
冰原	bing'yuan	0
冰缘线	bing'yuan'xian	0
波陡	bo'dou	0
波锋线	bo'feng'xian	0
波高	bo'gao	0
渤海	bo'hai	0
渤海沿岸流	bo'hai'yan'an'liu	0
波候	bo'hou	0
波级	bo'ji	0
波控三角洲	bo'kong'san'jiao'zhou	0
波浪反射	bo'lang'fan'she	0
波浪荷载	bo'lang'he'zai	0
波浪能	bo'lang'neng	0
波浪爬高	bo'lang'pa'gao	0
波浪散射	bo'lang'san'she	0
波浪水槽	bo'lang'shui'cao	0
波浪水池	bo'lang'shui'chi	0
波浪推算	bo'lang'tui'suan	0
波浪衍射	bo'lang'yan'she	0
波浪预报	bo'lang'yu'bao	0
波浪折射	bo'lang'zhe'she	0
波龄	bo'ling	0
波流	bo'liu	0
波能谱	bo'neng'pu	0
波剖面	bo'pou'mian	0
波群	bo'qun	0
泊位	bo'wei	0
波纹	bo'wen	0
波周期	bo'zhou'qi	0
补偿流	bu'chang'liu	0
补偿深度	bu'chang'shen'du	0
补充群体	bu'chong'qun'ti	0
补充型捕捞过度	bu'chong'xing'bu'lao'guo'du	0
不规则波	bu'gui'ze'bo	0
捕捞过度	bu'lao'guo'du	0
捕捞能力	bu'lao'neng'li	0
捕捞强度	bu'lao'qiang'du	0
捕食	bu'shi	0
捕食者	bu'shi'zhe	0
不育分布	bu'yu'fen'bu	0
参比物质	can'bi'wu'zhi	0
参比元素	can'bi'yuan'su	0
残留沉积	can'liu'chen'ji	0
测波杆	ce'bo'gan	0
测波仪	ce'bo'yi	0
侧反射	ce'fan'she	0
侧扫声呐	ce'sao'sheng'na	0
测深仪	ce'shen'yi	0
层化海洋	ceng'hua'hai'yang	0
叉臂系泊系统	cha'bi'ji'bo'xi'tong	0
产卵洄游	chan'luan'hui'you	0
长峰波	chang'feng'bo	0
常规潜水	chang'gui'qian'shui	0
长江冲淡水	chang'jiang'chong'dan'shui	0
长狂涌	chang'kuang'yong	0
长轻涌	chang'qing'yong	0
长腕幼体	chang'wan'you'ti	0
长中涌	chang'zhong'yong	0
潮波	chao'bo	0
潮差	chao'cha	0
潮感电磁场	chao'gan'dian'ci'chang	0
潮沟	chao'gou	0
潮混合	chao'hun'he	0
潮间带	chao'jian'dai	0
潮控三角洲	chao'kong'san'jiao'zhou	0
潮龄	chao'ling	0
潮流	chao'liu	0
潮流椭圆	chao'liu'tuo'yuan	0
潮能	chao'neng	0
潮上带	chao'shang'dai	0
超深渊带	chao'shen'yuan'dai	0
超深渊动物	chao'shen'yuan'dong'wu	0
潮升	chao'sheng	0
潮滩	chao'tan	0
潮位	chao'wei	0
潮位曲线	chao'wei'qu'xian	0
超微型浮游生物	chao'wei'xing'fu'you'sheng'wu	0
潮汐	chao'xi	0
潮汐表	chao'xi'biao	0
潮汐汊道	chao'xi'cha'dao	0
潮汐非调和常数	chao'xi'fei'tiao'he'chang'shu	0
潮汐基准面	chao'xi'ji'zhun'mian	0
潮汐能	chao'xi'neng	0
潮汐能发电	chao'xi'neng'fa'dian	0
潮汐调和常数	chao'xi'tiao'he'chang'shu	0
潮汐调和分析	chao'xi'tiao'he'fen'xi	0
潮汐通道	chao'xi'tong'dao	0
潮下带	chao'xia'dai	0
潮余流	chao'yu'liu	0
沉积动力学	chen'ji'dong'li'xue	0
沉积腐殖质	chen'ji'fu'zhi'zhi	0
沉积生物	chen'ji'sheng'wu	0
沉积速率	chen'ji'su'lv	0
沉积物捕集器	chen'ji'wu'bu'ji'qi	0
沉积物界面	chen'ji'wu'jie'mian	0
沉积物通量	chen'ji'wu'tong'liang	0
沉积作用	chen'ji'zuo'yong	0
沉井	chen'jing	0
沉箱	chen'xiang	0
赤潮	chi'chao	0
赤道辐合带	chi'dao'fu'he'dai	0
赤道流	chi'dao'liu	0
赤道逆流	chi'dao'ni'liu	0
赤道潜流	chi'dao'qian'liu	0
重叠冰	chong'die'bing	0
充分成长风浪	chong'fen'cheng'zhang'feng'lang	0
虫黄藻	chong'huang'zao	0
冲击波	chong'ji'bo	0
冲刷带	chong'shua'dai	0
重现期	chong'xian'qi	0
初级生产力	chu'ji'sheng'chan'li	0
初级生产量	chu'ji'sheng'chan'liang	0
船舶调头区	chuan'bo'diao'tou'qu	0
传播异常	chuan'bo'yi'chang	0
船行波	chuan'hang'bo	0
船上测定	chuan'shang'ce'ding	0
船坞	chuan'wu	0
船用分光光度计	chuan'yong'fen'guang'guang'du'ji	0
船闸	chuan'zha	0
垂荡	chui'dang	0
垂向稳定度	chui'xiang'wen'ding'du	0
垂直分布	chui'zhi'fen'bu	0
次表层流	ci'biao'ceng'liu	0
次表层水	ci'biao'ceng'shui	0
磁场平静带	ci'chang'ping'jing'dai	0
次级生产力	ci'ji'sheng'chan'li	0
次级生产量	ci'ji'sheng'chan'liang	0
次级种群	ci'ji'zhong'qun	0
磁条带	ci'tiao'dai	0
磁蟹幼体	ci'xie'you'ti	0
存活率	cun'huo'lv	0
大波平均	da'bo'ping'jun	0
大潮	da'chao	0
达尔马提亚岸线	da'er'ma'ti'ya'an'xian	0
大浪	da'lang	0
大陆边缘	da'lu'bian'yuan	0
大陆架	da'lu'jia	0
大陆架坡折	da'lu'jia'po'zhe	0
大陆阶地	da'lu'jie'di	0
大陆隆	da'lu'long	0
大陆漂移	da'lu'piao'yi	0
大陆坡	da'lu'po	0
大陆增生	da'lu'zeng'sheng	0
大气海盐	da'qi'hai'yan	0
大气输入	da'qi'shu'ru	0
大气输送	da'qi'shu'song	0
大西洋	da'xi'yang	0
大西洋赤道潜流	da'xi'yang'chi'dao'qian'liu	0
大西洋型岸线	da'xi'yang'xing'an'xian	0
大西洋型大陆边缘	da'xi'yang'xing'da'lu'bian'yuan	0
大西洋中脊	da'xi'yang'zhong'ji	0
大型底栖生物	da'xing'di'qi'sheng'wu	0
大型动物	da'xing'dong'wu	0
大型浮游生物	da'xing'fu'you'sheng'wu	0
大眼幼体	da'yan'you'ti	0
大洋板块	da'yang'ban'kuai	0
大洋对流层	da'yang'dui'liu'ceng	0
大洋化作用	da'yang'hua'zuo'yong	0
大洋环流	da'yang'huan'liu	0
大洋拉斑玄武岩	da'yang'la'ban'xuan'wu'yan	0
大洋区	da'yang'qu	0
大洋上层生物	da'yang'shang'ceng'sheng'wu	0
大洋深层生物	da'yang'shen'ceng'sheng'wu	0
大洋深渊水层生物	da'yang'shen'yuan'shui'ceng'sheng'wu	0
大洋生物	da'yang'sheng'wu	0
大洋中层生物	da'yang'zhong'ceng'sheng'wu	0
打桩船	da'zhuang'chuan	0
代表种	dai'biao'zhong	0
单点系泊	dan'dian'ji'bo	0
氮磷比	dan'lin'bi	0
担轮幼体	dan'lun'you'ti	0
单锚腿	dan'mao'tui	0
单食性	dan'shi'xing	0
淡水舌	dan'shui'she	0
氮循环	dan'xun'huan	0
单周期	dan'zhou'qi	0
挡潮堤	dang'chao'di	0
挡潮闸	dang'chao'zha	0
导堤	dao'di	0
导管架桩基平台	dao'guan'jia'zhuang'ji'ping'tai	0
导航设备	dao'hang'she'bei	0
岛弧	dao'hu	0
岛架	dao'jia	0
岛坡	dao'po	0
岛式防波堤	dao'shi'fang'bo'di	0
岛式码头	dao'shi'ma'tou	0
灯船	deng'chuan	0
等深流	deng'shen'liu	0
等深流沉积	deng'shen'liu'chen'ji	0
灯塔	deng'ta	0
等温线	deng'wen'xian	0
等效风区	deng'xiao'feng'qu	0
等效风时	deng'xiao'feng'shi	0
等盐线	deng'yan'xian	0
底表动物	di'biao'dong'wu	0
底表撬网	di'biao'qiao'wang	0
底波	di'bo	0
底层流	di'ceng'liu	0
底层水	di'ceng'shui	0
底层鱼类	di'ceng'yu'lei	0
低潮	di'chao	0
地方种	di'fang'zhong	0
地方种群	di'fang'zhong'qun	0
地缝合线	di'feng'he'xian	0
地基承载能力	di'ji'cheng'zai'neng'li	0
地理障碍	di'li'zhang'ai	0
地幔对流	di'man'dui'liu	0
地幔隆起	di'man'long'qi	0
地幔柱	di'man'zhu	0
底摩擦层	di'mo'ca'ceng	0
底内动物	di'nei'dong'wu	0
低平海岸	di'ping'hai'an	0
底栖动物	di'qi'dong'wu	0
底栖生物	di'qi'sheng'wu	0
底栖生物刮底网	di'qi'sheng'wu'gua'di'wang	0
底栖生物群落	di'qi'sheng'wu'qun'luo	0
底栖生物拖网	di'qi'sheng'wu'tuo'wang	0
底栖生物学	di'qi'sheng'wu'xue	0
低狭盐种	di'xia'yan'zhong	0
地质海洋学	di'zhi'hai'yang'xue	0
地转流	di'zhuan'liu	0
电磁海流计	dian'ci'hai'liu'ji	0
电磁振荡震源	dian'ci'zhen'dang'zhen'yuan	0
颠倒采水器	dian'dao'cai'shui'qi	0
颠倒温度表	dian'dao'wen'du'biao	0
电火花震源	dian'huo'hua'zhen'yuan	0
点礁	dian'jiao	0
电渗析	dian'shen'xi	0
调查船	diao'cha'chuan	0
碟状幼体	die'zhuang'you'ti	0
丁坝	ding'ba	0
定点观测站	ding'dian'guan'ce'zhan	0
东非裂谷带	dong'fei'lie'gu'dai	0
东海	dong'hai	0
东海沿岸流	dong'hai'yan'an'liu	0
东经	dong'jing	0
动力定位	dong'li'ding'wei	0
动力方法	dong'li'fang'fa	0
动力海洋学	dong'li'hai'yang'xue	0
东太平洋海隆	dong'tai'ping'yang'hai'long	0
度洋中脊	du'yang'zhong'ji	0
断层海岸	duan'ceng'hai'an	0
短峰波	duan'feng'bo	0
短狂涌	duan'kuang'yong	0
断面观测	duan'mian'guan'ce	0
短轻涌	duan'qing'yong	0
短中涌	duan'zhong'yong	0
堆积冰	dui'ji'bing	0
堆积作用	dui'ji'zuo'yong	0
对流混合	dui'liu'hun'he	0
对马海流	dui'ma'hai'liu	0
多波束测深仪	duo'bo'shu'ce'shen'yi	0
多点系泊	duo'dian'ji'bo	0
多级分离器	duo'ji'fen'li'qi	0
多级闪急蒸馏	duo'ji'shan'ji'zheng'liu	0
多金属结壳	duo'jin'shu'jie'ke	0
多瓶采水器	duo'ping'cai'shui'qi	0
多普勒海流计	duo'pu'le'hai'liu'ji	0
多态现象	duo'tai'xian'xiang	0
多样性	duo'yang'xing	0
多种型大洋	duo'zhong'xing'da'yang	0
厄尔尼诺	e'er'ni'nuo	0
厄特沃什效应	e'te'wo'shi'xiao'ying	0
饵料生物	er'liao'sheng'wu	0
耳状幼体	er'zhuang'you'ti	0
发光生物	fa'guang'sheng'wu	0
发光细菌	fa'guang'xi'jun	0
泛大陆	fan'da'lu	0
泛大洋	fan'da'yang	0
反射波	fan'she'bo	0
反渗透	fan'shen'tou	0
防波堤	fang'bo'di	0
方解石补偿深度	fang'jie'shi'bu'chang'shen'du	0
方解石溶解指数	fang'jie'shi'rong'jie'zhi'shu	0
放射虫软泥	fang'she'chong'ruan'ni	0
仿生学	fang'sheng'xue	0
方位改正	fang'wei'gai'zheng	0
防污着	fang'wu'zhe	0
方向波谱	fang'xiang'bo'pu	0
非饱和潜水	fei'bao'he'qian'shui	0
肥力	fei'li	0
非生物性悬浮物	fei'sheng'wu'xing'xuan'fu'wu	0
非生物转移	fei'sheng'wu'zhuan'yi	0
非造礁珊瑚	fei'zao'jiao'shan'hu	0
非洲板块	fei'zhou'ban'kuai	0
分潮	fen'chao	0
分潮日	fen'chao'ri	0
分潮时	fen'chao'shi	0
分点潮	fen'dian'chao	0
粪粒	fen'li	0
粉砂	fen'sha	0
风暴潮	feng'bao'chao	0
风暴沉积	feng'bao'chen'ji	0
丰度	feng'du	0
风海流	feng'hai'liu	0
风浪	feng'lang	0
风浪玫瑰图	feng'lang'mei'gui'tu	0
风浪谱	feng'lang'pu	0
风区	feng'qu	0
风生噪声	feng'sheng'zao'sheng	0
风时	feng'shi	0
风因子	feng'yin'zi	0
副标准海水	fu'biao'zhun'hai'shui	0
浮冰	fu'bing	0
浮冰群	fu'bing'qun	0
俯冲板块	fu'chong'ban'kuai	0
俯冲带	fu'chong'dai	0
敷管船	fu'guan'chuan	0
复合滨线	fu'he'bin'xian	0
复合潮	fu'he'chao	0
孵化	fu'hua	0
孵化率	fu'hua'lv	0
俘获波	fu'huo'bo	0
浮浪幼体	fu'lang'you'ti	0
浮力沉垫	fu'li'chen'dian	0
副轮	fu'lun	0
副热带模态水	fu're'dai'mo'tai'shui	0
辐射潮	fu'she'chao	0
腐生浮游生物	fu'sheng'fu'you'sheng'wu	0
附生植物	fu'sheng'zhi'wu	0
浮式防波堤	fu'shi'fang'bo'di	0
浮式结构	fu'shi'jie'gou	0
浮式码头	fu'shi'ma'tou	0
浮式软管	fu'shi'ruan'guan	0
复食性	fu'shi'xing	0
浮性卵	fu'xing'luan	0
浮性生活期	fu'xing'sheng'huo'qi	0
富营养化	fu'ying'yang'hua	0
富营养水	fu'ying'yang'shui	0
浮游动物	fu'you'dong'wu	0
浮游生物	fu'you'sheng'wu	0
浮游生物泵	fu'you'sheng'wu'beng	0
浮游生物当量	fu'you'sheng'wu'dang'liang	0
浮游生物记录器	fu'you'sheng'wu'ji'lu'qi	0
浮游生物网	fu'you'sheng'wu'wang	0
浮游生物学	fu'you'sheng'wu'xue	0
浮游生物指示器	fu'you'sheng'wu'zhi'shi'qi	0
浮游细菌	fu'you'xi'jun	0
浮游植物	fu'you'zhi'wu	0
腐殖化	fu'zhi'hua	0
盖奥特	gai'ao'te	0
钙质软泥	gai'zhi'ruan'ni	0
干扰加速度	gan'rao'jia'su'du	0
干式潜水	gan'shi'qian'shui	0
港池	gang'chi	0
港口腹地	gang'kou'fu'di	0
港口工程	gang'kou'gong'cheng	0
港口陆域	gang'kou'lu'yu	0
港口设施	gang'kou'she'shi	0
港口淤积	gang'kou'yu'ji	0
冈瓦纳古陆	gang'wa'na'gu'lu	0
港湾海岸	gang'wan'hai'an	0
港址	gang'zhi	0
港作船	gang'zuo'chuan	0
高潮	gao'chao	0
高狭盐种	gao'xia'yan'zhong	0
隔水套管	ge'shui'tao'guan	0
个体生态学	ge'ti'sheng'tai'xue	0
共栖	gong'qi	0
共生	gong'sheng	0
沟弧盆系	gou'hu'pen'xi	0
古地磁地层学	gu'di'ci'di'ceng'xue	0
古地中海	gu'di'zhong'hai	0
固定冰	gu'ding'bing	0
固定式结构	gu'ding'shi'jie'gou	0
古海流	gu'hai'liu	0
古海洋学	gu'hai'yang'xue	0
孤立波	gu'li'bo	0
古深度	gu'shen'du	0
古生产力	gu'sheng'chan'li	0
古温度	gu'wen'du	0
古盐度	gu'yan'du	0
固着生物	gu'zhuo'sheng'wu	0
寡盐种	gua'yan'zhong	0
观测平台	guan'ce'ping'tai	0
管汇系统	guan'hui'xi'tong	0
关键种	guan'jian'zhong	0
管结点	guan'jie'dian	0
管栖动物	guan'qi'dong'wu	0
管柱	guan'zhu	0
管状构件	guan'zhuang'gou'jian	0
光饱和	guang'bao'he	0
广布	guang'bu	0
光合活性	guang'he'huo'xing	0
光化学转化	guang'hua'xue'zhuan'hua	0
光能自养生物	guang'neng'zi'yang'sheng'wu	0
广深性生物	guang'shen'xing'sheng'wu	0
光适性	guang'shi'xing	0
广食性动物	guang'shi'xing'dong'wu	0
广温种	guang'wen'zhong	0
光驯化	guang'xun'hua	0
广压性生物	guang'ya'xing'sheng'wu	0
广盐种	guang'yan'zhong	0
硅藻软泥	gui'zao'ruan'ni	0
规则波	gui'ze'bo	0
硅质软泥	gui'zhi'ruan'ni	0
哈迪浮游生物记录器	ha'di'fu'you'sheng'wu'ji'lu'qi	0
哈浮游生物记录器	ha'fu'you'sheng'wu'ji'lu'qi	0
海岸	hai'an	0
海岸带	hai'an'dai	0
海岸工程	hai'an'gong'cheng	0
海岸阶地	hai'an'jie'di	0
海岸沙丘	hai'an'sha'qiu	0
海岸线	hai'an'xian	0
海岸效应	hai'an'xiao'ying	0
海冰	hai'bing	0
海冰密集度	hai'bing'mi'ji'du	0
海冰盐度	hai'bing'yan'du	0
海槽	hai'cao	0
海产养殖	hai'chan'yang'zhi	0
海产栽培	hai'chan'zai'pei	0
海胆幼体	hai'dan'you'ti	0
海堤	hai'di	0
海底	hai'di	0
海底采矿	hai'di'cai'kuang	0
海底地层剖面仪	hai'di'de'ceng'pou'mian'yi	0
海底地震仪	hai'di'di'zhen'yi	0
海底电缆	hai'di'dian'lan	0
海底高原	hai'di'gao'yuan	0
海底构造学	hai'di'gou'zao'xue	0
海底谷	hai'di'gu	0
海底管道	hai'di'guan'dao	0
海底混响	hai'di'hun'xiang	0
海底扩张	hai'di'kuo'zhang	0
海底区	hai'di'qu	0
海底热泉	hai'di're'quan	0
海底热液	hai'di're'ye	0
海底散射	hai'di'san'she	0
海底声反射	hai'di'sheng'fan'she	0
海底隧道	hai'di'sui'dao	0
海底完井	hai'di'wan'jing	0
海底峡谷	hai'di'xia'gu	0
海沟	hai'gou	0
海解作用	hai'jie'zuo'yong	0
海槛	hai'kan	0
海浪	hai'lang	0
海浪谱	hai'lang'pu	0
海流	hai'liu	0
海流计	hai'liu'ji	0
海流能	hai'liu'neng	0
海龙卷	hai'long'juan	0
海陆风	hai'lu'feng	0
海面带斑	hai'mian'dai'ban	0
海面混响	hai'mian'hun'xiang	0
海面散射	hai'mian'san'she	0
海面水温	hai'mian'shui'wen	0
海难救助	hai'nan'jiu'zhu	0
海平面	hai'ping'mian	0
海平面变化	hai'ping'mian'bian'hua	0
海气热交换	hai'qi're'jiao'huan	0
海侵	hai'qin	0
海色扫描仪	hai'se'sao'miao'yi	0
海色指数	hai'se'zhi'shu	0
海山	hai'shan	0
海上安装沉放	hai'shang'an'zhuang'chen'fang	0
海上输油气管线	hai'shang'shu'you'qi'guan'xian	0
海上拖运	hai'shang'tuo'yun	0
海上油气开发工程	hai'shang'you'qi'kai'fa'gong'cheng	0
海上油气勘探	hai'shang'you'qi'kan'tan	0
海上贮油装置	hai'shang'zhu'you'zhuang'zhi	0
海上装卸油系统	hai'shang'zhuang'xie'you'xi'tong	0
海蚀洞	hai'shi'dong	0
海蚀龛	hai'shi'kan	0
海蚀台地	hai'shi'tai'di	0
海蚀崖	hai'shi'ya	0
海蚀柱	hai'shi'zhu	0
海蚀作用	hai'shi'zuo'yong	0
海水	hai'shui	0
海水保守成分	hai'shui'bao'shou'cheng'fen	0
海水成分恒定性	hai'shui'cheng'fen'heng'ding'xing	0
海水磁导率	hai'shui'ci'dao'lv	0
海水淡化	hai'shui'dan'hua	0
海水电导率	hai'shui'dian'dao'lv	0
海水二氧化碳系统	hai'shui'er'yang'hua'tan'xi'tong	0
海水非保守成分	hai'shui'fei'bao'shou'cheng'fen	0
海水分析化学	hai'shui'fen'xi'hua'xue	0
海水腐蚀	hai'shui'fu'shi	0
海水腐殖质	hai'shui'fu'zhi'zhi	0
海水光散射仪	hai'shui'guang'san'she'yi	0
海水化学	hai'shui'hua'xue	0
海水颗粒物	hai'shui'ke'li'wu	0
海水离子缔合模型	hai'shui'li'zi'di'he'mo'xing	0
海水离子迁移率	hai'shui'li'zi'qian'yi'lv	0
海水密度	hai'shui'mi'du	0
海水水质标准	hai'shui'shui'zhi'biao'zhun	0
海水碳酸盐系统	hai'shui'tan'suan'yan'xi'tong	0
海水透明度	hai'shui'tou'ming'du	0
海水透明度盘	hai'shui'tou'ming'du'pan	0
海水透射率仪	hai'shui'tou'she'lv'yi	0
海水微量元素	hai'shui'wei'liang'yuan'su	0
海水污染物背景值	hai'shui'wu'ran'wu'bei'jing'zhi	0
海水雪花	hai'shui'xue'hua	0
海水营养盐	hai'shui'ying'yang'yan	0
海水主要成分	hai'shui'zhu'yao'cheng'fen	0
海水状态方程	hai'shui'zhuang'tai'fang'cheng	0
海水自净作用	hai'shui'zi'jing'zuo'yong	0
海损事故	hai'sun'shi'gu	0
海滩	hai'tan	0
海滩剖面	hai'tan'pou'mian	0
海滩旋回	hai'tan'xuan'hui	0
海滩岩	hai'tan'yan	0
海塘	hai'tang	0
海图基准面	hai'tu'ji'zhun'mian	0
海退	hai'tui	0
海湾	hai'wan	0
海雾	hai'wu	0
海峡	hai'xia	0
海啸	hai'xiao	0
海崖	hai'ya	0
海盐	hai'yan	0
海洋沉积学	hai'yang'chen'ji'xue	0
海洋磁力梯度仪	hai'yang'ci'li'ti'du'yi	0
海洋磁力仪	hai'yang'ci'li'yi	0
海洋地层学	hai'yang'di'ceng'xue	0
海洋地磁调查	hai'yang'di'ci'diao'cha	0
海洋地磁异常	hai'yang'di'ci'yi'chang	0
海洋地貌学	hai'yang'di'mao'xue	0
海洋地球化学	hai'yang'di'qiu'hua'xue	0
海洋地球物理调查	hai'yang'di'qiu'wu'li'diao'cha	0
海洋地球物理学	hai'yang'di'qiu'wu'li'xue	0
海洋地热流调查	hai'yang'di're'liu'diao'cha	0
海洋地震调查	hai'yang'di'zhen'diao'cha	0
海洋地震漂浮电缆	hai'yang'di'zhen'piao'fu'dian'lan	0
海洋地震剖面仪	hai'yang'di'zhen'pou'mian'yi	0
海洋地震仪	hai'yang'di'zhen'yi	0
海洋地质学	hai'yang'di'zhi'xue	0
海洋玷污	hai'yang'dian'wu	0
海洋调查	hai'yang'diao'cha	0
海洋法	hai'yang'fa	0
海洋反射地震调查	hai'yang'fan'she'di'zhen'diao'cha	0
海洋反照率	hai'yang'fan'zhao'lv	0
海洋锋	hai'yang'feng	0
海洋辐射传递	hai'yang'fu'she'chuan'di	0
海洋腐蚀	hai'yang'fu'shi	0
海洋腐殖质	hai'yang'fu'zhi'zhi	0
海洋高能环境	hai'yang'gao'neng'huan'jing	0
海洋工程	hai'yang'gong'cheng	0
海洋工程地质	hai'yang'gong'cheng'di'zhi	0
海洋工程水文	hai'yang'gong'cheng'shui'wen	0
海洋观测技术	hai'yang'guan'ce'ji'shu	0
海洋管理	hai'yang'guan'li	0
海洋光化学	hai'yang'guang'hua'xue	0
海洋光学	hai'yang'guang'xue	0
海洋光学遥感	hai'yang'guang'xue'yao'gan	0
海洋化学	hai'yang'hua'xue	0
海洋化学资源	hai'yang'hua'xue'zi'yuan	0
海洋环境	hai'yang'huan'jing	0
海洋环境保护	hai'yang'huan'jing'bao'hu	0
海洋环境化学	hai'yang'huan'jing'hua'xue	0
海洋环境监测	hai'yang'huan'jing'jian'ce	0
海洋环境科学	hai'yang'huan'jing'ke'xue	0
海洋环境评价	hai'yang'huan'jing'ping'jia	0
海洋环境容量	hai'yang'huan'jing'rong'liang	0
海洋环境预报	hai'yang'huan'jing'yu'bao	0
海洋环境噪声	hai'yang'huan'jing'zao'sheng	0
海洋环境质量	hai'yang'huan'jing'zhi'liang	0
海洋技术	hai'yang'ji'shu	0
海洋开发	hai'yang'kai'fa	0
海洋科学	hai'yang'ke'xue	0
海洋能发电	hai'yang'neng'fa'dian	0
海洋能源	hai'yang'neng'yuan	0
海洋能转换	hai'yang'neng'zhuan'huan	0
海洋农牧化	hai'yang'nong'mu'hua	0
海洋气候	hai'yang'qi'hou	0
海洋气候学	hai'yang'qi'hou'xue	0
海洋气溶胶	hai'yang'qi'rong'jiao	0
海洋气团	hai'yang'qi'tuan	0
海洋气象学	hai'yang'qi'xiang'xue	0
海洋生化资源	hai'yang'sheng'hua'zi'yuan	0
海洋声散射体	hai'yang'sheng'san'she'ti	0
海洋生态系	hai'yang'sheng'tai'xi	0
海洋生态学	hai'yang'sheng'tai'xue	0
海洋生物地球化学	hai'yang'sheng'wu'di'qiu'hua'xue	0
海洋生物化学	hai'yang'sheng'wu'hua'xue	0
海洋生物声学	hai'yang'sheng'wu'sheng'xue	0
海洋生物学	hai'yang'sheng'wu'xue	0
海洋生物噪声	hai'yang'sheng'wu'zao'sheng	0
海洋声学	hai'yang'sheng'xue	0
海洋生药学	hai'yang'sheng'yao'xue	0
海洋水文学	hai'yang'shui'wen'xue	0
海洋碎屑	hai'yang'sui'xie	0
海洋天然产物	hai'yang'tian'ran'chan'wu	0
海洋天然产物化学	hai'yang'tian'ran'chan'wu'hua'xue	0
海洋天然烃	hai'yang'tian'ran'ting	0
海洋同位素化学	hai'yang'tong'wei'su'hua'xue	0
海洋湍流	hai'yang'tuan'liu	0
海洋微表层	hai'yang'wei'biao'ceng	0
海洋微生物	hai'yang'wei'sheng'wu	0
海洋温差能	hai'yang'wen'cha'neng	0
海洋物理化学	hai'yang'wu'li'hua'xue	0
海洋物理学	hai'yang'wu'li'xue	0
海洋污染	hai'yang'wu'ran	0
海洋污染物	hai'yang'wu'ran'wu	0
海洋学	hai'yang'xue	0
海洋压力水听器	hai'yang'ya'li'shui'ting'qi	0
海洋盐差能	hai'yang'yan'cha'neng	0
海洋有机地球化学	hai'yang'you'ji'di'qiu'hua'xue	0
海洋有机化学	hai'yang'you'ji'hua'xue	0
海洋元素地球化学	hai'yang'yuan'su'di'qiu'hua'xue	0
海洋噪声	hai'yang'zao'sheng	0
海洋折射地震调查	hai'yang'zhe'she'di'zhen'diao'cha	0
海洋政策	hai'yang'zheng'ce	0
海洋重力调查	hai'yang'zhong'li'diao'cha	0
海洋重力仪	hai'yang'zhong'li'yi	0
海洋重力异常	hai'yang'zhong'li'yi'chang	0
海洋资源	hai'yang'zi'yuan	0
海洋资源化学	hai'yang'zi'yuan'hua'xue	0
寒流	han'liu	0
航道	hang'dao	0
航空遥感观测	hang'kong'yao'gan'guan'ce	0
耗竭	hao'jie	0
河界面	he'jie'mian	0
河控三角洲	he'kong'san'jiao'zhou	0
河口	he'kou	0
河口化学	he'kou'hua'xue	0
河口湾	he'kou'wan	0
河口治理	he'kou'zhi'li	0
褐粘土	he'nian'tu	0
河源物质	he'yuan'wu'zhi	0
黑白瓶法	hei'bai'ping'fa	0
黑潮	hei'chao	0
横荡	heng'dang	0
恒化培养	heng'hua'pei'yang	0
桁拖网	heng'tuo'wang	0
横摇	heng'yao	0
红粘土	hong'nian'tu	0
红树林海岸	hong'shu'lin'hai'an	0
红树林沼泽	hong'shu'lin'zhao'ze	0
后滨	hou'bin	0
护岸工程	hu'an'gong'cheng	0
弧后	hu'hou	0
弧后扩张	hu'hou'kuo'zhang	0
弧后盆地	hu'hou'pen'di	0
护面块体	hu'mian'kuai'ti	0
护坡	hu'po	0
弧前	hu'qian	0
弧前盆地	hu'qian'pen'di	0
滑道	hua'dao	0
化能营养	hua'neng'ying'yang	0
化能自养生物	hua'neng'zi'yang'sheng'wu	0
化学成岩作用	hua'xue'cheng'yan'zuo'yong	0
化学风化作用	hua'xue'feng'hua'zuo'yong	0
化学海洋学	hua'xue'hai'yang'xue	0
化学清除	hua'xue'qing'chu	0
化学形式	hua'xue'xing'shi	0
化学形态	hua'xue'xing'tai	0
化学形态分析	hua'xue'xing'tai'fen'xi	0
化学形态模型	hua'xue'xing'tai'mo'xing	0
化学需氧量	hua'xue'xu'yang'liang	0
怀卵量	huai'luan'liang	0
环礁	huan'jiao	0
环境荷载	huan'jing'he'zai	0
环太平洋火山带	huan'tai'ping'yang'huo'shan'dai	0
黄海	huang'hai	0
黄海冷水团	huang'hai'leng'shui'tuan	0
黄海暖流	huang'hai'nuan'liu	0
黄海沿岸流	huang'hai'yan'an'liu	0
黄色物质	huang'se'wu'zhi	0
回步	hui'bu	0
挥发性有机碳	hui'fa'xing'you'ji'tan	0
挥发性有机物	hui'fa'xing'you'ji'wu	0
回归潮	hui'gui'chao	0
会聚边界	hui'ju'bian'jie	0
回声测距	hui'sheng'ce'ju	0
洄游鱼类	hui'you'yu'lei	0
混合	hun'he	0
混合层	hun'he'ceng	0
混合层声道	hun'he'ceng'sheng'dao	0
混合潮	hun'he'chao	0
混合式防波堤	hun'he'shi'fang'bo'di	0
混合营养生物	hun'he'ying'yang'sheng'wu	0
火炬臂	huo'ju'bi	0
活塞取芯器	huo'sai'qu'xin'qi	0
火山沉积	huo'shan'chen'ji	0
火山弧	huo'shan'hu	0
火山链	huo'shan'lian	0
活体荧光技术	huo'ti'ying'guang'ji'shu	0
活性硅	huo'xing'gui	0
活性磷	huo'xing'lin	0
激波	ji'bo	0
系泊力	ji'bo'li	0
系泊设施	ji'bo'she'shi	0
基床	ji'chuang	0
极地冰	ji'di'bing	0
季风海流	ji'feng'hai'liu	0
机会种	ji'hui'zhong	0
季节变动	ji'jie'bian'dong	0
季节变化	ji'jie'bian'hua	0
季节性温跃层	ji'jie'xing'wen'yue'ceng	0
集聚分布	ji'ju'fen'bu	0
集群	ji'qun	0
寄生	ji'sheng	0
激碎波	ji'sui'bo	0
基线研究	ji'xian'yan'jiu	0
机械式温深计	ji'xie'shi'wen'shen'ji	0
机载红外辐射计	ji'zai'hong'wai'fu'she'ji	0
甲板装置	jia'ban'zhuang'zhi	0
假潮	jia'chao	0
岬角	jia'jiao	0
甲壳动物学	jia'qiao'dong'wu'xue	0
假想天体	jia'xiang'tian'ti	0
加压舱	jia'ya'cang	0
碱度	jian'du	0
尖角坝	jian'jiao'ba	0
建设性板块边界	jian'she'xing'ban'kuai'bian'jie	0
间隙动物	jian'xi'dong'wu	0
间隙水	jian'xi'shui	0
减压舱	jian'ya'cang	0
交叉耦合效应	jiao'cha'ou'he'xiao'ying	0
礁顶	jiao'ding	0
交混回响	jiao'hun'hui'xiang	0
礁坪	jiao'ping	0
礁前	jiao'qian	0
礁滩	jiao'tan	0
阶段性浮游生物	jie'duan'xing'fu'you'sheng'wu	0
界面交换过程	jie'mian'jiao'huan'guo'cheng	0
界面通量	jie'mian'tong'liang	0
近滨带	jin'bin'dai	0
近海	jin'hai	0
近海工程	jin'hai'gong'cheng	0
近海平台	jin'hai'ping'tai	0
近海区	jin'hai'qu	0
近海生物	jin'hai'sheng'wu	0
进积作用	jin'ji'zuo'yong	0
金星幼体	jin'xing'you'ti	0
禁渔期	jin'yu'qi	0
净初级生产力	jing'chu'ji'sheng'chan'li	0
净初级生产量	jing'chu'ji'sheng'chan'liang	0
静海环境	jing'hai'huan'jing	0
井口装置	jing'kou'zhuang'zhi	0
静止期	jing'zhi'qi	0
聚爆式震源	ju'bao'shi'zhen'yuan	0
巨浪	ju'lang	0
巨型动物	ju'xing'dong'wu	0
巨型浮游生物	ju'xing'fu'you'sheng'wu	0
具足面盘幼体	ju'zu'mian'pan'you'ti	0
卷碎波	juan'sui'bo	0
卷吸	juan'xi	0
绝对盐度	jue'dui'yan'du	0
均匀层	jun'yun'ceng	0
菌株	jun'zhu	0
开尔文波	kai'er'wen'bo	0
开阔海域	kai'kuo'hai'yu	0
铠装潜水	kai'zhuang'qian'shui	0
糠虾期幼体	kang'xia'qi'you'ti	0
靠船撞击力	kao'chuan'zhuang'ji'li	0
可捕系数	ke'bu'xi'shu	0
蝌蚪幼体	ke'dou'you'ti	0
可更新资源	ke'geng'xin'zi'yuan	0
颗粒无机碳	ke'li'wu'ji'tan	0
颗粒物界面	ke'li'wu'jie'mian	0
颗粒有机氮	ke'li'you'ji'dan	0
颗粒有机磷	ke'li'you'ji'lin	0
颗粒有机碳	ke'li'you'ji'tan	0
颗粒有机物	ke'li'you'ji'wu	0
克伦威尔海流	ke'lun'wei'er'hai'liu	0
克努森表	ke'nu'sen'biao	0
克努森滴定管	ke'nu'sen'di'ding'guan	0
克努森移液管	ke'nu'sen'yi'ye'guan	0
颗石软泥	ke'shi'ruan'ni	0
空间分布	kong'jian'fen'bu	0
孔隙度	kong'xi'du	0
孔隙水	kong'xi'shui	0
控制生态系实验	kong'zhi'sheng'tai'xi'shi'yan	0
口门	kou'men	0
狂浪	kuang'lang	0
狂涛	kuang'tao	0
拉索塔平台	la'suo'ta'ping'tai	0
浪感电磁场	lang'gan'dian'ci'chang	0
浪基面	lang'ji'mian	0
劳埃德船级社	lao'ai'de'chuan'ji'she	0
劳亚古陆	lao'ya'gu'lu	0
冷水圈	leng'shui'quan	0
冷水舌	leng'shui'she	0
冷水种	leng'shui'zhong	0
冷涡	leng'wo	0
立管	li'guan	0
理论稀释线	li'lun'xi'shi'xian	0
离散边界	li'san'bian'jie	0
里亚海岸	li'ya'hai'an	0
离子交换膜	li'zi'jiao'huan'mo	0
涟波	lian'bo	0
连岛坝	lian'dao'ba	0
连续观测	lian'xu'guan'ce	0
连续模型	lian'xu'mo'xing	0
连续培养	lian'xu'pei'yang	0
两极同源	liang'ji'tong'yuan	0
裂谷系	lie'gu'xi	0
裂流	lie'liu	0
裂流水道	lie'liu'shui'dao	0
猎物	lie'wu	0
临界深度	lin'jie'shen'du	0
磷循环	lin'xun'huan	0
领海	ling'hai	0
流冰	liu'bing	0
流环	liu'huan	0
流体动力噪声	liu'ti'dong'li'zao'sheng	0
流涡	liu'wo	0
流型	liu'xing	0
硫循环	liu'xun'huan	0
陆架波	lu'jia'bo	0
陆界面	lu'jie'mian	0
陆上预制	lu'shang'yu'zhi	0
卤水	lu'shui	0
陆源冰	lu'yuan'bing	0
陆源沉积	lu'yuan'chen'ji	0
陆源腐殖质	lu'yuan'fu'zhi'zhi	0
陆源有机物	lu'yuan'you'ji'wu	0
掠射角	lve'she'jiao	0
落潮	luo'chao	0
罗蒙诺索夫海流	luo'meng'nuo'suo'fu'hai'liu	0
罗斯贝波	luo'si'bei'bo	0
氯度	lv'du	0
氯度比值	lv'du'bi'zhi	0
氯量	lv'liang	0
滤食性动物	lv'shi'xing'dong'wu	0
码头	ma'tou	0
漫游底栖生物	man'you'di'qi'sheng'wu	0
锚冰	mao'bing	0
锚泊地	mao'bo'di	0
锚泊结构	mao'bo'jie'gou	0
毛初级生产量	mao'chu'ji'sheng'chan'liang	0
锚定资料浮标	mao'ding'zi'liao'fu'biao	0
毛细波	mao'xi'bo	0
帽状幼体	mao'zhuang'you'ti	0
锰结核	meng'jie'he	0
密度流	mi'du'liu	0
密度跃层	mi'du'yue'ceng	0
密度制约死亡率	mi'du'zhi'yue'si'wang'lv	0
面盘幼体	mian'pan'you'ti	0
描述海洋学	miao'shu'hai'yang'xue	0
鸣震	ming'zhen	0
摩擦深度	mo'ca'shen'du	0
模块	mo'kuai	0
模拟潜水	mo'ni'qian'shui	0
牡蛎礁	mu'li'jiao	0
耐冷细菌	nai'leng'xi'jun	0
南大洋	nan'da'yang	0
南方涛动	nan'fang'tao'dong	0
南海	nan'hai	0
南海暖流	nan'hai'nuan'liu	0
南海沿岸流	nan'hai'yan'an'liu	0
南极底层水	nan'ji'di'ceng'shui	0
南极海隆	nan'ji'hai'long	0
南极绕极流	nan'ji'rao'ji'liu	0
南极绕极水团	nan'ji'rao'ji'shui'tuan	0
南极洲板块	nan'ji'zhou'ban'kuai	0
南美洲板块	nan'mei'zhou'ban'kuai	0
内滨	nei'bin	0
内波	nei'bo	0
内潮	nei'chao	0
能流	neng'liu	0
逆流	ni'liu	0
泥面生物	ni'mian'sheng'wu	0
泥内生物	ni'nei'sheng'wu	0
尼斯金采水器	ni'si'jin'cai'shui'qi	0
逆置层	ni'zhi'ceng	0
泥质海岸	ni'zhi'hai'an	0
年代地层学	nian'dai'di'ceng'xue	0
年龄组成	nian'ling'zu'cheng	0
粘土	nian'tu	0
粘性卵	nian'xing'luan	0
鸟足	niao'zu	0
怒涛	nu'tao	0
暖流	nuan'liu	0
暖水圈	nuan'shui'quan	0
暖水舌	nuan'shui'she	0
暖水种	nuan'shui'zhong	0
暖涡	nuan'wo	0
偶然性浮游生物	ou'ran'xing'fu'you'sheng'wu	0
欧亚板块	ou'ya'ban'kuai	0
庞加莱波	pang'jia'lai'bo	0
硼酸	peng'suan	0
碰撞带	peng'zhuang'dai	0
疲劳断裂	pi'lao'duan'lie	0
偏利共生	pian'li'gong'sheng	0
漂浮生物	piao'fu'sheng'wu	0
漂流	piao'liu	0
漂流浮标	piao'liu'fu'biao	0
漂游细菌	piao'you'xi'jun	0
品系	pin'xi	0
贫营养水	pin'ying'yang'shui	0
平潮	ping'chao	0
平底生物群落	ping'di'sheng'wu'qun'luo	0
平顶海山	ping'ding'hai'shan	0
平衡潮	ping'heng'chao	0
平衡剖面	ping'heng'pou'mian	0
平均海平面	ping'jun'hai'ping'mian	0
平面分布	ping'mian'fen'bu	0
平整冰	ping'zheng'bing	0
坡度流	po'du'liu	0
破坏概率	po'huai'gai'lv	0
破坏性板块边界	po'huai'xing'ban'kuai'bian'jie	0
破裂带	po'lie'dai	0
气爆震源	qi'bao'zhen'yuan	0
气边界过程	qi'bian'jie'guo'cheng	0
气界面	qi'jie'mian	0
气举	qi'ju	0
气密	qi'mi	0
气泡效应	qi'pao'xiao'ying	0
气枪	qi'qiang	0
栖息地	qi'xi'di	0
气象潮	qi'xiang'chao	0
气相互作用	qi'xiang'hu'zuo'yong	0
气源物质	qi'yuan'wu'zhi	0
起重船	qi'zhong'chuan	0
潜标	qian'biao	0
前滨	qian'bin	0
潜堤	qian'di	0
浅海沉积	qian'hai'chen'ji	0
浅海传播	qian'hai'chuan'bo	0
浅海带	qian'hai'dai	0
浅海动物	qian'hai'dong'wu	0
浅海声道	qian'hai'sheng'dao	0
前进波	qian'jin'bo	0
潜流	qian'liu	0
潜水病	qian'shui'bing	0
浅水波	qian'shui'bo	0
潜水服	qian'shui'fu	0
潜水器	qian'shui'qi	0
浅水系数	qian'shui'xi'shu	0
潜水医务保障	qian'shui'yi'wu'bao'zhang	0
潜水员	qian'shui'yuan	0
潜水作业	qian'shui'zuo'ye	0
浅滩	qian'tan	0
钱塘	qian'tang	0
亲潮	qin'chao	0
轻便潜水器	qing'bian'qian'shui'qi	0
轻浪	qing'lang	0
趋光性	qu'guang'xing	0
趋化性	qu'hua'xing	0
区域海洋学	qu'yu'hai'yang'xue	0
全球性海面升降	quan'qiu'xing'hai'mian'sheng'jiang	0
全日潮	quan'ri'chao	0
全植型营养	quan'zhi'xing'ying'yang	0
缺氧海盆	que'yang'hai'pen	0
缺氧事件	que'yang'shi'jian	0
缺氧水	que'yang'shui	0
裙板	qun'ban	0
群岛	qun'dao	0
群聚	qun'ju	0
群落	qun'luo	0
群落生态学	qun'luo'sheng'tai'xue	0
群体	qun'ti	0
群体生态学	qun'ti'sheng'tai'xue	0
群桩	qun'zhuang	0
桡足幼体	rao'zu'you'ti	0
热比容偏差	re'bi'rong'pian'cha	0
热带沉降	re'dai'chen'jiang	0
热点	re'dian	0
热盐对流	re'yan'dui'liu	0
热盐环流	re'yan'huan'liu	0
热盐结构	re'yan'jie'gou	0
热液过程	re'ye'guo'cheng	0
热液循环	re'ye'xun'huan	0
人工岛	ren'gong'dao	0
人工海水	ren'gong'hai'shui	0
人工育滩	ren'gong'yu'tan	0
人源输入	ren'yuan'shu'ru	0
人源烃	ren'yuan'ting	0
日不等	ri'bu'deng	0
溶解无机碳	rong'jie'wu'ji'tan	0
溶解旋回	rong'jie'xuan'hui	0
溶解氧	rong'jie'yang	0
溶解氧饱和度	rong'jie'yang'bao'he'du	0
溶解有机氮	rong'jie'you'ji'dan	0
溶解有机磷	rong'jie'you'ji'lin	0
溶解有机碳	rong'jie'you'ji'tan	0
溶解有机物	rong'jie'you'ji'wu	0
溶菌	rong'jun	0
溶跃层	rong'yue'ceng	0
入射波	ru'she'bo	0
软泥	ruan'ni	0
软体动物学	ruan'ti'dong'wu'xue	0
三角洲	san'jiao'zhou	0
三叶幼体	san'ye'you'ti	0
沙坝	sha'ba	0
沙坝岛	sha'ba'dao	0
沙波	sha'bo	0
沙间生物	sha'jian'sheng'wu	0
沙面生物	sha'mian'sheng'wu	0
沙内生物	sha'nei'sheng'wu	0
沙纹	sha'wen	0
沙嘴	sha'zui	0
珊瑚礁	shan'hu'jiao	0
珊湖礁海岸	shan'hu'jiao'hai'an	0
上部结构	shang'bu'jie'gou	0
上层	shang'ceng	0
上层浮游生物	shang'ceng'fu'you'sheng'wu	0
上层水	shang'ceng'shui	0
上层鱼类	shang'ceng'yu'lei	0
上覆水	shang'fu'shui	0
上升海岸	shang'sheng'hai'an	0
上升流	shang'sheng'liu	0
少种型大洋	shao'zhong'xing'da'yang	0
深层	shen'ceng	0
深层浮游生物	shen'ceng'fu'you'sheng'wu	0
深层流	shen'ceng'liu	0
深层水	shen'ceng'shui	0
深海沉积	shen'hai'chen'ji	0
深海传播	shen'hai'chuan'bo	0
深海带	shen'hai'dai	0
深海动物	shen'hai'dong'wu	0
深海粘土	shen'hai'nian'tu	0
深海平原	shen'hai'ping'yuan	0
深海丘陵	shen'hai'qiu'ling	0
深海散射层	shen'hai'san'she'ceng	0
深海砂	shen'hai'sha	0
深海扇	shen'hai'shan	0
深海声道	shen'hai'sheng'dao	0
蜃景	shen'jing	0
神经毒素	shen'jing'du'su	0
深水波	shen'shui'bo	0
深渊层	shen'yuan'ceng	0
深渊带	shen'yuan'dai	0
深渊动物	shen'yuan'dong'wu	0
深渊浮游生物	shen'yuan'fu'you'sheng'wu	0
深渊环流	shen'yuan'huan'liu	0
生产率	sheng'chan'lv	0
生产者	sheng'chan'zhe	0
生化需氧量	sheng'hua'xu'yang'liang	0
生活小区	sheng'huo'xiao'qu	0
生境	sheng'jing	0
生命效应	sheng'ming'xiao'ying	0
生命支持系统	sheng'ming'zhi'chi'xi'tong	0
声呐	sheng'na	0
生态位	sheng'tai'wei	0
生态系	sheng'tai'xi	0
生态障碍	sheng'tai'zhang'ai	0
生物测定	sheng'wu'ce'ding	0
生物测试	sheng'wu'ce'shi	0
生物沉积	sheng'wu'chen'ji	0
生物带	sheng'wu'dai	0
生物发光	sheng'wu'fa'guang	0
生物海洋学	sheng'wu'hai'yang'xue	0
生物降解	sheng'wu'jiang'jie	0
生物界面	sheng'wu'jie'mian	0
生物净化	sheng'wu'jing'hua	0
生物量	sheng'wu'liang	0
生物粘着	sheng'wu'nian'zhuo	0
生物侵蚀	sheng'wu'qin'shi	0
生物清除	sheng'wu'qing'chu	0
生物区系	sheng'wu'qu'xi	0
生物圈	sheng'wu'quan	0
生物扰动	sheng'wu'rao'dong	0
生物输入	sheng'wu'shu'ru	0
生物碎屑	sheng'wu'sui'xie	0
生物污染	sheng'wu'wu'ran	0
生物污着	sheng'wu'wu'zhe	0
生物相	sheng'wu'xiang	0
生物噪声	sheng'wu'zao'sheng	0
生物转移	sheng'wu'zhuan'yi	0
声学海洋学	sheng'xue'hai'yang'xue	0
声遥感	sheng'yao'gan	0
剩余碱度	sheng'yu'jian'du	0
生源硅石	sheng'yuan'gui'shi	0
生源烃	sheng'yuan'ting	0
生长效率	sheng'zhang'xiao'lv	0
生长型捕捞过度	sheng'zhang'xing'bu'lao'guo'du	0
生殖力	sheng'zhi'li	0
湿地	shi'di	0
食底泥动物	shi'di'ni'dong'wu	0
食粪动物	shi'fen'dong'wu	0
适光生物	shi'guang'sheng'wu	0
石蛤毒素	shi'ha'du'su	0
事件沉积	shi'jian'chen'ji	0
世界	shi'jie	0
嗜冷细菌	shi'leng'xi'jun	0
石面生物	shi'mian'sheng'wu	0
石内生物	shi'nei'sheng'wu	0
食肉动物	shi'rou'dong'wu	0
湿式潜水	shi'shi'qian'shui	0
食碎屑动物	shi'sui'xie'dong'wu	0
食微生物者	shi'wei'sheng'wu'zhe	0
适温生物	shi'wen'sheng'wu	0
嗜温细菌	shi'wen'xi'jun	0
食物金字塔	shi'wu'jin'zi'ta	0
食物链	shi'wu'lian	0
食物网	shi'wu'wang	0
适盐生物	shi'yan'sheng'wu	0
实用盐标	shi'yong'yan'biao	0
实用盐度	shi'yong'yan'du	0
食植动物	shi'zhi'dong'wu	0
示踪剂	shi'zong'ji	0
收获	shou'huo	0
首摇	shou'yao	0
输出通量	shu'chu'tong'liang	0
疏浚工程	shu'jun'gong'cheng	0
输入通量	shu'ru'tong'liang	0
双低潮	shuang'di'chao	0
双高潮	shuang'gao'chao	0
双扩散	shuang'kuo'san	0
双周期	shuang'zhou'qi	0
水层改正	shui'ceng'gai'zheng	0
水层耦合	shui'ceng'ou'he	0
水层区	shui'ceng'qu	0
水层生物	shui'ceng'sheng'wu	0
水层虚反射	shui'ceng'xu'fan'she	0
水产养殖	shui'chan'yang'zhi	0
水产养殖场	shui'chan'yang'zhi'chang	0
水产栽培	shui'chan'zai'pei	0
水尺	shui'chi	0
水华	shui'hua	0
水力模型试验	shui'li'mo'xing'shi'yan	0
水密	shui'mi	0
水枪	shui'qiang	0
水色	shui'se	0
水深测量	shui'shen'ce'liang	0
水生群落	shui'sheng'qun'luo	0
水生生态系	shui'sheng'sheng'tai'xi	0
水生生物	shui'sheng'sheng'wu	0
水生生物学	shui'sheng'sheng'wu'xue	0
水团	shui'tuan	0
水系	shui'xi	0
水下坝	shui'xia'ba	0
水下爆破	shui'xia'bao'po	0
水下采油系统	shui'xia'cai'you'xi'tong	0
水下焊接	shui'xia'han'jie	0
水下机器人	shui'xia'ji'qi'ren	0
水下结构	shui'xia'jie'gou	0
水下切割	shui'xia'qie'ge	0
水下通讯	shui'xia'tong'xun	0
水下信标	shui'xia'xin'biao	0
水下照度计	shui'xia'zhao'du'ji	0
水型	shui'xing	0
水质监测仪	shui'zhi'jian'ce'yi	0
水中对比度	shui'zhong'dui'bi'du	0
水中对比度传输	shui'zhong'dui'bi'du'chuan'shu	0
水中牧场	shui'zhong'mu'chang	0
水中能见度	shui'zhong'neng'jian'du	0
水中视程	shui'zhong'shi'cheng	0
顺岸流	shun'an'liu	0
顺岸码头	shun'an'ma'tou	0
顺坝	shun'ba	0
瞬变示踪剂	shun'bian'shi'zong'ji	0
瞬间死亡率	shun'jian'si'wang'lv	0
顺路观测船	shun'lu'guan'ce'chuan	0
顺应式结构	shun'ying'shi'jie'gou	0
朔望潮	shuo'wang'chao	0
斯托克斯波	si'tuo'ke'si'bo	0
死亡率	si'wang'lv	0
斯韦尔德鲁普波	si'wei'er'de'lu'pu'bo	0
溯河鱼	su'he'yu	0
酸盐	suan'yan	0
碎冰	sui'bing	0
碎波	sui'bo	0
碎波带	sui'bo'dai	0
索饵洄游	suo'er'hui'you	0
太平洋	tai'ping'yang	0
太平洋板块	tai'ping'yang'ban'kuai	0
太平洋赤道潜流	tai'ping'yang'chi'dao'qian'liu	0
太平洋两岸分布	tai'ping'yang'liang'an'fen'bu	0
太平洋型岸线	tai'ping'yang'xing'an'xian	0
太平洋型大陆边缘	tai'ping'yang'xing'da'lu'bian'yuan	0
台湾暖流	tai'wan'nuan'liu	0
苔藓虫幼体	tai'xian'chong'you'ti	0
太阳潮	tai'yang'chao	0
太阴潮	tai'yin'chao	0
太阴潮间隙	tai'yin'chao'jian'xi	0
弹簧采泥器	tan'huang'cai'ni'qi	0
滩脊	tan'ji	0
滩肩	tan'jian	0
滩角	tan'jiao	0
滩面	tan'mian	0
碳酸	tan'suan	0
碳酸盐极限深度	tan'suan'yan'ji'xian'shen'du	0
碳酸盐旋回	tan'suan'yan'xuan'hui	0
碳同化作用	tan'tong'hua'zuo'yong	0
碳循环	tan'xun'huan	0
特提斯海	te'ti'si'hai	0
特异性	te'yi'xing	0
特征种	te'zheng'zhong	0
体积混响	ti'ji'hun'xiang	0
体积散射	ti'ji'san'she	0
体积输送	ti'ji'shu'song	0
天文潮	tian'wen'chao	0
条件密度	tiao'jian'mi'du	0
停潮	ting'chao	0
同潮图	tong'chao'tu	0
同化数	tong'hua'shu	0
同化效率	tong'hua'xiao'lv	0
同域分布	tong'yu'fen'bu	0
同质性	tong'zhi'xing	0
投弃式温深计	tou'qi'shi'wen'shen'ji	0
突堤	tu'di	0
土工试验	tu'gong'shi'yan	0
退积作用	tui'ji'zuo'yong	0
脱镁叶绿素	tuo'mei'ye'lv'su	0
拖曳船模试验池	tuo'ye'chuan'mo'shi'yan'chi	0
椭余摆波	tuo'yu'bai'bo	0
椭余波	tuo'yu'bo	0
椭圆余摆线波	tuo'yuan'yu'bai'xian'bo	0
椭圆余弦波	tuo'yuan'yu'xian'bo	0
挖泥船	wa'ni'chuan	0
外滨	wai'bin	0
外来种群	wai'lai'zhong'qun	0
外源有机物	wai'yuan'you'ji'wu	0
湾流	wan'liu	0
万向接头	wan'xiang'jie'tou	0
网采浮游生物	wang'cai'fu'you'sheng'wu	0
往复流	wang'fu'liu	0
微表层采样器	wei'biao'ceng'cai'yang'qi	0
未充分成长风浪	wei'chong'fen'cheng'zhang'feng'lang	0
微大陆	wei'da'lu	0
微分布	wei'fen'bu	0
围海工程	wei'hai'gong'cheng	0
微结构	wei'jie'gou	0
微浪	wei'lang	0
微量营养物	wei'liang'ying'yang'wu	0
微生境	wei'sheng'jing	0
微生态系	wei'sheng'tai'xi	0
微生物污着	wei'sheng'wu'wu'zhe	0
微型底栖生物	wei'xing'di'qi'sheng'wu	0
微型动物	wei'xing'dong'wu	0
微型浮游生物	wei'xing'fu'you'sheng'wu	0
卫星海洋学	wei'xing'hai'yang'xue	0
卫星遥感观测	wei'xing'yao'gan'guan'ce	0
围堰	wei'yan	0
温带种	wen'dai'zhong	0
稳定同位素地层学	wen'ding'tong'wei'su'di'ceng'xue	0
稳定同位素期	wen'ding'tong'wei'su'qi	0
温盐深仪	wen'yan'shen'yi	0
温盐图解	wen'yan'tu'jie	0
温盐指标	wen'yan'zhi'biao	0
温跃层	wen'yue'ceng	0
无潮点	wu'chao'dian	0
无光带	wu'guang'dai	0
午后效应	wu'hou'xiao'ying	0
无节幼体	wu'jie'you'ti	0
无浪	wu'lang	0
物理海洋学	wu'li'hai'yang'xue	0
污染物	wu'ran'wu	0
无生命带	wu'sheng'ming'dai	0
污水处理	wu'shui'chu'li	0
无涌	wu'yong	0
无沾污采水器	wu'zhan'wu'cai'shui'qi	0
污着生物	wu'zhe'sheng'wu	0
无震海岭	wu'zhen'hai'ling	0
雾状层	wu'zhuang'ceng	0
西边界流	xi'bian'jie'liu	0
西风漂流	xi'feng'piao'liu	0
西加毒鱼类	xi'jia'du'yu'lei	0
习见种	xi'jian'zhong	0
细结构	xi'jie'gou	0
细菌膜	xi'jun'mo	0
细菌粘膜	xi'jun'nian'mo	0
牺牲阳极	xi'sheng'yang'ji	0
稀释旋回	xi'shi'xuan'hui	0
喜压细菌	xi'ya'xi'jun	0
喜阴浮游生物	xi'yin'fu'you'sheng'wu	0
稀有种	xi'you'zhong	0
下沉海岸	xia'chen'hai'an	0
狭分布种	xia'fen'bu'zhong	0
下降流	xia'jiang'liu	0
峡口	xia'kou	0
狭深性生物	xia'shen'xing'sheng'wu	0
下水	xia'shui	0
峡湾	xia'wan	0
狭温种	xia'wen'zhong	0
狭盐种	xia'yan'zhong	0
陷波	xian'bo	0
现场比容	xian'chang'bi'rong	0
现场测定	xian'chang'ce'ding	0
现场密度	xian'chang'mi'du	0
现场温度	xian'chang'wen'du	0
现场盐度计	xian'chang'yan'du'ji	0
现存量	xian'cun'liang	0
腺介幼体	xian'jie'you'ti	0
现象	xian'xiang	0
先行涌	xian'xing'yong	0
箱式模型	xiang'shi'mo'xing	0
箱式取样器	xiang'shi'qu'yang'qi	0
相似性	xiang'si'xing	0
消波装置	xiao'bo'zhuang'zhi	0
小潮	xiao'chao	0
消费者	xiao'fei'zhe	0
小菌落	xiao'jun'luo	0
小型底栖生物	xiao'xing'di'qi'sheng'wu	0
小型动物	xiao'xing'dong'wu	0
小型浮游生物	xiao'xing'fu'you'sheng'wu	0
小型实验生态系	xiao'xing'shi'yan'sheng'tai'xi	0
泻湖	xie'hu	0
挟卷	xie'juan	0
斜坡式防波堤	xie'po'shi'fang'bo'di	0
斜拖	xie'tuo	0
斜向浪	xie'xiang'lang	0
斜压海洋	xie'ya'hai'yang	0
信风海流	xin'feng'hai'liu	0
悬浮体	xuan'fu'ti	0
悬浮物	xuan'fu'wu	0
旋转潮波系统	xuan'zhuan'chao'bo'xi'tong	0
旋转流	xuan'zhuan'liu	0
雪盖冰	xue'gai'bing	0
穴居生物	xue'ju'sheng'wu	0
沿岸流	yan'an'liu	0
沿岸泥沙流	yan'an'ni'sha'liu	0
沿岸水	yan'an'shui	0
验潮井	yan'chao'jing	0
验潮仪	yan'chao'yi	0
盐度	yan'du	0
盐度计	yan'du'ji	0
盐度校正	yan'du'jiao'zheng	0
掩护水域	yan'hu'shui'yu	0
盐侵	yan'qin	0
盐舌	yan'she	0
盐生生物	yan'sheng'sheng'wu	0
岩滩	yan'tan	0
演替	yan'ti	0
盐误	yan'wu	0
厌氧带	yan'yang'dai	0
厌氧生活	yan'yang'sheng'huo	0
盐跃层	yan'yue'ceng	0
盐沼	yan'zhao	0
盐指	yan'zhi	0
氧饱和潜水	yang'bao'he'qian'shui	0
仰冲板块	yang'chong'ban'kuai	0
仰冲带	yang'chong'dai	0
氧分压	yang'fen'ya	0
氧化膜	yang'hua'mo	0
洋壳	yang'ke	0
洋盆	yang'pen	0
氧潜水	yang'qian'shui	0
洋中脊	yang'zhong'ji	0
洋中脊玄武岩	yang'zhong'ji'xuan'wu'yan	0
氧最大层	yang'zui'da'ceng	0
氧最小层	yang'zui'xiao'ceng	0
遥控潜水器	yao'kong'qian'shui'qi	0
液压活塞取芯器	ye'ya'huo'sai'qu'xin'qi	0
叶状幼体	ye'zhuang'you'ti	0
异常水位	yi'chang'shui'wei	0
一次性培养	yi'ci'xing'pei'yang	0
移动式平台	yi'dong'shi'ping'tai	0
异养生物	yi'yang'sheng'wu	0
溢油回收器	yi'you'hui'shou'qi	0
异域分布	yi'yu'fen'bu	0
异质性	yi'zhi'xing	0
异重流	yi'zhong'liu	0
翼足类软泥	yi'zu'lei'ruan'ni	0
引潮力	yin'chao'li	0
引潮势	yin'chao'shi	0
印度洋	yin'du'yang	0
印度洋板块	yin'du'yang'ban'kuai	0
印度洋中脊	yin'du'yang'zhong'ji	0
阴极防护	yin'ji'fang'hu	0
引力潮	yin'li'chao	0
营养	ying'yang	0
营养级	ying'yang'ji	0
营养缺陷生物	ying'yang'que'xian'sheng'wu	0
涌潮	yong'chao	0
永久性温跃层	yong'jiu'xing'wen'yue'ceng	0
涌浪	yong'lang	0
有机覆盖层	you'ji'fu'gai'ceng	0
有孔虫软泥	you'kong'chong'ruan'ni	0
幼年个体	you'nian'ge'ti	0
油气水处理系统	you'qi'shui'chu'li'xi'tong	0
油栅	you'shan	0
优势种	you'shi'zhong	0
幼体	you'ti	0
有限风区谱	you'xian'feng'qu'pu	0
有限风时谱	you'xian'feng'shi'pu	0
有效波	you'xiao'bo	0
游泳底栖生物	you'yong'di'qi'sheng'wu	0
游泳生物	you'yong'sheng'wu	0
疣足幼体	you'zu'you'ti	0
余摆线波	yu'bai'xian'bo	0
渔获量	yu'huo'liang	0
羽角	yu'jiao	0
渔捞死亡系数	yu'lao'si'wang'xi'shu	0
鱼类学	yu'lei'xue	0
鱼类资源	yu'lei'zi'yuan	0
余流	yu'liu	0
渔期	yu'qi	0
鱼探仪	yu'tan'yi	0
羽腕幼体	yu'wan'you'ti	0
渔业管理	yu'ye'guan'li	0
渔业海洋学	yu'ye'hai'yang'xue	0
渔业资源	yu'ye'zi'yuan	0
育幼场	yu'you'chang	0
宇宙沉积	yu'zhou'chen'ji	0
羽状移动	yu'zhuang'yi'dong	0
原存营养盐	yuan'cun'ying'yang'yan	0
远洋沉积	yuan'yang'chen'ji	0
跃层	yue'ceng	0
越冬	yue'dong	0
蕴藏量	yun'cang'liang	0
杂食动物	za'shi'dong'wu	0
灾变	zai'bian	0
再生循环	zai'sheng'xun'huan	0
再生资源	zai'sheng'zi'yuan	0
再悬浮	zai'xuan'fu	0
造船台	zao'chuan'tai	0
藻礁	zao'jiao	0
造礁珊瑚	zao'jiao'shan'hu	0
藻类化学	zao'lei'hua'xue	0
藻类学	zao'lei'xue	0
藻株	zao'zhu	0
增密	zeng'mi	0
增生楔	zeng'sheng'xie	0
增水	zeng'shui	0
增殖	zeng'zhi	0
炸药震源	zha'yao'zhen'yuan	0
栈桥	zhan'qiao	0
站位复原	zhan'wei'fu'yuan	0
障壁岛	zhang'bi'dao	0
涨潮	zhang'chao	0
张力腿平台	zhang'li'tui'ping'tai	0
沼泽生物	zhao'ze'sheng'wu	0
真光层	zhen'guang'ceng	0
振弦式海洋重力仪	zhen'xian'shi'hai'yang'zhong'li'yi	0
蒸汽枪	zheng'qi'qiang	0
正压海洋	zheng'ya'hai'yang	0
整治工程	zheng'zhi'gong'cheng	0
支承结构	zhi'cheng'jie'gou	0
滞后效应	zhi'hou'xiao'ying	0
直立式防波堤	zhi'li'shi'fang'bo'di	0
质量平衡	zhi'liang'ping'heng	0
质量收支	zhi'liang'shou'zhi	0
质量转移	zhi'liang'zhuan'yi	0
滞流事件	zhi'liu'shi'jian	0
滞留时间	zhi'liu'shi'jian	0
稚期	zhi'qi	0
指示种	zhi'shi'zhong	0
中层	zhong'ceng	0
中层水	zhong'ceng'shui	0
中层拖网	zhong'ceng'tuo'wang	0
中层鱼类	zhong'ceng'yu'lei	0
中尺度涡	zhong'chi'du'wo	0
中国船级社	zhong'guo'chuan'ji'she	0
中狂涌	zhong'kuang'yong	0
中浪	zhong'lang	0
重力波	zhong'li'bo	0
重力取芯器	zhong'li'qu'xin'qi	0
重力式结构	zhong'li'shi'jie'gou	0
重力式平台	zhong'li'shi'ping'tai	0
种群	zhong'qun	0
种群动态	zhong'qun'dong'tai	0
种群过密	zhong'qun'guo'mi	0
种群生态学	zhong'qun'sheng'tai'xue	0
终生浮游生物	zhong'sheng'fu'you'sheng'wu	0
中型浮游生物	zhong'xing'fu'you'sheng'wu	0
中型实验生态系	zhong'xing'shi'yan'sheng'tai'xi	0
中央海岭	zhong'yang'hai'ling	0
中央裂谷	zhong'yang'lie'gu	0
中央水	zhong'yang'shui	0
中中涌	zhong'zhong'yong	0
周丛生物	zhou'cong'sheng'wu	0
轴对称式海洋重力仪	zhou'dui'chen'shi'hai'yang'zhong'li'yi	0
昼夜垂直移动	zhou'ye'chui'zhi'yi'dong	0
周转率	zhou'zhuan'lv	0
驻波	zhu'bo	0
主动大陆边缘	zhu'dong'da'lu'bian'yuan	0
转换边界	zhuan'huan'bian'jie	0
转换断层	zhuan'huan'duan'ceng	0
转换效率	zhuan'huan'xiao'lv	0
转流	zhuan'liu	0
专属经济区	zhuan'shu'jing'ji'qu	0
专一性	zhuan'yi'xing	0
浊积物	zhuo'ji'wu	0
浊积岩	zhuo'ji'yan	0
浊流	zhuo'liu	0
自返式沉积物取芯器	zi'fan'shi'chen'ji'wu'qu'xin'qi	0
自生沉积	zi'sheng'chen'ji	0
自升式平台	zi'sheng'shi'ping'tai	0
自体抑制物质	zi'ti'yi'zhi'wu'zhi	0
自养生物	zi'yang'sheng'wu	0
资源评估	zi'yuan'ping'gu	0
资源增殖	zi'yuan'zeng'zhi	0
纵荡	zong'dang	0
总环流	zong'huan'liu	0
总碱度	zong'jian'du	0
纵摇	zong'yao	0
总有机氮	zong'you'ji'dan	0
总有机磷	zong'you'ji'lin	0
总有机碳	zong'you'ji'tan	0
总有机物	zong'you'ji'wu	0
组合	zu'he	0
钻孔生物	zuan'kong'sheng'wu	0
钻探船	zuan'tan'chuan	0
最低天文潮位	zui'di'tian'wen'chao'wei	0
最高天文潮位	zui'gao'tian'wen'chao'wei	0
最适渔获量	zui'shi'yu'huo'liang	0
最小风区	zui'xiao'feng'qu	0
最小风时	zui'xiao'feng'shi	0
坐底式平台	zuo'di'shi'ping'tai	0
作用	zuo'yong	0
