百木园	bai'mu'yuan	0
悲伤之穴	bei'shang'zhi'xue	0
悲雾林	bei'wu'lin	0
碧绿林地	bi'lv'lin'di	0
残阳关	can'yang'guan	0
禅杖林	chan'zhang'lin	0
潮雾林地	chao'wu'lin'di	0
晨息村	chen'xi'cun	0
晨息湖	chen'xi'hu	0
晨之谷	chen'zhi'gu	0
晨之阶	chen'zhi'jie	0
晨之桥	chen'zhi'qiao	0
翠竹旷野	cui'zhu'kuang'ye	0
大箩农场	da'luo'nong'chang	0
倒影之池	dao'ying'zhi'chi	0
地狱咆哮的希望	di'yu'pao'xiao'de'xi'wang	0
吊尾围栏	diao'wei'wei'lan	0
翡翠林	fei'cui'lin	0
狒狒村	fei'fei'cun	0
风暴烈酒酿造厂	feng'bao'lie'jiu'niang'zao'chang	0
疯酒师山谷	feng'jiu'shi'shan'gu	0
丰饶树林	feng'rao'shu'lin	0
风语厅	feng'yu'ting	0
福家小池	fu'jia'xiao'chi	0
刚狮废墟	gang'shi'fei'xu	0
格玛尔营地	ge'ma'er'ying'di	0
孤寂塔	gu'ji'ta	0
骨之碑	gu'zhi'bei	0
观景台	guan'jing'tai	0
观山台	guan'shan'tai	0
海雾岭	hai'wu'ling	0
红烛林	hong'zhu'lin	0
狐狸森林	hu'li'sen'lin	0
滑水溪	hua'shui'xi	0
唤魂者之座	huan'hun'zhe'zhi'zuo	0
皇帝的预言地	huang'di'de'yu'yan'di	0
黄粱阁	huang'liang'ge	0
荒弃小屋	huang'qi'xiao'wu	0
金莲教	jin'lian'jiao	0
锦绣谷	jin'xiu'gu	0
静寂瀑布	jing'ji'pu'bu	0
惊叹角	jing'tan'jiao	0
酒仙	jiu'xian	0
卡桑琅丛林	ka'sang'lang'cong'lin	0
恐惧废土	kong'ju'fei'tu	0
昆莱山	kun'lai'shan	0
兰花谷	lan'hua'gu	0
蓝玉号船骸	lan'yu'hao'chuan'hai	0
雷木林	lei'mu'lin	0
雷爪峰	lei'zhao'feng	0
雷爪阁	lei'zhao'ge	0
黎明神龛	li'ming'shen'kan	0
黎明之桥	li'ming'zhi'qiao	0
璃影湖	li'ying'hu	0
梁家小宅	liang'jia'xiao'zhai	0
鳞之碑	lin'zhi'bei	0
灵水湖	ling'shui'hu	0
龙脊之柱	long'ji'zhi'zhu	0
绿石采掘场	lv'shi'cai'jue'chang	0
绿石村	lv'shi'cun	0
绿石集市	lv'shi'ji'shi	0
绿野村	lv'ye'cun	0
猛虎林	meng'hu'lin	0
梦石神龛	meng'shi'shen'kan	0
蜜风果园	mi'feng'guo'yuan	0
迷航港	mi'hang'gang	0
迷踪岛	mi'zong'dao	0
冥想洞穴	ming'xiang'dong'xue	0
魔古山宝库	mo'gu'shan'bao'ku	0
魔古山宫殿	mo'gu'shan'gong'dian	0
能量谷	neng'liang'gu	0
能量谷场景战役	neng'liang'gu'chang'jing'zhan'yi	0
宁静洞室	ning'jing'dong'shi	0
努卡努卡营地	nu'ka'nu'ka'ying'di	0
欧文的许愿井	ou'wen'de'xu'yuan'jing	0
品酒师赛场	pin'jiu'shi'sai'chang	0
珀雾沼	po'wu'zhao	0
破晓塔	po'xiao'ta	0
启迪之路	qi'di'zhi'lu	0
祁翰酒坊	qi'han'jiu'fang	0
阡陌	qian'mo	0
青龙寺	qing'long'si	0
青龙寺庭院	qing'long'si'ting'yuan	0
青玉巫婆的小屋	qing'yu'wu'po'de'xiao'wu	0
柔沙海滩	rou'sha'hai'tan	0
塞拉摩之战	sai'la'mo'zhi'zhan	0
三春禅院	san'chun'chan'yuan	0
沙拉村	sha'la'cun	0
沙拉兰	sha'la'lan	0
上古魔古地穴	shang'gu'mo'gu'di'xue	0
尚喜习武场	shang'xi'xi'wu'chang	0
神秘海域	shen'mi'hai'yu	0
圣陵草甸	sheng'ling'cao'dian	0
试炼场	shi'lian'chang	0
失落林地	shi'luo'lin'di	0
石之碑	shi'zhi'bei	0
四风谷	si'feng'gu	0
丝木林	si'mu'lin	0
碎石小径	sui'shi'xiao'jing	0
踏风	ta'feng	0
螳螂荒原	tang'lang'huang'yuan	0
天火号坠落地	tian'huo'hao'zhui'luo'di	0
天鲨号的残骸	tian'sha'hao'de'can'hai	0
通灵学院	tong'ling'xue'yuan	0
兔妖洞	tu'yao'dong	0
顽猴旷野	wan'hou'kuang'ye	0
完美风暴	wan'mei'feng'bao	0
围攻砮皂寺	wei'gong'nu'zao'si	0
五晨神龛	wu'chen'shen'kan	0
五晨寺	wu'chen'si	0
无风岛	wu'feng'dao	0
无尽之海	wu'jin'zhi'hai	0
武僧	wu'seng	0
武松村	wu'song'cun	0
希望石拱	xi'wang'shi'gong	0
习武场	xi'wu'chang	0
笑风山	xiao'feng'shan	0
心光神龛	xin'guang'shen'kan	0
信徒营地	xin'tu'ying'di	0
旋风高地	xuan'feng'gao'di	0
喧闹洼地	xuan'nao'wa'di	0
喧嚣地穴	xuan'xiao'di'xue	0
血色大教堂	xue'se'da'jiao'tang	0
血色大厅	xue'se'da'ting	0
血之碑	xue'zhi'bei	0
宴会地	yan'hui'di	0
隐秘小路	yin'mi'xiao'lu	0
影枝坳	ying'zhi'ao	0
影踪禅院	ying'zong'chan'yuan	0
永春台	yong'chun'tai	0
咏之池	yong'zhi'chi	0
玉盘湖	yu'pan'hu	0
玉塔海	yu'ta'hai	0
月水庄	yue'shui'zhuang	0
长者之路	zhang'zhe'zhi'lu	0
爪之池	zhao'zhi'chi	0
织雾	zhi'wu	0
至尊天神	zhi'zun'tian'shen	0
中部竹林	zhong'bu'zhu'lin	0
珠鳍村	zhu'qi'cun	0
浊水河岸	zhuo'shui'he'an	0
醉猴楼	zui'hou'lou	0
