安全水头	an'quan'shui'tou	0
饱和溶解氧浓度	bao'he'rong'jie'yang'nong'du	0
曝气	bao'qi	0
曝气池	bao'qi'chi	0
曝气池容积	bao'qi'chi'rong'ji	0
曝气链	bao'qi'lian	0
曝气量	bao'qi'liang	0
曝气生物滤池	bao'qi'sheng'wu'lv'chi	0
曝气式沉砂池	bao'qi'shi'chen'sha'chi	0
曝气头	bao'qi'tou	0
泵房	beng'fang	0
表面负荷	biao'mian'fu'he	0
表面活性剂	biao'mian'huo'xing'ji	0
表面水力负荷	biao'mian'shui'li'fu'he	0
标准状态需氧量	biao'zhun'zhuang'tai'xu'yang'liang	0
标准状态需要空气量	biao'zhun'zhuang'tai'xu'yao'kong'qi'liang	0
产生生物污泥量	chan'sheng'sheng'wu'wu'ni'liang	0
超滤	chao'lv	0
沉淀	chen'dian	0
沉淀池	chen'dian'chi	0
沉淀室容积	chen'dian'shi'rong'ji	0
沉砂池	chen'sha'chi	0
沉砂含水率	chen'sha'han'shui'lv	0
沉砂量	chen'sha'liang	0
沉砂密度	chen'sha'mi'du	0
澄清	cheng'qing	0
澄清池	cheng'qing'chi	0
冲击负荷	chong'ji'fu'he	0
初沉池	chu'chen'chi	0
出水悬浮物浓度	chu'shui'xuan'fu'wu'nong'du	0
出水堰	chu'shui'yan	0
粗格栅	cu'ge'shan	0
大肠杆菌	da'chang'gan'jun	0
单位进水生物合成的需氮量	dan'wei'jin'shui'sheng'wu'he'cheng'de'xu'dan'liang	0
导流筒	dao'liu'tong	0
电渗析	dian'shen'xi	0
二次沉淀池	er'ci'chen'dian'chi	0
二级处理	er'ji'chu'li	0
二氧化氯发生器	er'yang'hua'lv'fa'sheng'qi	0
反冲洗	fan'chong'xi	0
反渗透	fan'shen'tou	0
反硝化时溶解氧浓度	fan'xiao'hua'shi'rong'jie'yang'nong'du	0
反硝化速率	fan'xiao'hua'su'lv	0
反硝化增加的体积	fan'xiao'hua'zeng'jia'de'ti'ji	0
废水	fei'shui	0
废水处理	fei'shui'chu'li	0
辐流式沉淀池	fu'liu'shi'chen'dian'chi	0
浮渣井	fu'zha'jing	0
干沉砂量	gan'chen'sha'liang	0
高负荷曝气	gao'fu'he'bao'qi	0
格栅	ge'shan	0
隔油池	ge'you'chi	0
工业废水	gong'ye'fei'shui	0
鼓风机	gu'feng'ji	0
鼓风机房	gu'feng'ji'fang	0
挂膜	gua'mo	0
刮泥板	gua'ni'ban	0
管材	guan'cai	0
管道	guan'dao	0
管径	guan'jing	0
管线	guan'xian	0
过滤	guo'lv	0
过滤池	guo'lv'chi	0
过栅流速	guo'shan'liu'su	0
挥发悬浮物浓度	hui'fa'xuan'fu'wu'nong'du	0
回转式机械格栅	hui'zhuan'shi'ji'xie'ge'shan	0
混凝沉淀池	hun'ning'chen'dian'chi	0
混凝剂	hun'ning'ji	0
活性炭再生	huo'xing'tan'zai'sheng	0
活性污泥法	huo'xing'wu'ni'fa	0
计量泵	ji'liang'beng	0
集水槽	ji'shui'cao	0
加药系统	jia'yao'xi'tong	0
加药装置	jia'yao'zhuang'zhi	0
碱度	jian'du	0
接触消毒池	jie'chu'xiao'du'chi	0
接触氧化	jie'chu'yang'hua	0
进水水质	jin'shui'shui'zhi	0
进水悬浮物浓度	jin'shui'xuan'fu'wu'nong'du	0
聚丙烯酰胺	ju'bing'xi'xian'an	0
局部阻力系数	ju'bu'zu'li'xi'shu	0
聚合氯化铝	ju'he'lv'hua'lv	0
菌种驯化	jun'zhong'xun'hua	0
可调堰门	ke'tiao'yan'men	0
冷却水	leng'que'shui	0
离心鼓风机	li'xin'gu'feng'ji	0
离子交换	li'zi'jiao'huan	0
离子交换器	li'zi'jiao'huan'qi	0
离子交换树脂	li'zi'jiao'huan'shu'zhi	0
联动试车	lian'dong'shi'che	0
罗茨风机	luo'ci'feng'ji	0
螺旋输送机	luo'xuan'shu'song'ji	0
钠滤	na'lv	0
泥龄	ni'ling	0
平均日流量	ping'jun'ri'liu'liang	0
平流式沉淀池	ping'liu'shi'chen'dian'chi	0
平流式沉砂池	ping'liu'shi'chen'sha'chi	0
气浮	qi'fu	0
气浮池	qi'fu'chi	0
潜水排污泵	qian'shui'pai'wu'beng	0
潜水污泥泵	qian'shui'wu'ni'beng	0
清砂间隔时间	qing'sha'jian'ge'shi'jian	0
清水池	qing'shui'chi	0
去除有机物	qu'chu'you'ji'wu	0
容积负荷	rong'ji'fu'he	0
三角堰	san'jiao'yan	0
栅槽宽度	shan'cao'kuan'du	0
栅前水深	shan'qian'shui'shen	0
栅渣量	shan'zha'liang	0
上流式厌氧污泥反应床	shang'liu'shi'yan'yang'wu'ni'fan'ying'chuang	0
设计流量	she'ji'liu'liang	0
深度处理	shen'du'chu'li	0
生活污水	sheng'huo'wu'shui	0
生物合成需氮量	sheng'wu'he'cheng'xu'dan'liang	0
生物接触氧化	sheng'wu'jie'chu'yang'hua	0
生物滤池	sheng'wu'lv'chi	0
生物膜	sheng'wu'mo	0
剩余污泥	sheng'yu'wu'ni	0
剩余污泥量	sheng'yu'wu'ni'liang	0
实际设计泥龄	shi'ji'she'ji'ni'ling	0
竖流式沉淀池	shu'liu'shi'chen'dian'chi	0
竖流式沉砂池	shu'liu'shi'chen'sha'chi	0
衰减系数	shuai'jian'xi'shu	0
水泵扬程	shui'beng'yang'cheng	0
水解酸化	shui'jie'suan'hua	0
水量	shui'liang	0
水头损失	shui'tou'sun'shi	0
水质	shui'zhi	0
丝状菌	si'zhuang'jun	0
塔式生物滤池	ta'shi'sheng'wu'lv'chi	0
提升泵房	ti'sheng'beng'fang	0
调节堰门	tiao'jie'yan'men	0
停留时间	ting'liu'shi'jian	0
推流曝气	tui'liu'bao'qi	0
微孔曝气器	wei'kong'bao'qi'qi	0
污泥	wu'ni	0
污泥产量	wu'ni'chan'liang	0
污泥产泥系数	wu'ni'chan'ni'xi'shu	0
污泥处理	wu'ni'chu'li	0
污泥处置	wu'ni'chu'zhi	0
污泥负荷	wu'ni'fu'he	0
污泥回流	wu'ni'hui'liu	0
污泥回流泵	wu'ni'hui'liu'beng	0
污泥回流比	wu'ni'hui'liu'bi	0
污泥井	wu'ni'jing	0
污泥内源呼吸系数	wu'ni'nei'yuan'hu'xi'xi'shu	0
污泥浓缩池	wu'ni'nong'suo'chi	0
污泥膨胀	wu'ni'peng'zhang	0
污泥填埋	wu'ni'tian'mai	0
污泥脱水机房	wu'ni'tuo'shui'ji'fang	0
污泥稳定	wu'ni'wen'ding	0
污泥消化	wu'ni'xiao'hua	0
污泥自身氧化需氧率	wu'ni'zi'shen'yang'hua'xu'yang'lv	0
污水	wu'shui	0
污水处理	wu'shui'chu'li	0
污水量	wu'shui'liang	0
污水栅渣量	wu'shui'shan'zha'liang	0
细格栅	xi'ge'shan	0
系统每日需氧量	xi'tong'mei'ri'xu'yang'liang	0
消毒	xiao'du	0
消毒池	xiao'du'chi	0
硝化菌的生长速率	xiao'hua'jun'de'sheng'zhang'su'lv	0
消化污泥最小停留时间	xiao'hua'wu'ni'zui'xiao'ting'liu'shi'jian	0
斜板沉淀池	xie'ban'chen'dian'chi	0
斜管沉淀池	xie'guan'chen'dian'chi	0
需氧量	xu'yang'liang	0
悬浮物浓度	xuan'fu'wu'nong'du	0
旋流式沉砂池	xuan'liu'shi'chen'sha'chi	0
驯化菌种	xun'hua'jun'zhong	0
循环水	xun'huan'shui	0
堰门	yan'men	0
延时曝气	yan'shi'bao'qi	0
氧半速常数	yang'ban'su'chang'shu	0
氧化沟	yang'hua'gou	0
氧化沟体积	yang'hua'gou'ti'ji	0
一级处理	yi'ji'chu'li	0
余氯	yu'lv	0
栅条间隙	zha'tiao'jian'xi	0
栅条宽度	zha'tiao'kuan'du	0
整流挡板	zheng'liu'dang'ban	0
中水	zhong'shui	0
中水处理	zhong'shui'chu'li	0
中水回用	zhong'shui'hui'yong	0
轴流风机	zhou'liu'feng'ji	0
助凝剂	zhu'ning'ji	0
贮水池	zhu'shui'chi	0
转鼓式机械格栅	zhuan'gu'shi'ji'xie'ge'shan	0
总变化系数	zong'bian'hua'xi'shu	0
最大日流量	zui'da'ri'liu'liang	0
最大时流量	zui'da'shi'liu'liang	0
最低温度	zui'di'wen'du	0
