阿尔伯特威斯克	a'er'bo'te'wei'si'ke	0
阿尔弗雷德	a'er'fu'lei'de	0
阿克雷山区	a'ke'lei'shan'qu	0
阿莱克西亚	a'lai'ke'xi'ya	0
阿什莉	a'shen'li	0
阿什莉格拉汉姆	a'shen'li'ge'la'han'mu	0
艾达	ai'da	0
艾达王	ai'da'wang	0
爱德华亚西福特	ai'de'hua'ya'xi'fu'te	0
埃里克马比乌斯	ai'li'ke'ma'bi'wu'si	0
艾丽萨阿什克罗芙特	ai'li'sa'a'shen'ke'luo'fu'te	0
艾丽斯	ai'li'si	0
碍事梨	ai'shi'li	0
安布雷拉	an'bu'lei'la	0
安布雷拉的阴谋	an'bu'lei'la'de'yin'mou	0
安布雷拉法国支部	an'bu'lei'la'fa'guo'zhi'bu	0
安布雷拉公司	an'bu'lei'la'gong'si	0
安布雷拉历代记	an'bu'lei'la'li'dai'ji	0
安妮柏肯	an'ni'bai'ken	0
肮脏的珍珠项链	ang'zang'de'zhen'zhu'xiang'lian	0
肮脏生锈的黄铜怀表	ang'zang'sheng'xiu'de'huang'tong'huai'biao	0
奥迪德弗尔	ao'di'de'fu'er	0
奥斯威尔斯宾塞	ao'si'wei'e'si'bin'sai	0
巴里波顿	ba'li'bo'dun	0
半自动来福枪	ban'zi'dong'lai'fu'qiang	0
半自动来福枪瞄准镜	ban'zi'dong'lai'fu'qiang'miao'zhun'jing	0
爆发	bao'fa	0
保护伞	bao'hu'san	0
保护伞公司	bao'hu'san'gong'si	0
暴君	bao'jun	0
爆裂弹	bao'lie'tan	0
保罗安德森	bao'luo'an'de'sen	0
比利	bi'li	0
比利科恩	bi'li'ke'en	0
标准手枪	biao'zhun'shou'qiang	0
布莱恩艾斯隆	bu'lai'en'ai'si'long	0
布鲁斯麦吉克文	bu'lu'si'mai'ji'ke'wen	0
城主	cheng'zhu	0
村长	cun'zhang	0
大昂	da'ang	0
打击者	da'ji'zhe	0
大卫迪泰	da'wei'di'tai	0
大卫肯	da'wei'ken	0
代号维罗妮卡	dai'hao'wei'luo'ni'ka	0
地雷枪	di'lei'qiang	0
地雷枪弹药	di'lei'qiang'dan'yao	0
地雷枪瞄准镜	di'lei'qiang'miao'zhun'jing	0
地下世界	di'xia'shi'jie	0
电锯	dian'ju	0
电锯老祖	dian'ju'lao'zu	0
吊灯	diao'deng	0
雕像	diao'xiang	0
噩梦的洞窟	e'meng'de'dong'ku	0
防暴枪	fang'bao'qiang	0
废弃物处理场	fei'qi'wu'chu'li'chang	0
废物处理场	fei'wu'chu'li'chang	0
蜂巢	feng'chao	0
凤铃	feng'ling	0
复仇女神	fu'chou'nv'shen	0
复仇女神计划	fu'chou'nv'shen'ji'hua	0
富兰克林哈特	fu'lan'ke'lin'ha'te	0
富有宝石质感的晶体矿物	fu'you'bao'shi'zhi'gan'de'jing'ti'kuang'wu	0
富有宝石质感的蓝晶石	fu'you'bao'shi'zhi'gan'de'lan'jing'shi	0
干部培养所	gan'bu'pei'yang'suo	0
干部养成所	gan'bu'yang'cheng'suo	0
古董烟斗	gu'dong'yan'dou	0
哈弗威尔	ha'fu'wei'er	0
汉克	han'ke	0
黑尾	hei'wei	0
黑曜石	hei'yao'shi	0
红暴	hong'bao	0
红宝石	hong'bao'shi	0
红猎	hong'lie	0
红猫眼石	hong'mao'yan'shi	0
红色的猫眼石	hong'se'de'mao'yan'shi	0
红色的珠宝	hong'se'de'zhu'bao	0
红色发光的大宝石	hong'se'fa'guang'de'da'bao'shi	0
红色女皇	hong'se'nv'huang	0
红外线瞄准镜	hong'wai'xian'miao'zhun'jing	0
红眼石	hong'yan'shi	0
琥珀色的红宝石戒指	hu'po'se'de'hong'bao'shi'jie'zhi	0
琥珀石	hu'po'shi	0
湖主	hu'zhu	0
怀表	huai'biao	0
幻彩珍藏	huan'cai'zhen'cang	0
浣熊市	huan'xiong'shi	0
皇家标志	huang'jia'biao'zhi	0
皇家权杖	huang'jia'quan'zhang	0
黄金制成的面具	huang'jin'zhi'cheng'de'mian'ju	0
黄猎	huang'lie	0
黄猫眼石	huang'mao'yan'shi	0
黄色的猫眼石	huang'se'de'mao'yan'shi	0
黄玉朗	huang'yu'lang	0
火箭筒	huo'jian'tong	0
火焰弹	huo'yan'dan	0
吉尔	ji'er	0
吉儿瓦伦蒂安	ji'er'wa'lun'di'an	0
机密报告	ji'mi'bao'gao	0
吉姆查普曼	ji'mu'cha'pu'man	0
机枪手	ji'qiang'shou	0
寄生虫	ji'sheng'chong	0
寄生狗	ji'sheng'gou	0
教主	jiao'zhu	0
杰克克劳萨	jie'ke'ke'lao'sa	0
杰茜卡特雷沃	jie'qian'ka'te'lei'wo	0
戒指	jie'zhi	0
金币	jin'bi	0
金条	jin'tiao	0
金制的皇家标志	jin'zhi'de'huang'jia'biao'zhi	0
金制的王冠	jin'zhi'de'wang'guan	0
金制猫的雕像	jin'zhi'mao'de'diao'xiang	0
金制手镯	jin'zhi'shou'zhuo	0
竞技手枪	jing'ji'shou'qiang	0
精美的珍珠项链	jing'mei'de'zhen'zhu'xiang'lian	0
精美雕刻的时间沙漏	jing'mei'diao'ke'de'shi'jian'sha'lou	0
晶体矿物	jing'ti'kuang'wu	0
精致的蝴蝶吊灯	jing'zhi'de'hu'die'diao'deng	0
精致的啤酒杯	jing'zhi'de'pi'jiu'bei	0
精致的香水瓶	jing'zhi'de'xiang'shui'ping	0
精致高雅的棋盘	jing'zhi'gao'ya'de'qi'pan	0
精致高雅的头饰	jing'zhi'gao'ya'de'tou'shi	0
精致黄铜怀表	jing'zhi'huang'tong'huai'biao	0
镜子	jing'zi	0
掘土者	jue'tu'zhe	0
卡莉莫珊	ka'li'mo'shan	0
卡洛斯奥利维拉	ka'luo'si'ao'li'wei'la	0
卡普空	ka'pu'kong	0
凯文雷曼	kai'wen'lei'man	0
克莱尔雷德菲尔德	ke'lai'er'lei'de'fei'er'de	0
克劳萨	ke'lao'sa	0
克里斯	ke'li'si	0
克里斯多夫亨利	ke'li'si'duo'fu'heng'li	0
克里斯雷德菲尔德	ke'li'si'lei'de'fei'er'de	0
来福枪	lai'fu'qiang	0
来福枪瞄准镜	lai'fu'qiang'miao'zhun'jing	0
来福枪子弹	lai'fu'qiang'zi'dan	0
莱肯市	lai'ken'shi	0
蓝宝石	lan'bao'shi	0
蓝晶石	lan'jing'shi	0
蓝眼石	lan'yan'shi	0
老式手枪	lao'shi'shou'qiang	0
雷恩	lei'en	0
雷萨克艾多提	lei'sa'ke'ai'duo'ti	0
冷冻弹	leng'dong'tan	0
里昂	li'ang	0
里昂斯科特肯尼迪	li'ang'si'ke'te'ken'ni'di	0
历代记	li'dai'ji	0
利卡	li'ka	0
李老汉	li'lao'han	0
猎杀者	lie'sha'zhe	0
猎食者	lie'shi'zhe	0
零度时刻	ling'du'shi'ke	0
铃木阳子	ling'mu'yang'zi	0
榴弹发射器	liu'dan'fa'she'qi	0
硫酸弹	liu'suan'tan	0
路易斯	lu'yi'si	0
洛克福特岛	luo'ke'fu'te'dao	0
洛克福特岛刑务所	luo'ke'fu'te'dao'xing'wu'suo	0
绿暴	lv'bao	0
绿宝石	lv'bao'shi	0
绿猎	lv'lie	0
绿猫眼石	lv'mao'yan'shi	0
绿色的猫眼石	lv'se'de'mao'yan'shi	0
绿色的珠宝	lv'se'de'zhu'bao	0
绿色翡翠宝石	lv'se'fei'cui'bao'shi	0
绿眼石	lv'yan'shi	0
马克威尔金斯	ma'ke'wei'er'jin'si	0
马休泰勒	ma'xiu'tai'le	0
迈克埃普斯	mai'ke'ai'pu'si	0
迈克尔沃伦	mai'ke'er'wo'lun	0
麦林手枪	mai'lin'shou'qiang	0
麦林弹	mai'lin'tan	0
麦特	mai'te	0
米汉尔	mi'han'er	0
米拉乔沃维奇	mi'la'qiao'wo'wei'qi	0
米歇尔罗德里格兹	mi'xie'er'luo'de'li'ge'zi	0
面具	mian'ju	0
灭菌作战	mie'jun'zuo'zhan	0
尼古拉	ni'gu'la	0
女王蚁	nv'wang'yi	0
帕拉克努斯	pa'la'ke'nu'si	0
帕拉克努斯魔剑	pa'la'ke'nu'si'mo'jian	0
帕拉克努斯之剑	pa'la'ke'nu'si'zhi'jian	0
啤酒杯	pi'jiu'bei	0
棋盘	qi'pan	0
枪下游魂	qiang'xia'you'hun	0
乔治汉弥尔顿	qiao'zhi'han'mi'er'dun	0
乔治特雷沃	qiao'zhi'te'lei'wo	0
权杖	quan'zhang	0
燃烧手榴弹	ran'shao'shou'liu'dan	0
瑞贝卡	rui'bei'ka	0
瑞贝卡查姆博斯	rui'bei'ka'cha'mu'bo'si	0
萨德勒	sa'de'le	0
萨克华德	sa'ke'hua'de	0
萨拉萨尔	sa'la'sa'er	0
散弹枪	san'dan'qiang	0
散弹枪子弹	san'dan'qiang'zi'dan	0
三上真司	san'shang'zhen'si	0
丧尸	sang'shi	0
丧尸犬	sang'shi'quan	0
沙漏	sha'lou	0
杀手	sha'shou	0
闪光手榴弹	shan'guang'shou'liu'dan	0
神谷诚	shen'gu'cheng	0
生化危机	sheng'hua'wei'ji	0
生物兵器紧急应对部队	sheng'wu'bing'qi'jin'ji'ying'dui'bu'dui	0
史蒂夫伯恩塞德	shi'di'fu'bo'en'sai'de	0
十年典藏	shi'nian'dian'cang	0
始祖病毒	shi'zu'bing'du	0
手雷	shou'lei	0
手镯	shou'zhuo	0
水晶石	shui'jing'shi	0
死寂	si'ji	0
死亡目标	si'wang'mu'biao	0
特别战术营救小队	te'bie'zhan'shu'ying'jiu'xiao'dui	0
特殊火箭筒	te'shu'huo'jian'tong	0
舔食者	tian'shi'zhe	0
铜罗盘	tong'luo'pan	0
铜书	tong'shu	0
头饰	tou'shi	0
完整王冠	wan'zheng'wang'guan	0
王冠	wang'guan	0
王冠上面的珠宝	wang'guan'shang'mian'de'zhu'bao	0
王冠珠宝	wang'guan'zhu'bao	0
亡者的城市	wang'zhe'de'cheng'shi	0
威廉柏肯	wei'lian'bai'ken	0
维罗妮卡	wei'luo'ni'ka	0
威斯克	wei'si'ke	0
蚊子	wen'zi	0
西部制式	xi'bu'zhi'shi	0
西娜吉罗瑞	xi'na'ji'luo'rui	0
夏娃阿洛玛	xia'wa'a'luo'ma	0
霰弹枪	xian'dan'qiang	0
项链	xiang'lian	0
镶嵌满宝石的金猫雕像	xiang'qian'man'bao'shi'de'jin'mao'diao'xiang	0
镶嵌满宝石的啤酒杯	xiang'qian'man'bao'shi'de'pi'jiu'bei	0
镶嵌满红宝石珍珠的镜子	xiang'qian'man'hong'bao'shi'zhen'zhu'de'jing'zi	0
镶嵌满珠宝的完整金制王冠	xiang'qian'man'zhu'bao'de'wan'zheng'jin'zhi'wang'guan	0
镶嵌珍珠的黄金手镯	xiang'qian'zhen'zhu'de'huang'jin'shou'zhuo	0
香水瓶	xiang'shui'ping	0
小林裕幸	xiao'lin'yu'xing	0
谢尔盖乌拉兹米尔	xie'er'gai'wu'la'zi'mi'er	0
辛迪莱诺克斯	xin'di'lai'nuo'ke'si	0
刑务所	xing'wu'suo	0
胸针	xiong'zhen	0
雪利柏肯	xue'li'bai'ken	0
亚历山大亚西福特	ya'li'shan'da'ya'xi'fu'te	0
亚西福特	ya'xi'fu'te	0
烟斗	yan'dou	0
洋馆	yang'guan	0
夜之女神	ye'zhi'nv'shen	0
疫苗培养液	yi'miao'pei'yang'ye	0
右手	you'shou	0
月之饰物	yue'zhi'shi'wu	0
再生者	zai'sheng'zhe	0
詹姆斯马库斯	zhan'mu'si'ma'ku'si	0
詹姆斯普洱弗伊	zhan'mu'si'pu'er'fu'yi	0
折翼蝴蝶	zhe'yi'hu'die	0
制弹器	zhi'dan'qi	0
芝加哥打字机	zhi'jia'ge'da'zi'ji	0
芝加哥研究所	zhi'jia'ge'yan'jiu'suo	0
珠宝	zhu'bao	0
追哥	zhui'ge	0
追追	zhui'zhui	0
追踪者	zhui'zong'zhe	0
紫色的珠宝	zi'se'de'zhu'bao	0
自由之路	zi'you'zhi'lu	0
左手	zuo'shou	0
