电气试验报告	dian'qi'shi'yan'bao'gao	0
工程概况	gong'cheng'gai'kuang	0
工程量明细表	gong'cheng'liang'ming'xi'biao	0
工程质量评估报	gong'cheng'zhi'liang'ping'gu'bao	0
工程质量评估报告	gong'cheng'zhi'liang'ping'gu'bao'gao	0
合同	he'tong	0
结算审核报告	jie'suan'shen'he'bao'gao	0
结算书	jie'suan'shu	0
竣工验收报告	jun'gong'yan'shou'bao'gao	0
竣工验收报审表	jun'gong'yan'shou'bao'shen'biao	0
竣工正式验收报告单	jun'gong'zheng'shi'yan'shou'bao'gao'dan	0
领用核对表	ling'yong'he'dui'biao	0
青赔	qing'pei	0
设计变更	she'ji'bian'geng	0
审核确认	shen'he'que'ren	0
物资审核确认表	wu'zi'shen'he'que'ren'biao	0
验评表	yan'ping'biao	0
验收暨移交生产签证书	yan'shou'ji'yi'jiao'sheng'chan'qian'zheng'shu	0
移交清单	yi'jiao'qing'dan	0
预算书	yu'suan'shu	0
中标通知书	zhong'biao'tong'zhi'shu	0
