暗夜女巫	an'ye'nv'wu	0
爸爸塔	ba'ba'ta	0
白银宝箱	bai'yin'bao'xiang	0
蝙蝠	bian'fu	0
冰冻法术	bing'dong'fa'shu	0
冰法师	bing'fa'shi	0
冰封之巅	bing'feng'zhi'dian	0
冰雪精灵	bing'xue'jing'ling	0
部落宝箱	bu'luo'bao'xiang	0
部落奖杯	bu'luo'jiang'bei	0
部落锦标赛	bu'luo'jin'biao'sai	0
叉连弩	cha'lian'nu	0
叉弩	cha'nu	0
超级骑士	chao'ji'qi'shi	0
超级神奇宝箱	chao'ji'shen'qi'bao'xiang	0
传奇宝箱	chuan'qi'bao'xiang	0
传奇公开赛	chuan'qi'gong'kai'sai	0
传奇竞技场	chuan'qi'jing'ji'chang	0
传奇卡	chuan'qi'ka	0
吹箭哥布林	chui'jian'ge'bu'lin	0
丛林竞技场	cong'lin'jing'ji'chang	0
大骷髅	da'ku'lou	0
大皮卡	da'pi'ka	0
大闪电	da'shan'dian	0
达阵模式	da'zhen'mo'shi	0
刀哥布林	dao'ge'bu'lin	0
地狱飞龙	di'yu'fei'long	0
地狱之塔	di'yu'zhi'ta	0
电磁车	dian'ci'che	0
电磁炮	dian'ci'pao	0
电磁塔	dian'ci'ta	0
电击法师	dian'ji'fa'shi	0
电击法术	dian'ji'fa'shu	0
毒药	du'yao	0
毒药法术	du'yao'fa'shu	0
法师	fa'shi	0
法术幽谷	fa'shu'you'gu	0
飞斧屠夫	fei'fu'tu'fu	0
飞龙	fei'long	0
飞龙宝宝	fei'long'bao'bao	0
飞桶	fei'tong	0
飞行器	fei'xing'qi	0
复仇滚木	fu'chou'gun'mu	0
哥布林	ge'bu'lin	0
哥布林大军	ge'bu'lin'da'jun	0
哥布林飞桶	ge'bu'lin'fei'tong	0
哥布林竞技场	ge'bu'lin'jing'ji'chang	0
哥布林投矛手	ge'bu'lin'tou'mao'shou	0
哥布林小屋	ge'bu'lin'xiao'wu	0
戈仑石人	ge'lun'shi'ren	0
攻城槌	gong'cheng'chui	0
攻城槌挑战赛	gong'cheng'chui'tiao'zhan'sai	0
弓箭手	gong'jian'shou	0
公主	gong'zhu	0
锅炉	guo'lu	0
寒冰戈仑石人	han'bing'ge'lun'shi'ren	0
黑暗王子	hei'an'wang'zi	0
幻影刺客	huan'ying'ci'ke	0
皇冠宝箱	huang'guan'bao'xiang	0
皇冠锦标赛	huang'guan'jin'biao'sai	0
皇家竞技场	huang'jia'jing'ji'chang	0
黄家驹	huang'jia'ju	0
皇家巨人	huang'jia'ju'ren	0
黄金宝箱	huang'jin'bao'xiang	0
火法师	huo'fa'shi	0
火箭	huo'jian	0
火枪手	huo'qiang'shou	0
火球	huo'qiu	0
加农炮	jia'nong'pao	0
加农炮战车	jia'nong'pao'zhan'che	0
箭雨	jian'yu	0
建筑工人工坊	jian'zhu'gong'ren'gong'fang	0
锦标赛	jin'biao'sai	0
镜像	jing'xiang	0
镜像法术	jing'xiang'fa'shu	0
飓风法术	ju'feng'fa'shu	0
巨人	ju'ren	0
巨石投手	ju'shi'tou'shou	0
巨型宝箱	ju'xing'bao'xiang	0
掘地矿工	jue'di'kuang'gong	0
卡组互选模式	ka'zu'hu'xuan'mo'shi	0
克隆法术	ke'long'fa'shu	0
骷髅兵	ku'lou'bing	0
骷髅巨人	ku'lou'ju'ren	0
骷髅军团	ku'lou'jun'tuan	0
骷髅气球	ku'lou'qi'qiu	0
骷髅守卫	ku'lou'shou'wei	0
骷髅召唤	ku'lou'zhao'huan	0
狂暴法术	kuang'bao'fa'shu	0
狂暴樵夫	kuang'bao'qiao'fu	0
矿工	kuang'gong	0
雷电法术	lei'dian'fa'shu	0
烈焰精灵	lie'yan'jing'ling	0
烈焰熔炉	lie'yan'rong'lu	0
埋骨深渊	mai'gu'shen'yuan	0
盲打模式	mang'da'mo'shi	0
矛哥布林	mao'ge'bu'lin	0
迷你皮卡	mi'ni'pi'ka	0
免费宝箱	mian'fei'bao'xiang	0
墓碑	mu'bei	0
木箱	mu'xiang	0
女巫	nv'wu	0
女武神	nv'wu'shen	0
迫击炮	pai'ji'pao	0
胖子	pang'zi	0
皮卡	pi'ka	0
皮卡超人	pi'ka'chao'ren	0
皮卡超人乐园	pi'ka'chao'ren'le'yuan	0
普通卡	pu'tong'ka	0
气球兵	qi'qiu'bing	0
骑士	qi'shi	0
熔炉	rong'lu	0
熔岩猎犬	rong'yan'lie'quan	0
三个火枪手	san'ge'huo'qiang'shou	0
闪电法师挑战赛	shan'dian'fa'shi'tiao'zhan'sai	0
神奇宝箱	shen'qi'bao'xiang	0
圣水收集器	sheng'shui'shou'ji'qi	0
史诗宝箱	shi'shi'bao'xiang	0
史诗卡	shi'shi'ka	0
双倍圣水模式	shuang'bei'sheng'shui'mo'shi	0
双核卡组	shuang'he'ka'zu	0
特斯拉电磁塔	te'si'la'dian'ci'ta	0
天狗	tian'gou	0
瓦基丽武神	wa'ji'li'wu'shen	0
万箭齐发	wan'jian'qi'fa	0
亡灵	wang'ling	0
亡灵军团	wang'ling'jun'tuan	0
王子	wang'zi	0
稀有卡	xi'you'ka	0
小电	xiao'dian	0
小戈仑石人	xiao'ge'lun'shi'ren	0
小骷髅	xiao'ku'lou	0
小熔岩猎犬	xiao'rong'yan'lie'quan	0
小闪电	xiao'shan'dian	0
新手训练营	xin'shou'xun'lian'ying	0
训练营	xun'lian'ying	0
野蛮人	ye'man'ren	0
野蛮人精锐	ye'man'ren'jing'rui	0
野蛮人擂台	ye'man'ren'lei'tai	0
野蛮人小屋	ye'man'ren'xiao'wu	0
野猪	ye'zhu	0
野猪骑士	ye'zhu'qi'shi	0
野猪山脉	ye'zhu'shan'mai	0
友谊战	you'yi'zhan	0
炸弹兵	zha'dan'bing	0
炸弹人	zha'dan'ren	0
炸弹塔	zha'dan'ta	0
重甲亡灵	zhong'jia'wang'ling	0
自定义锦标赛	zi'ding'yi'jin'biao'sai	0
