阿柏怪	a'bai'guai	0
阿柏蛇	a'bai'she	0
阿勃梭鲁	a'bo'suo'lu	0
阿尔宙斯	a'er'zhou'si	0
阿利多斯	a'li'duo'si	0
艾路雷朵	ai'lu'lei'duo	0
艾姆利多	ai'mu'li'duo	0
爱心印章	ai'xin'yin'zhang	0
爱心鱼	ai'xin'yu	0
哎呀球菇	ai'ya'qiu'gu	0
暗黑爆破	an'hei'bao'po	0
暗黑洞	an'hei'dong	0
安瓢虫	an'piao'chong	0
暗袭要害	an'xi'yao'hai	0
暗影潜袭	an'ying'qian'xi	0
暗影球	an'ying'qiu	0
暗影拳	an'ying'quan	0
暗影偷盗	an'ying'tou'dao	0
暗影爪	an'ying'zhao	0
暗影之骨	an'ying'zhi'gu	0
暗影之光	an'ying'zhi'guang	0
傲骨燕	ao'gu'yan	0
巴大蝶	ba'da'die	0
芭瓢虫	ba'piao'chong	0
巴投	ba'tou	0
霸王花	ba'wang'hua	0
百变怪	bai'bian'guai	0
白海狮	bai'hai'shi	0
百合根娃娃	bai'he'gen'wa'wa	0
败露球菇	bai'lu'qiu'gu	0
百万吨重拳	bai'wan'dun'zhong'quan	0
百万吨重踢	bai'wan'dun'zhong'ti	0
白雾	bai'wu	0
百足蜈蚣	bai'zu'wu'gong	0
斑斑马	ban'ban'ma	0
班基拉斯	ban'ji'la'si	0
扮演	ban'yan	0
搬运小匠	ban'yun'xiao'jiang	0
绑紧	bang'jin	0
帮助	bang'zhu	0
宝宝暴龙	bao'bao'bao'long	0
宝宝丁	bao'bao'ding	0
宝包茧	bao'bao'jian	0
宝贝龙	bao'bei'long	0
报仇	bao'chou	0
报恩	bao'en	0
暴飞龙	bao'fei'long	0
暴风	bao'feng	0
暴风雪	bao'feng'xue	0
报复	bao'fu	0
保护色	bao'hu'se	0
爆肌蚊	bao'ji'wen	0
暴鲤龙	bao'li'long	0
爆裂拳	bao'lie'quan	0
保姆虫	bao'mu'chong	0
保姆曼波	bao'mu'man'bo	0
宝石海星	bao'shi'hai'xing	0
爆香猴	bao'xiang'hou	0
爆香猿	bao'xiang'yuan	0
暴雪王	bao'xue'wang	0
爆焰龟兽	bao'yan'gui'shou	0
爆音波	bao'yin'bo	0
爆音怪	bao'yin'guai	0
爆炸烈焰	bao'zha'lie'yan	0
爆炸头水牛	bao'zha'tou'shui'niu	0
爆炸头突击	bao'zha'tou'tu'ji	0
贝壳夹击	bei'ke'jia'ji	0
贝壳刃	bei'ke'ren	0
比比鸟	bi'bi'niao	0
臂锤	bi'chui	0
比克提尼	bi'ke'ti'ni	0
毕力吉翁	bi'li'ji'weng	0
必杀门牙	bi'sha'men'ya	0
变身	bian'shen	0
变小	bian'xiao	0
变隐龙	bian'yin'long	0
变硬	bian'ying	0
变圆	bian'yuan	0
冰宝	bing'bao	0
冰雹	bing'bao	0
冰锤	bing'chui	0
冰冻伏特	bing'dong'fu'te	0
冰冻光束	bing'dong'guang'shu	0
冰冻拳	bing'dong'quan	0
冰冻牙	bing'dong'ya	0
冰冻之风	bing'dong'zhi'feng	0
冰封世界	bing'feng'shi'jie	0
冰鬼护	bing'gui'hu	0
冰砾	bing'li	0
冰球	bing'qiu	0
冰息	bing'xi	0
冰雪巨龙	bing'xue'ju'long	0
冰雪龙	bing'xue'long	0
冰岩怪	bing'yan'guai	0
冰伊布	bing'yi'bu	0
冰柱坠击	bing'zhu'zhui'ji	0
冰锥	bing'zhui	0
波波	bo'bo	0
波导弹	bo'dao'dan	0
波尔凯尼恩	bo'er'kai'ni'en	0
波皇子	bo'huang'zi	0
波加曼	bo'jia'man	0
波克比	bo'ke'bi	0
波克基古	bo'ke'ji'gu	0
波克基斯	bo'ke'ji'si	0
搏命	bo'ming	0
波士可多拉	bo'shi'ke'duo'la	0
薄雾场地	bo'wu'chang'di	0
薄雾球	bo'wu'qiu	0
布里卡隆	bu'li'ka'long	0
不良蛙	bu'liang'wa	0
布鲁	bu'lu	0
布鲁皇	bu'lu'huang	0
步哨鼠	bu'shao'shu	0
彩粉蝶	cai'fen'die	0
踩踏	cai'ta	0
草笛	cao'di	0
草苗龟	cao'miao'gui	0
草之誓约	cao'zhi'shi'yue	0
蹭蹭脸颊	ceng'ceng'lian'jia	0
差不多娃娃	cha'bu'duo'wa'wa	0
查封	cha'feng	0
叉字蝠	cha'zi'fu	0
蟾蜍王	chan'chu'wang	0
缠绕	chan'rao	0
长鼻叶	chang'bi'ye	0
长翅鸥	chang'chi'ou	0
长耳兔	chang'er'tu	0
唱歌	chang'ge	0
长嚎	chang'hao	0
长毛狗	chang'mao'gou	0
长毛猪	chang'mao'zhu	0
长尾怪手	chang'wei'guai'shou	0
长尾火狐	chang'wei'huo'hu	0
朝北鼻	chao'bei'bi	0
炒炒猪	chao'chao'zhu	0
超坏星	chao'huai'xing	0
超级角击	chao'ji'jiao'ji	0
超级水流大漩涡	chao'ji'shui'liu'da'xuan'wo	0
超级吸取	chao'ji'xi'qu	0
超甲狂犀	chao'jia'kuang'xi	0
超绝螺旋连击	chao'jue'luo'xuan'lian'ji	0
超梦	chao'meng	0
吵闹	chao'nao	0
超能妙喵	chao'neng'miao'miao	0
超强极限爆焰弹	chao'qiang'ji'xian'bao'yan'dan	0
潮旋	chao'xuan	0
超音波	chao'yin'bo	0
超音波幼虫	chao'yin'bo'you'chong	0
超音蝠	chao'yin'fu	0
车轮球	che'lun'qiu	0
晨光	chen'guang	0
惩罚	cheng'fa	0
翅膀攻击	chi'bang'gong'ji	0
炽魂热舞烈音爆	chi'hun're'wu'lie'yin'bao	0
齿轮儿	chi'lun'er	0
齿轮飞盘	chi'lun'fei'pan	0
齿轮怪	chi'lun'guai	0
齿轮组	chi'lun'zu	0
赤面龙	chi'mian'long	0
炽焰咆哮虎	chi'yan'pao'xiao'hu	0
虫宝包	chong'bao'bao	0
充电	chong'dian	0
虫电宝	chong'dian'bao	0
充电光束	chong'dian'guang'shu	0
冲浪	chong'lang	0
虫鸣	chong'ming	0
冲天拳	chong'tian'quan	0
冲岩	chong'yan	0
虫咬	chong'yao	0
虫之抵抗	chong'zhi'di'kang	0
铳嘴大鸟	chong'zui'da'niao	0
臭臭花	chou'chou'hua	0
臭臭泥	chou'chou'ni	0
丑丑鱼	chou'chou'yu	0
臭泥	chou'ni	0
臭鼬噗	chou'you'pu	0
出奇一击	chu'qi'yi'ji	0
触手百合	chu'shou'bai'he	0
传递礼物	chuan'di'li'wu	0
穿山鼠	chuan'shan'shu	0
穿山王	chuan'shan'wang	0
穿着熊	chuan'zhe'xiong	0
吹飞	chui'fei	0
吹捧	chui'peng	0
磁场操控	ci'chang'cao'kong	0
刺耳声	ci'er'sheng	0
刺甲贝	ci'jia'bei	0
刺龙王	ci'long'wang	0
刺球仙人掌	ci'qiu'xian'ren'zhang	0
磁铁炸弹	ci'tie'zha'dan	0
刺尾虫	ci'wei'chong	0
催眠粉	cui'mian'fen	0
催眠貘	cui'mian'mo	0
催眠术	cui'mian'shu	0
大爆炸	da'bao'zha	0
大比鸟	da'bi'niao	0
打草结	da'cao'jie	0
大朝北鼻	da'chao'bei'bi	0
大葱鸭	da'cong'ya	0
大地神力	da'di'shen'li	0
大地掌控	da'di'zhang'kong	0
大地之力	da'di'zhi'li	0
大颚蚁	da'e'yi	0
大钢蛇	da'gang'she	0
打嗝	da'ge	0
打鼾	da'han	0
打击鬼	da'ji'gui	0
大剑鬼	da'jian'gui	0
达克莱伊	da'ke'lai'yi	0
大狼犬	da'lang'quan	0
打雷	da'lei	0
大力鳄	da'li'e	0
达摩狒狒	da'mo'fei'fei	0
大奶罐	da'nai'guan	0
大闹一番	da'nao'yi'fan	0
大钳蟹	da'qian'xie	0
大晴天	da'qing'tian	0
大舌贝	da'she'bei	0
大蛇瞪眼	da'she'deng'yan	0
大舌舔	da'she'tian	0
大舌头	da'she'tou	0
大声咆哮	da'sheng'pao'xiao	0
大食花	da'shi'hua	0
大王燕	da'wang'yan	0
大尾狸	da'wei'li	0
大尾立	da'wei'li	0
大牙狸	da'ya'li	0
大岩蛇	da'yan'she	0
大宇怪	da'yu'guai	0
大针蜂	da'zhen'feng	0
大竺葵	da'zhu'kui	0
大字爆炎	da'zi'bao'yan	0
大嘴蝠	da'zui'fu	0
大嘴鸥	da'zui'ou	0
大嘴雀	da'zui'que	0
大嘴娃	da'zui'wa	0
呆呆兽	dai'dai'shou	0
呆呆王	dai'dai'wang	0
呆火驼	dai'huo'tuo	0
呆壳兽	dai'ke'shou	0
代拉基翁	dai'la'ji'weng	0
戴鲁比	dai'lu'bi	0
代欧奇希斯	dai'ou'qi'xi'si	0
袋兽	dai'shou	0
单纯光束	dan'chun'guang'shu	0
蛋蛋	dan'dan	0
单卵细胞球	dan'luan'xi'bao'qiu	0
单首龙	dan'shou'long	0
胆小虫	dan'xiao'chong	0
挡路	dang'lu	0
灯火幽灵	deng'huo'you'ling	0
等离子闪电拳	deng'li'zi'shan'dian'quan	0
等离子浴	deng'li'zi'yu	0
灯笼鱼	deng'long'yu	0
瞪眼	deng'yan	0
灯罩夜菇	deng'zhao'ye'gu	0
蒂安希	di'an'xi	0
第二世代	di'er'shi'dai	0
地裂	di'lie	0
第六世代	di'liu'shi'dai	0
地隆啸天大终结	di'long'xiao'tian'da'zhong'jie	0
地幔岩	di'man'yan	0
第七世代	di'qi'shi'dai	0
地球上投	di'qiu'shang'tou	0
第三世代	di'san'shi'dai	0
地鼠	di'shu	0
第四世代	di'si'shi'dai	0
帝王拿波	di'wang'na'bo	0
第五世代	di'wu'shi'dai	0
帝牙海狮	di'ya'hai'shi	0
帝牙卢卡	di'ya'lu'ka	0
地狱翻滚	di'yu'fan'gun	0
地狱突刺	di'yu'tu'ci	0
地震	di'zhen	0
滴蛛	di'zhu	0
滴蛛霸	di'zhu'ba	0
电磁波	dian'ci'bo	0
电磁炮	dian'ci'pao	0
电磁飘浮	dian'ci'piao'fu	0
颠倒	dian'dao	0
点到为止	dian'dao'wei'zhi	0
电灯怪	dian'deng'guai	0
电电虫	dian'dian'chong	0
电飞鼠	dian'fei'shu	0
电光	dian'guang	0
电光一闪	dian'guang'yi'shan	0
电击	dian'ji	0
电击波	dian'ji'bo	0
电击怪	dian'ji'guai	0
电击魔兽	dian'ji'mo'shou	0
电击兽	dian'ji'shou	0
电龙	dian'long	0
电气场地	dian'qi'chang'di	0
电球	dian'qiu	0
电束木	dian'shu'mu	0
电网	dian'wang	0
点穴	dian'xue	0
电萤虫	dian'ying'chong	0
电蜘蛛	dian'zhi'zhu	0
掉包	diao'bao	0
碉堡	diao'bao	0
喋喋不休	die'die'bu'xiu	0
蝶结萌虻	die'jie'meng'meng	0
蝶舞	die'wu	0
定身法	ding'shen'fa	0
咚咚鼠	dong'dong'shu	0
东施喵	dong'shi'miao	0
冻原熊	dong'yuan'xiong	0
豆豆鸽	dou'dou'ge	0
斗笠菇	dou'li'gu	0
毒贝比	du'bei'bi	0
毒刺水母	du'ci'shui'mu	0
嘟嘟	du'du	0
嘟嘟利	du'du'li	0
毒粉	du'fen	0
毒粉蛾	du'fen'e	0
毒击	du'ji	0
独剑鞘	du'jian'qiao	0
独角虫	du'jiao'chong	0
独角犀牛	du'jiao'xi'niu	0
毒骷蛙	du'ku'wa	0
毒菱	du'ling	0
毒蔷薇	du'qiang'wei	0
毒丝	du'si	0
毒瓦斯	du'wa'si	0
毒尾	du'wei	0
毒液冲击	du'ye'chong'ji	0
毒液陷阱	du'ye'xian'jing	0
毒藻龙	du'zao'long	0
毒针	du'zhen	0
断头钳	duan'tou'qian	0
断崖之剑	duan'ya'zhi'jian	0
顿甲	dun'jia	0
盾甲茧	dun'jia'jian	0
盾甲龙	dun'jia'long	0
多边兽	duo'bian'shou	0
多刺菊石兽	duo'ci'ju'shi'shou	0
多多冰	duo'duo'bing	0
跺脚	duo'jiao	0
多丽米亚	duo'li'mi'ya	0
多属性攻击	duo'shu'xing'gong'ji	0
恶梦	e'meng	0
恶魔之吻	e'mo'zhi'wen	0
恶食大王	e'shi'da'wang	0
恶意追击	e'yi'zhui'ji	0
恶之波动	e'zhi'bo'dong	0
二连击	er'lian'ji	0
二连劈	er'lian'pi	0
二连踢	er'lian'ti	0
发劲	fa'jin	0
饭匙蛇	fan'chi'she	0
烦恼种子	fan'nao'zhong'zi	0
反射壁	fan'she'bi	0
放电	fang'dian	0
防守互换	fang'shou'hu'huan	0
防守平分	fang'shou'ping'fen	0
芳香薄雾	fang'xiang'bo'wu	0
芳香精	fang'xiang'jing	0
芳香治疗	fang'xiang'zhi'liao	0
仿效	fang'xiao	0
防御指令	fang'yu'zhi'ling	0
飞弹针	fei'dan'zhen	0
费洛美螂	fei'luo'mei'lang	0
霏欧纳	fei'ou'na	0
飞身重压	fei'shen'zhong'ya	0
飞水手里剑	fei'shui'shou'li'jian	0
飞踢	fei'ti	0
飞天螳螂	fei'tian'tang'lang	0
飞腿郎	fei'tui'lang	0
飞膝踢	fei'xi'ti	0
飞翔	fei'xiang	0
飞叶风暴	fei'ye'feng'bao	0
飞叶快刀	fei'ye'kuai'dao	0
粉尘	fen'chen	0
分担痛楚	fen'dan'tong'chu	0
粉蝶虫	fen'die'chong	0
粉蝶蛹	fen'die'yong	0
愤怒	fen'nu	0
愤怒粉	fen'nu'fen	0
愤怒门牙	fen'nu'men'ya	0
焚天灭世炽光爆	fen'tian'mie'shi'chi'guang'bao	0
粉香香	fen'xiang'xiang	0
疯狂伏特	feng'kuang'fu'te	0
疯狂滚压	feng'kuang'gun'ya	0
疯狂植物	feng'kuang'zhi'wu	0
风铃铃	feng'ling'ling	0
蜂女王	feng'nv'wang	0
风速狗	feng'su'gou	0
凤王	feng'wang	0
风妖精	feng'yao'jing	0
封印	feng'yin	0
缝影	feng'ying	0
佛烈托斯	fo'lie'tuo'si	0
负电拍拍	fu'dian'pai'pai	0
腹鼓	fu'gu	0
浮潜鼬	fu'qian'you	0
伏特攻击	fu'te'gong'ji	0
伏特替换	fu'te'ti'huan	0
斧牙龙	fu'ya'long	0
辅助齿轮	fu'zhu'chi'lun	0
辅助力量	fu'zhu'li'liang	0
嘎啦嘎啦	ga'la'ga'la	0
盖盖虫	gai'gai'chong	0
盖诺赛克特	gai'nuo'sai'ke'te	0
盖欧卡	gai'ou'ka	0
钢炮臂虾	gang'pao'bi'xia	0
钢翼	gang'yi	0
高傲雉鸡	gao'ao'zhi'ji	0
高科技光炮	gao'ke'ji'guang'pao	0
高速星星	gao'su'xing'xing	0
高速旋转	gao'su'xuan'zhuan	0
高速移动	gao'su'yi'dong	0
高温重压	gao'wen'zhong'ya	0
哥达鸭	ge'da'ya	0
哥德宝宝	ge'de'bao'bao	0
哥德小姐	ge'de'xiao'jie	0
哥德小童	ge'de'xiao'tong	0
根源波动	gen'yuan'bo'dong	0
耕地	geng'di	0
耿鬼	geng'gui	0
功夫鼬	gong'fu'you	0
攻击指令	gong'ji'zhi'ling	0
勾魂眼	gou'hun'yan	0
勾帕路翁	gou'pa'lu'weng	0
骨棒	gu'bang	0
骨棒乱打	gu'bang'luan'da	0
咕咕	gu'gu	0
咕咕鸽	gu'gu'ge	0
古空棘鱼	gu'kong'ji'yu	0
固拉多	gu'la'duo	0
古老之歌	gu'lao'zhi'ge	0
咕妞妞	gu'niu'niu	0
骨头回力镖	gu'tou'hui'li'biao	0
呱呱泡蛙	gua'gua'pao'wa	0
呱头蛙	gua'tou'wa	0
怪颚龙	guai'e'long	0
怪力	guai'li	0
怪异电波	guai'yi'dian'bo	0
光电伞蜥	guang'dian'san'xi	0
光合作用	guang'he'zuo'yong	0
光墙	guang'qiang	0
广域防守	guang'yu'fang'shou	0
光子喷涌	guang'zi'pen'yong	0
鬼火	gui'huo	0
诡计	gui'ji	0
龟脚脚	gui'jiao'jiao	0
鬼面	gui'mian	0
鬼斯	gui'si	0
鬼斯通	gui'si'tong	0
龟足巨铠	gui'zu'ju'kai	0
滚动	gun'dong	0
滚滚蝙蝠	gun'gun'bian'fu	0
过动猿	guo'dong'yuan	0
果然翁	guo'ran'weng	0
过热	guo're	0
聒噪鸟	guo'zao'niao	0
哈克龙	ha'ke'long	0
哈力栗	ha'li'li	0
哈欠	ha'qian	0
哈约克	ha'yue'ke	0
海豹球	hai'bao'qiu	0
海刺龙	hai'ci'long	0
海魔狮	hai'mo'shi	0
海神庄严交响乐	hai'shen'zhuang'yan'jiao'xiang'yue	0
海兔兽	hai'tu'shou	0
海星星	hai'xing'xing	0
含羞苞	han'xiu'bao	0
好坏星	hao'huai'xing	0
好啦鱿	hao'la'you	0
豪力	hao'li	0
号令	hao'ling	0
好胜毛蟹	hao'sheng'mao'xie	0
好胜蟹	hao'sheng'xie	0
赫拉克罗斯	he'la'ke'luo'si	0
河马兽	he'ma'shou	0
和睦相处	he'mu'xiang'chu	0
喝牛奶	he'niu'nai	0
核心惩罚者	he'xin'cheng'fa'zhe	0
黑暗鸦	hei'an'ya	0
黑洞吞噬万物灭	hei'dong'tun'shi'wan'wu'mie	0
黑鲁加	hei'lu'jia	0
黑色目光	hei'se'mu'guang	0
黑雾	hei'wu	0
黑眼鳄	hei'yan'e	0
黑夜魔灵	hei'ye'mo'ling	0
黑夜魔影	hei'ye'mo'ying	0
吼爆弹	hou'bao'dan	0
猴怪	hou'guai	0
吼吼鲸	hou'hou'jing	0
吼叫	hou'jiao	0
吼鲸王	hou'jing'wang	0
护城龙	hu'cheng'long	0
胡地	hu'di	0
壶壶	hu'hu	0
胡帕	hu'pa	0
花瓣舞	hua'ban'wu	0
花蓓蓓	hua'bei'bei	0
花朵加农炮	hua'duo'jia'nong'pao	0
花粉团	hua'fen'tuan	0
滑滑小子	hua'hua'xiao'zi	0
花洁夫人	hua'jie'fu'ren	0
花疗	hua'liao	0
花疗环环	hua'liao'huan'huan	0
画龙点睛	hua'long'dian'jing	0
化石盔	hua'shi'kui	0
化石翼龙	hua'shi'yi'long	0
花舞鸟	hua'wu'niao	0
花岩怪	hua'yan'guai	0
花漾海狮	hua'yang'hai'shi	0
花叶蒂	hua'ye'di	0
花椰猴	hua'ye'hou	0
花椰猿	hua'ye'yuan	0
换挡	huan'dang	0
欢乐时光	huan'le'shi'guang	0
焕然一新	huan'ran'yi'xin	0
幻象光线	huan'xiang'guang'xian	0
唤醒巴掌	huan'xing'ba'zhang	0
晃晃斑	huang'huang'ban	0
灰尘山	hui'chen'shan	0
回复封锁	hui'fu'feng'suo	0
回复指令	hui'fu'zhi'ling	0
回声	hui'sheng	0
回收利用	hui'shou'li'yong	0
毁天灭地巨岩坠	hui'tian'mie'di'ju'yan'zhui	0
彗星拳	hui'xing'quan	0
回旋踢	hui'xuan'ti	0
挥指	hui'zhi	0
混混鳄	hun'hun'e	0
火斑喵	huo'ban'miao	0
火暴猴	huo'bao'hou	0
火暴兽	huo'bao'shou	0
祸不单行	huo'bu'dan'xing	0
火红不倒翁	huo'hong'bu'dao'weng	0
火狐狸	huo'hu'li	0
火花	huo'hua	0
火箭雀	huo'jian'que	0
火箭头锤	huo'jian'tou'chui	0
火恐龙	huo'kong'long	0
火球鼠	huo'qiu'shu	0
火神蛾	huo'shen'e	0
火焰鞭	huo'yan'bian	0
火焰弹	huo'yan'dan	0
火焰鸡	huo'yan'ji	0
火焰轮	huo'yan'lun	0
火焰鸟	huo'yan'niao	0
火焰拳	huo'yan'quan	0
火炎狮	huo'yan'shi	0
火岩鼠	huo'yan'shu	0
火焰踢	huo'yan'ti	0
火焰旋涡	huo'yan'xuan'wo	0
火焰牙	huo'yan'ya	0
火伊布	huo'yi'bu	0
火稚鸡	huo'zhi'ji	0
火之誓约	huo'zhi'shi'yue	0
火之舞	huo'zhi'wu	0
急冻鸟	ji'dong'niao	0
极恶飞跃粉碎击	ji'e'fei'yue'fen'sui'ji	0
基格尔德	ji'ge'er'de	0
极光幕	ji'guang'mu	0
极光束	ji'guang'shu	0
极寒冷焰	ji'han'leng'yan	0
几何雪花	ji'he'xue'hua	0
激狂大地万里冰	ji'kuang'da'di'wan'li'bing	0
基拉祈	ji'la'qi	0
吉利蛋	ji'li'dan	0
击落	ji'luo	0
集沙	ji'sha	0
寄生种子	ji'sheng'zhong'zi	0
极速俯冲轰烈撞	ji'su'fu'chong'hong'lie'zhuang	0
急速折返	ji'su'zhe'fan	0
击掌奇袭	ji'zhang'qi'xi	0
甲贺忍蛙	jia'he'ren'wa	0
假哭	jia'ku	0
驾雷驭电戏冲浪	jia'lei'yu'dian'xi'chong'lang	0
加农光炮	jia'nong'guang'pao	0
加农水炮	jia'nong'shui'pao	0
甲壳茧	jia'qiao'jian	0
甲壳龙	jia'qiao'long	0
夹住	jia'zhu	0
尖刺臂	jian'ci'bi	0
尖刺防守	jian'ci'fang'shou	0
尖刺加农炮	jian'ci'jia'nong'pao	0
坚盾剑怪	jian'dun'jian'guai	0
坚果哑铃	jian'guo'ya'ling	0
健美	jian'mei	0
尖石攻击	jian'shi'gong'ji	0
剑舞	jian'wu	0
尖牙笼	jian'ya'long	0
尖牙陆鲨	jian'ya'lu'sha	0
毽子草	jian'zi'cao	0
毽子花	jian'zi'hua	0
毽子棉	jian'zi'mian	0
交错火焰	jiao'cuo'huo'yan	0
交错闪电	jiao'cuo'shan'dian	0
狡猾天狗	jiao'hua'tian'gou	0
交换场地	jiao'huan'chang'di	0
绞紧	jiao'jin	0
角金鱼	jiao'jin'yu	0
叫声	jiao'sheng	0
角撞	jiao'zhuang	0
角钻	jiao'zuan	0
接棒	jie'bang	0
结草儿	jie'cao'er	0
结草贵妇	jie'cao'gui'fu	0
洁净光芒	jie'jing'guang'mang	0
捷克罗姆	jie'ke'luo'mu	0
捷拉奥拉	jie'la'ao'la	0
借力摔	jie'li'shuai	0
杰尼龟	jie'ni'gui	0
借助	jie'zhu	0
金勾臂	jin'gou'bi	0
近身战	jin'shen'zhan	0
紧束	jin'shu	0
金属爆炸	jin'shu'bao'zha	0
金属怪	jin'shu'guai	0
金属音	jin'shu'yin	0
金属爪	jin'shu'zhao	0
浸水	jin'shui	0
金鱼王	jin'yu'wang	0
惊爆大头	jing'bao'da'tou	0
镜光射击	jing'guang'she'ji	0
净化	jing'hua	0
惊角鹿	jing'jiao'lu	0
镜面反射	jing'mian'fan'she	0
镜面属性	jing'mian'shu'xing	0
精神波	jing'shen'bo	0
精神场地	jing'shen'chang'di	0
精神冲击	jing'shen'chong'ji	0
精神击破	jing'shen'ji'po	0
精神利刃	jing'shen'li'ren	0
精神强念	jing'shen'qiang'nian	0
精神突进	jing'shen'tu'jin	0
精神之牙	jing'shen'zhi'ya	0
精神转移	jing'shen'zhuan'yi	0
惊吓	jing'xia	0
九彩昇华齐聚顶	jiu'cai'sheng'hua'qi'ju'ding	0
究极巨龙震天地	jiu'ji'ju'long'zhen'tian'di	0
究极无敌大冲撞	jiu'ji'wu'di'da'chong'zhuang	0
九尾	jiu'wei	0
聚宝功	ju'bao'gong	0
菊草叶	ju'cao'ye	0
巨翅飞鱼	ju'chi'fei'yu	0
驹刀小兵	ju'dao'xiao'bing	0
剧毒	ju'du	0
剧毒牙	ju'du'ya	0
聚光灯	ju'guang'deng	0
居合斩	ju'he'zhan	0
具甲武者	ju'jia'wu'zhe	0
巨金怪	ju'jin'guai	0
巨蔓藤	ju'man'teng	0
聚气	ju'qi	0
巨钳螳螂	ju'qian'tang'lang	0
巨钳蟹	ju'qian'xie	0
巨人卫士阿罗拉	ju'ren'wei'shi'a'luo'la	0
狙射树枭	ju'she'shu'xiao	0
巨声	ju'sheng	0
菊石兽	ju'shi'shou	0
巨牙鲨	ju'ya'sha	0
巨沼怪	ju'zhao'guai	0
卷卷耳	juan'juan'er	0
掘地兔	jue'di'tu	0
绝对捕食回旋斩	jue'dui'bu'shi'hui'xuan'zhan	0
绝对零度	jue'dui'ling'du	0
掘掘兔	jue'jue'tu	0
觉醒力量	jue'xing'li'liang	0
觉醒之舞	jue'xing'zhi'wu	0
君主蛇	jun'zhu'she	0
卡比兽	ka'bi'shou	0
卡蒂狗	ka'di'gou	0
卡拉卡拉	ka'la'ka'la	0
卡咪龟	ka'mi'gui	0
卡璞蝶蝶	ka'pu'die'die	0
卡璞鸣鸣	ka'pu'ming'ming	0
卡璞哞哞	ka'pu'mou'mou	0
卡璞鳍鳍	ka'pu'qi'qi	0
凯路迪欧	kai'lu'di'ou	0
凯罗斯	kai'luo'si	0
凯西	kai'xi	0
看穿	kan'chuan	0
看我嘛	kan'wo'ma	0
可爱星星飞天撞	ke'ai'xing'xing'fei'tian'zhuang	0
可达鸭	ke'da'ya	0
可多拉	ke'duo'la	0
可可多拉	ke'ke'duo'la	0
克雷色利亚	ke'lei'se'li'ya	0
科斯莫古	ke'si'mo'gu	0
科斯莫姆	ke'si'mo'mu	0
渴望	ke'wang	0
肯泰罗	ken'tai'luo	0
空气利刃	kong'qi'li'ren	0
空气斩	kong'qi'zhan	0
空手劈	kong'shou'pi	0
口呆花	kou'dai'hua	0
酷豹	ku'bao	0
哭哭面具	ku'ku'mian'ju	0
快龙	kuai'long	0
快拳郎	kuai'quan'lang	0
快速防守	kuai'su'fang'shou	0
狂舞挥打	kuang'wu'hui'da	0
盔甲鸟	kui'jia'niao	0
喇叭芽	la'ba'ya	0
喇叭啄鸟	la'ba'zhuo'niao	0
拉达	la'da	0
拉帝欧斯	la'di'ou'si	0
拉帝亚斯	la'di'ya'si	0
垃圾射击	la'ji'she'ji	0
垃垃藻	la'la'zao	0
拉鲁拉丝	la'lu'la'si	0
拉普拉斯	la'pu'la'si	0
莱希拉姆	lai'xi'la'mu	0
蓝蟾蜍	lan'chan'chu	0
蓝鳄	lan'e	0
懒人獭	lan'ren'ta	0
兰螳花	lan'tang'hua	0
狼啸石牙飓风暴	lang'xiao'shi'ya'ju'feng'bao	0
老翁龙	lao'weng'long	0
勒克猫	le'ke'mao	0
乐天河童	le'tian'he'tong	0
雷电斑马	lei'dian'ban'ma	0
雷电拳	lei'dian'quan	0
雷电兽	lei'dian'shou	0
雷电牙	lei'dian'ya	0
雷电云	lei'dian'yun	0
雷公	lei'gong	0
肋骨海龟	lei'gu'hai'gui	0
雷击	lei'ji	0
雷吉艾斯	lei'ji'ai'si	0
雷吉洛克	lei'ji'luo'ke	0
雷吉奇卡斯	lei'ji'qi'ka'si	0
雷吉斯奇鲁	lei'ji'si'qi'lu	0
垒磊石	lei'lei'shi	0
雷丘	lei'qiu	0
泪眼汪汪	lei'yan'wang'wang	0
雷伊布	lei'yi'bu	0
冷冻干燥	leng'dong'gan'zao	0
棱角化	leng'jiao'hua	0
棱镜镭射	leng'jing'lei'she	0
冷水猴	leng'shui'hou	0
冷水猿	leng'shui'yuan	0
力量宝石	li'liang'bao'shi	0
力量互换	li'liang'hu'huan	0
力量平分	li'liang'ping'fen	0
力量戏法	li'liang'xi'fa	0
利欧路	li'ou'lu	0
礼物	li'wu	0
利牙鱼	li'ya'yu	0
鲤鱼王	li'yu'wang	0
力壮鸡	li'zhuang'ji	0
镰刀盔	lian'dao'kui	0
连环巴掌	lian'huan'ba'zhang	0
莲帽小童	lian'mao'xiao'tong	0
连续拳	lian'xu'quan	0
莲叶童子	lian'ye'tong'zi	0
炼狱	lian'yu	0
连斩	lian'zhan	0
猎斑鱼	lie'ban'yu	0
烈箭鹰	lie'jian'ying	0
烈空坐	lie'kong'zuo	0
烈雀	lie'que	0
烈焰猴	lie'yan'hou	0
烈焰溅射	lie'yan'jian'she	0
烈焰马	lie'yan'ma	0
烈咬陆鲨	lie'yao'lu'sha	0
临别礼物	lin'bie'li'wu	0
鳞甲龙	lin'jia'long	0
鳞片噪音	lin'pian'zao'yin	0
铃铛响	ling'dang'xiang	0
溜溜糖球	liu'liu'tang'qiu	0
流氓鳄	liu'mang'e	0
流氓熊猫	liu'mang'xiong'mao	0
流沙地狱	liu'sha'di'yu	0
六尾	liu'wei	0
流星群	liu'xing'qun	0
流星闪冲	liu'xing'shan'chong	0
龙锤	long'chui	0
龙卷风	long'juan'feng	0
龙卷云	long'juan'yun	0
隆隆石	long'long'shi	0
隆隆岩	long'long'yan	0
龙头地鼠	long'tou'di'shu	0
龙王蝎	long'wang'xie	0
龙尾	long'wei	0
龙息	long'xi	0
龙虾小兵	long'xia'xiao'bing	0
龙之波动	long'zhi'bo'dong	0
龙之俯冲	long'zhi'fu'chong	0
龙之怒	long'zhi'nu	0
龙之舞	long'zhi'wu	0
龙爪	long'zhua	0
路卡利欧	lu'ka'li'ou	0
露力丽	lu'li'li	0
露奈雅拉	lu'nai'ya'la	0
乱击	luan'ji	0
乱抓	luan'zhua	0
轮唱	lun'chang	0
伦琴猫	lun'qin'mao	0
螺钉地鼠	luo'ding'di'shu	0
落雷兽	luo'lei'shou	0
洛奇亚	luo'qi'ya	0
落石	luo'shi	0
罗丝雷朵	luo'si'lei'duo	0
洛托姆	luo'tuo'mu	0
落英缤纷	luo'ying'bin'fen	0
绿毛虫	lv'mao'chong	0
麻痹粉	ma'bi'fen	0
玛机雅娜	ma'ji'ya'na	0
玛力露	ma'li'lu	0
玛力露丽	ma'li'lu'li	0
麻麻刺刺	ma'ma'ci'ci	0
麻麻鳗	ma'ma'man	0
麻麻鳗鱼王	ma'ma'man'yu'wang	0
麻麻小鱼	ma'ma'xiao'yu	0
玛纳霏	ma'na'fei	0
玛瑙水母	ma'nao'shui'mu	0
玛狃拉	ma'niu'la	0
玛沙那	ma'sha'na	0
玛夏多	ma'xia'duo	0
蛮干	man'gan	0
蛮力	man'li	0
蔓藤怪	man'teng'guai	0
猫老大	mao'lao'da	0
毛球	mao'qiu	0
毛头小鹰	mao'tou'xiao'ying	0
猫头夜鹰	mao'tou'ye'ying	0
猫鼬少	mao'you'shao	0
猫鼬探长	mao'you'tan'zhang	0
猫鼬斩	mao'you'zhan	0
魅惑之声	mei'huo'zhi'sheng	0
美丽花	mei'li'hua	0
魅力喵	mei'li'miao	0
美洛耶塔	mei'luo'ye'ta	0
美纳斯	mei'na'si	0
煤炭龟	mei'tan'gui	0
梦歌仙人掌	meng'ge'xian'ren'zhang	0
梦话	meng'hua	0
梦幻	meng'huan	0
猛火猴	meng'huo'hou	0
萌虻	meng'meng	0
梦梦蚀	meng'meng'shi	0
猛扑	meng'pu	0
猛推	meng'tui	0
萌芽鹿	meng'ya'lu	0
梦妖	meng'yao	0
梦妖魔	meng'yao'mo	0
猛撞	meng'zhuang	0
迷唇姐	mi'chun'jie	0
迷唇娃	mi'chun'wa	0
迷昏拳	mi'hun'quan	0
秘密之力	mi'mi'zhi'li	0
谜拟	mi'ni	0
迷你冰	mi'ni'bing	0
迷你龙	mi'ni'long	0
迷人	mi'ren	0
密语	mi'yu	0
棉孢子	mian'bao'zi	0
棉花防守	mian'hua'fang'shou	0
绵绵泡芙	mian'mian'pao'fu	0
喵喵	miao'miao	0
妙喵	miao'miao	0
妙蛙草	miao'wa'cao	0
妙蛙花	miao'wa'hua	0
妙蛙种子	miao'wa'zhong'zi	0
咩利羊	mie'li'yang	0
灭亡之歌	mie'wang'zhi'ge	0
敏捷虫	min'jie'chong	0
冥想	ming'xiang	0
魔法反射	mo'fa'fan'she	0
魔法火焰	mo'fa'huo'yan	0
魔法空间	mo'fa'kong'jian	0
魔法闪耀	mo'fa'shan'yao	0
魔法叶	mo'fa'ye	0
模仿	mo'fang	0
蘑菇孢子	mo'gu'bao'zi	0
墨海马	mo'hai'ma	0
磨砺	mo'li	0
摩鲁蛾	mo'lu'e	0
蘑蘑菇	mo'mo'gu	0
魔尼尼	mo'ni'ni	0
魔墙人偶	mo'qiang'ren'ou	0
磨牙彩皮鱼	mo'ya'cai'pi'yu	0
磨爪	mo'zhao	0
木槌	mu'chui	0
木角	mu'jiao	0
姆克儿	mu'ke'er	0
姆克鸟	mu'ke'niao	0
姆克鹰	mu'ke'ying	0
木棉球	mu'mian'qiu	0
木木枭	mu'mu'xiao	0
木守宫	mu'shou'gong	0
幕下力士	mu'xia'li'shi	0
奈克洛兹玛	nai'ke'luo'zi'ma	0
南瓜怪人	nan'gua'guai'ren	0
南瓜精	nan'gua'jing	0
挠痒	nao'yang	0
能量球	neng'liang'qiu	0
泥巴射击	ni'ba'she'ji	0
泥巴鱼	ni'ba'yu	0
泥巴炸弹	ni'ba'zha'dan	0
尼多后	ni'duo'hou	0
尼多兰	ni'duo'lan	0
尼多朗	ni'duo'lang	0
尼多力诺	ni'duo'li'nuo	0
尼多娜	ni'duo'na	0
尼多王	ni'duo'wang	0
霓虹鱼	ni'hong'yu	0
逆鳞	ni'lin	0
泥驴仔	ni'lv'zai	0
泥泥鳅	ni'ni'qiu	0
泥偶巨人	ni'ou'ju'ren	0
泥偶小人	ni'ou'xiao'ren	0
念力	nian'li	0
念力土偶	nian'li'tu'ou	0
黏美儿	nian'mei'er	0
黏美龙	nian'mei'long	0
黏黏宝	nian'nian'bao	0
黏黏网	nian'nian'wang	0
鲶鱼王	nian'yu'wang	0
鸟嘴加农炮	niao'zui'jia'nong'pao	0
捏碎	nie'sui	0
您先请	nin'xian'qing	0
狃拉	niu'la	0
暖暖猪	nuan'nuan'zhu	0
帕路奇亚	pa'lu'qi'ya	0
帕奇利兹	pa'qi'li'zi	0
扒手猫	pa'shou'mao	0
拍击	pai'ji	0
派拉斯	pai'la'si	0
派拉斯特	pai'la'si'te	0
拍落	pai'luo	0
攀瀑	pan'pu	0
盘蜷	pan'quan	0
攀岩	pan'yan	0
胖丁	pang'ding	0
胖嘟嘟	pang'du'du	0
彷徨夜灵	pang'huang'ye'ling	0
胖可丁	pang'ke'ding	0
胖胖哈力	pang'pang'ha'li	0
胖甜妮	pang'tian'ni	0
庞岩怪	pang'yan'guai	0
泡沫	pao'mo	0
泡沫光线	pao'mo'guang'xian	0
泡沫栗鼠	pao'mo'li'shu	0
抛物面充电	pao'wu'mian'chong'dian	0
抛下狠话	pao'xia'hen'hua	0
泡影的咏叹调	pao'ying'de'yong'tan'diao	0
盆才怪	pen'cai'guai	0
喷出	pen'chu	0
喷火	pen'huo	0
喷火龙	pen'huo'long	0
喷火驼	pen'huo'tuo	0
喷射火焰	pen'she'huo'yan	0
喷水	pen'shui	0
喷嚏熊	pen'ti'xiong	0
喷烟	pen'yan	0
砰头小丑	peng'tou'xiao'chou	0
皮宝宝	pi'bao'bao	0
皮卡皮卡必杀击	pi'ka'pi'ka'bi'sha'ji	0
皮卡丘	pi'ka'qiu	0
劈开	pi'kai	0
皮可西	pi'ke'xi	0
霹雳电球	pi'li'dian'qiu	0
皮皮	pi'pi	0
皮丘	pi'qiu	0
劈瓦	pi'wa	0
劈斩司令	pi'zhan'si'ling	0
飘浮泡泡	piao'fu'pao'pao	0
飘飘球	piao'piao'qiu	0
屏障	ping'zhang	0
破坏光线	po'huai'guang'xian	0
破壳	po'ke	0
破灭之光	po'mie'zhi'guang	0
破灭之愿	po'mie'zhi'yuan	0
破破袋	po'po'dai	0
破破舵轮	po'po'duo'lun	0
泼沙	po'sha	0
噗噗猪	pu'pu'zhu	0
起风	qi'feng	0
奇迹之眼	qi'ji'zhi'yan	0
骑拉帝纳	qi'la'di'na	0
麒麟奇	qi'lin'qi	0
奇鲁莉安	qi'lu'li'an	0
奇妙空间	qi'miao'kong'jian	0
奇诺栗鼠	qi'nuo'li'shu	0
骑士蜗牛	qi'shi'wo'niu	0
起死回生	qi'si'hui'sheng	0
气味侦测	qi'wei'zhen'ce	0
七夕青鸟	qi'xi'qing'niao	0
气象球	qi'xiang'qiu	0
七星夺魂腿	qi'xing'duo'hun'tui	0
气旋攻击	qi'xuan'gong'ji	0
奇异之风	qi'yi'zhi'feng	0
奇异之光	qi'yi'zhi'guang	0
祈愿	qi'yuan	0
起源超新星大爆炸	qi'yuan'chao'xin'xing'da'bao'zha	0
欺诈	qi'zha	0
恰雷姆	qia'lei'mu	0
千波激荡	qian'bo'ji'dang	0
千箭齐发	qian'jian'qi'fa	0
潜灵奇袭	qian'ling'qi'xi	0
迁怒	qian'nu	0
牵手	qian'shou	0
潜水	qian'shui	0
千万伏特	qian'wan'fu'te	0
钳尾蝎	qian'wei'xie	0
千针鱼	qian'zhen'yu	0
抢夺	qiang'duo	0
强颚鸡母虫	qiang'e'ji'mu'chong	0
强力鞭打	qiang'li'bian'da	0
强酸剧毒灭绝雨	qiang'suan'ju'du'mie'jue'yu	0
抢先一步	qiang'xian'yi'bu	0
锹农炮虫	qiao'nong'pao'chong	0
亲密无间大乱揍	qin'mi'wu'jian'da'luan'zou	0
青草场地	qing'cao'chang'di	0
青草搅拌器	qing'cao'jiao'ban'qi	0
清除浓雾	qing'chu'nong'wu	0
清除之烟	qing'chu'zhi'yan	0
请假王	qing'jia'wang	0
青绵鸟	qing'mian'niao	0
轻飘飘	qing'piao'piao	0
蜻蜻蜓	qing'qing'ting	0
青藤蛇	qing'teng'she	0
青铜钟	qing'tong'zhong	0
清醒	qing'xing	0
青焰	qing'yan	0
庆祝	qing'zhu	0
酋雷姆	qiu'lei'mu	0
球球海狮	qiu'qiu'hai'shi	0
求雨	qiu'yu	0
拳海参	quan'hai'shen	0
全力无双激烈拳	quan'li'wu'shuang'ji'lie'quan	0
圈圈熊	quan'quan'xiong	0
裙儿小姐	qun'er'xiao'jie	0
燃尽	ran'jin	0
燃烧虫	ran'shao'chong	0
热带龙	re'dai'long	0
热带踢	re'dai'ti	0
热风	re'feng	0
热水	re'shui	0
热焰	re'yan	0
忍耐	ren'nai	0
人造细胞卵	ren'zao'xi'bao'luan	0
认真起来大爆击	ren'zhen'qi'lai'da'bao'ji	0
日光回旋下苍穹	ri'guang'hui'xuan'xia'cang'qiong	0
日光刃	ri'guang'ren	0
日光束	ri'guang'shu	0
溶化	rong'hua	0
溶解液	rong'jie'ye	0
茸茸羊	rong'rong'yang	0
溶食兽	rong'shi'shou	0
熔岩虫	rong'yan'chong	0
熔岩风暴	rong'yan'feng'bao	0
熔岩蜗牛	rong'yan'wo'niu	0
熔蚁兽	rong'yi'shou	0
弱丁鱼	ruo'ding'yu	0
撒娇	sa'jiao	0
撒菱	sa'ling	0
三重攻击	san'chong'gong'ji	0
三地鼠	san'di'shu	0
伞电蜥	san'dian'xi	0
三合一磁怪	san'he'yi'ci'guai	0
三连踢	san'lian'ti	0
三蜜蜂	san'mi'feng	0
三首恶龙	san'shou'e'long	0
扫尾拍打	sao'wei'pai'da	0
森林蜥蜴	sen'lin'xi'yi	0
森林诅咒	sen'lin'zu'zhou	0
沙暴	sha'bao	0
沙河马	sha'he'ma	0
沙基拉斯	sha'ji'la'si	0
沙铃仙人掌	sha'ling'xian'ren'zhang	0
沙漠蜻蜓	sha'mo'qing'ting	0
沙奈朵	sha'nai'duo	0
沙丘娃	sha'qiu'wa	0
闪电鸟	shan'dian'niao	0
闪光	shan'guang	0
山岚摔	shan'lan'shuai	0
闪焰冲锋	shan'yan'chong'feng	0
烧尽	shao'jin	0
舍身冲撞	she'shen'chong'zhuang	0
舌舔	she'tian	0
蛇纹熊	she'wen'xiong	0
神秘守护	shen'mi'shou'hu	0
神秘之剑	shen'mi'zhi'jian	0
神鸟猛击	shen'niao'meng'ji	0
神圣之火	shen'sheng'zhi'huo	0
绅士蛾	shen'shi'e	0
神速	shen'su	0
身体轻量化	shen'ti'qing'liang'hua	0
神通力	shen'tong'li	0
生蛋	sheng'dan	0
圣剑	sheng'jian	0
生长	sheng'zhang	0
师父鼬	shi'fu'you	0
时光咆哮	shi'guang'pao'xiao	0
石居蟹	shi'ju'xie	0
时拉比	shi'la'bi	0
食梦	shi'meng	0
食梦梦	shi'meng'meng	0
识破	shi'po	0
噬沙堡爷	shi'sha'bao'ye	0
十万伏特	shi'wan'fu'te	0
十万马力	shi'wan'ma'li	0
石丸子	shi'wan'zi	0
十字毒刃	shi'zi'du'ren	0
十字剪	shi'zi'jian	0
十字劈	shi'zi'pi	0
始祖大鸟	shi'zu'da'niao	0
始祖小鸟	shi'zu'xiao'niao	0
狩猎凤蝶	shou'lie'feng'die	0
手下留情	shou'xia'liu'qing	0
守住	shou'zhu	0
树才怪	shu'cai'guai	0
输电	shu'dian	0
树林龟	shu'lin'gui	0
属性空	shu'xing'kong	0
树叶	shu'ye	0
树枕尾熊	shu'zhen'wei'xiong	0
摔打	shuai'da	0
摔角鹰人	shuai'jiao'ying'ren	0
双倍多多冰	shuang'bei'duo'duo'bing	0
双倍奉还	shuang'bei'feng'huan	0
双弹瓦斯	shuang'dan'wa'si	0
双斧战龙	shuang'fu'zhan'long	0
双剑鞘	shuang'jian'qiao	0
双卵细胞球	shuang'luan'xi'bao'qiu	0
双刃头锤	shuang'ren'tou'chui	0
双刃丸	shuang'ren'wan	0
双首暴龙	shuang'shou'bao'long	0
双尾怪手	shuang'wei'guai'shou	0
双针	shuang'zhen	0
水箭龟	shui'jian'gui	0
睡觉	shui'jiao	0
水晶灯火灵	shui'jing'deng'huo'ling	0
水君	shui'jun	0
水流环	shui'liu'huan	0
水流裂破	shui'liu'lie'po	0
水流喷射	shui'liu'pen'she	0
水流尾	shui'liu'wei	0
水炮	shui'pao	0
水枪	shui'qiang	0
睡睡菇	shui'shui'gu	0
水水獭	shui'shui'ta	0
水伊布	shui'yi'bu	0
水跃鱼	shui'yue'yu	0
水之波动	shui'zhi'bo'dong	0
水之誓约	shui'zhi'shi'yue	0
顺风	shun'feng	0
瞬间失忆	shun'jian'shi'yi	0
瞬间移动	shun'jian'yi'dong	0
死缠烂打	si'chan'lan'da	0
四顎针龙	si'e'zhen'long	0
四季鹿	si'ji'lu	0
撕裂爪	si'lie'zhao	0
死神棺	si'shen'guan	0
死亡之翼	si'wang'zhi'yi	0
速度互换	su'du'hu'huan	0
酸液炸弹	suan'ye'zha'dan	0
随风球	sui'feng'qiu	0
碎岩	sui'yan	0
锁定	suo'ding	0
索尔迦雷欧	suo'er'jia'lei'ou	0
索罗亚	suo'luo'ya	0
索罗亚克	suo'luo'ya'ke	0
缩入壳中	suo'ru'ke'zhong	0
太古盔甲	tai'gu'kui'jia	0
太古羽虫	tai'gu'yu'chong	0
泰山压顶	tai'shan'ya'ding	0
太阳珊瑚	tai'yang'shan'hu	0
太阳岩	tai'yang'yan	0
太阳伊布	tai'yang'yi'bu	0
坦克臭鼬	tan'ke'chou'you	0
探探鼠	tan'tan'shu	0
弹跳	tan'tiao	0
特性互换	te'xing'hu'huan	0
藤鞭	teng'bian	0
藤藤蛇	teng'teng'she	0
踢倒	ti'dao	0
替身	ti'shen	0
天秤偶	tian'cheng'ou	0
甜冷美后	tian'leng'mei'hou	0
天然鸟	tian'ran'niao	0
天然雀	tian'ran'que	0
天使之吻	tian'shi'zhi'wen	0
甜甜香气	tian'tian'xiang'qi	0
甜甜萤	tian'tian'ying	0
甜舞妮	tian'wu'ni	0
天蝎	tian'xie	0
天蝎王	tian'xie'wang	0
甜竹竹	tian'zhu'zhu	0
跳跳猪	tiao'tiao'zhu	0
挑衅	tiao'xin	0
铁螯龙虾	tie'ao'long'xia	0
铁壁	tie'bi	0
铁臂枪虾	tie'bi'qiang'xia	0
铁骨土人	tie'gu'tu'ren	0
铁火辉夜	tie'huo'hui'ye	0
铁甲蛹	tie'jia'yong	0
铁壳蛹	tie'ke'yong	0
铁面忍者	tie'mian'ren'zhe	0
铁炮鱼	tie'pao'yu	0
铁头	tie'tou	0
铁尾	tie'wei	0
铁哑铃	tie'ya'ling	0
铁蚁	tie'yi	0
铁掌力士	tie'zhang'li'shi	0
挺住	ting'zhu	0
同步干扰	tong'bu'gan'rao	0
铜镜怪	tong'jing'guai	0
同命	tong'ming	0
童偶熊	tong'ou'xiong	0
头锤	tou'chui	0
头盖龙	tou'gai'long	0
头巾混混	tou'jin'hun'hun	0
偷懒	tou'lan	0
投球	tou'qiu	0
投摔鬼	tou'shuai'gui	0
投羽枭	tou'yu'xiao	0
投掷	tou'zhi	0
投掷猴	tou'zhi'hou	0
土地云	tu'di'yun	0
土居忍士	tu'ju'ren'shi	0
土狼犬	tu'lang'quan	0
土龙弟弟	tu'long'di'di	0
吐丝	tu'si	0
土台龟	tu'tai'gui	0
图图犬	tu'tu'quan	0
突袭	tu'xi	0
秃鹰娜	tu'ying'na	0
秃鹰丫头	tu'ying'ya'tou	0
吞食兽	tun'shi'shou	0
吞下	tun'xia	0
托戈德玛尔	tuo'ge'de'ma'er	0
陀螺球	tuo'luo'qiu	0
脱壳忍者	tuo'qiao'ren'zhe	0
挖洞	wa'dong	0
瓦斯弹	wa'si'dan	0
腕力	wan'li	0
玩泥巴	wan'ni'ba	0
顽皮雷弹	wan'pi'lei'dan	0
顽皮熊猫	wan'pi'xiong'mao	0
万圣夜	wan'sheng'ye	0
玩水	wan'shui	0
王牌	wang'pai	0
王者盾牌	wang'zhe'dun'pai	0
围攻	wei'gong	0
尾立	wei'li	0
伪螳草	wei'tang'cao	0
胃液	wei'ye	0
未知图腾	wei'zhi'tu'teng	0
纹理	wen'li	0
蚊香君	wen'xiang'jun	0
蚊香蝌蚪	wen'xiang'ke'dou	0
蚊香蛙皇	wen'xiang'wa'huang	0
蚊香泳士	wen'xiang'yong'shi	0
嗡蝠	weng'fu	0
乌波	wu'bo	0
蜈蚣王	wu'gong'wang	0
无尽暗夜之诱惑	wu'jin'an'ye'zhi'you'huo	0
无壳海兔	wu'ke'hai'tu	0
无理取闹	wu'li'qu'nao	0
污泥波	wu'ni'bo	0
污泥攻击	wu'ni'gong'ji	0
污泥炸弹	wu'ni'zha'dan	0
舞天鹅	wu'tian'e	0
无畏小子	wu'wei'xiao'zi	0
乌鸦头头	wu'ya'tou'tou	0
乌贼王	wu'zei'wang	0
席多蓝恩	xi'duo'lan'en	0
戏法	xi'fa	0
戏法防守	xi'fa'fang'shou	0
戏法空间	xi'fa'kong'jian	0
嬉闹	xi'nao	0
吸取	xi'qu	0
吸取力量	xi'qu'li'liang	0
吸取拳	xi'qu'quan	0
吸取之吻	xi'qu'zhi'wen	0
西狮海壬	xi'shi'hai'ren	0
吸血	xi'xue	0
细雪	xi'xue	0
蜥蜴王	xi'yi'wang	0
下盘踢	xia'pan'ti	0
鲜花防守	xian'hua'fang'shou	0
陷阱甲壳	xian'jing'jia'qiao	0
掀榻榻米	xian'ta'ta'mi	0
仙子伊布	xian'zi'yi'bu	0
向日花怪	xiang'ri'hua'guai	0
向日种子	xiang'ri'zhong'zi	0
橡实果	xiang'shi'guo	0
向尾喵	xiang'wei'miao	0
象牙猪	xiang'ya'zhu	0
象征鸟	xiang'zheng'niao	0
小磁怪	xiao'ci'guai	0
小笃儿	xiao'du'er	0
小福蛋	xiao'fu'dan	0
小果然	xiao'guo'ran	0
小海狮	xiao'hai'shi	0
小灰怪	xiao'hui'guai	0
小火龙	xiao'huo'long	0
小火马	xiao'huo'ma	0
小火焰猴	xiao'huo'yan'hou	0
小箭雀	xiao'jian'que	0
小锯鳄	xiao'ju'e	0
小卡比兽	xiao'ka'bi'shou	0
小拉达	xiao'la'da	0
小猫怪	xiao'mao'guai	0
小木灵	xiao'mu'ling	0
小球飞鱼	xiao'qiu'fei'yu	0
小拳石	xiao'quan'shi	0
小山猪	xiao'shan'zhu	0
小狮狮	xiao'shi'shi	0
小碎钻	xiao'sui'zuan	0
小偷	xiao'tou	0
小小象	xiao'xiao'xiang	0
小约克	xiao'yue'ke	0
小陨星	xiao'yun'xing	0
嚣张	xiao'zhang	0
小嘴蜗	xiao'zui'wo	0
谢米	xie'mi	0
蟹钳锤	xie'qian'chui	0
写生	xie'sheng	0
心蝙蝠	xin'bian'fu	0
信号光束	xin'hao'guang'shu	0
心鳞宝	xin'lin'bao	0
心灵互换	xin'ling'hu'huan	0
信使鸟	xin'shi'niao	0
新月舞	xin'yue'wu	0
心之眼	xin'zhi'yan	0
幸福蛋	xing'fu'dan	0
幸运咒语	xing'yun'zhou'yu	0
熊宝宝	xiong'bao'bao	0
修长之角	xiu'chang'zhi'jiao	0
修建老匠	xiu'jian'lao'jiang	0
朽木妖	xiu'mu'yao	0
蓄力	xu'li	0
蓄能焰袭	xu'neng'yan'xi	0
虚吾伊德	xu'wu'yi'de	0
虚张声势	xu'zhang'sheng'shi	0
旋风刀	xuan'feng'dao	0
绚烂缤纷花怒放	xuan'lan'bin'fen'hua'nu'fang	0
雪崩	xue'beng	0
雪笠怪	xue'li'guai	0
雪童子	xue'tong'zi	0
雪妖女	xue'yao'nv	0
鸭宝宝	ya'bao'bao	0
亚克诺姆	ya'ke'nuo'mu	0
亚空裂斩	ya'kong'lie'zhan	0
牙牙	ya'ya	0
鸭嘴宝宝	ya'zui'bao'bao	0
鸭嘴火兽	ya'zui'huo'shou	0
鸭嘴炎兽	ya'zui'yan'shou	0
岩崩	yan'beng	0
炎帝	yan'di	0
岩殿居蟹	yan'dian'ju'xie	0
燕返	yan'fan	0
岩狗狗	yan'gou'gou	0
延后	yan'hou	0
焰后蜥	yan'hou'xi	0
烟幕	yan'mu	0
炎热喵	yan're'miao	0
岩石爆击	yan'shi'bao'ji	0
岩石打磨	yan'shi'da'mo	0
岩石封锁	yan'shi'feng'suo	0
岩石炮	yan'shi'pao	0
盐水	yan'shui	0
炎武王	yan'wu'wang	0
佯攻	yang'gong	0
摇晃舞	yao'huang'wu	0
妖火红狐	yao'huo'hong'hu	0
妖精之风	yao'jing'zhi'feng	0
妖精之锁	yao'jing'zhi'suo	0
摇篮百合	yao'lan'bai'he	0
钥圈儿	yao'quan'er	0
咬碎	yao'sui	0
摇尾巴	yao'wei'ba	0
咬住	yao'zhu	0
椰蛋树	ye'dan'shu	0
夜盗火蜥	ye'dao'huo'xi	0
野蛮鲈鱼	ye'man'lu'yu	0
叶刃	ye'ren	0
夜巡灵	ye'xun'ling	0
叶伊布	ye'yi'bu	0
伊布	yi'bu	0
异次元洞	yi'ci'yuan'dong	0
异次元猛攻	yi'ci'yuan'meng'gong	0
意念头锤	yi'nian'tou'chui	0
意念移物	yi'nian'yi'wu	0
伊裴尔塔尔	yi'pei'er'ta'er	0
以牙还牙	yi'ya'huan'ya	0
银伴战兽	yin'ban'zhan'shou	0
音爆	yin'bao	0
音波龙	yin'bo'long	0
引梦貘人	yin'meng'mo'ren	0
银色旋风	yin'se'xuan'feng	0
音速拳	yin'su'quan	0
音箱蟀	yin'xiang'shuai	0
隐形岩	yin'xing'yan	0
硬撑	ying'cheng	0
荧光鱼	ying'guang'yu	0
樱花宝	ying'hua'bao	0
樱花儿	ying'hua'er	0
樱花鱼	ying'hua'yu	0
萤火	ying'huo	0
迎头一击	ying'tou'yi'ji	0
鹦鹉学舌	ying'wu'xue'she	0
影子分身	ying'zi'fen'shen	0
影子偷袭	ying'zi'tou'xi	0
勇基拉	yong'ji'la	0
勇鸟猛攻	yong'niao'meng'gong	0
泳圈鼬	yong'quan'you	0
勇士雄鹰	yong'shi'xiong'ying	0
诱惑	you'huo	0
幼基拉斯	you'ji'la'si	0
由克希	you'ke'xi	0
优雅猫	you'ya'mao	0
雨翅蛾	yu'chi'e	0
瑜伽姿势	yu'jia'zi'shi	0
羽毛舞	yu'mao'wu	0
羽栖	yu'qi	0
预知未来	yu'zhi'wei'lai	0
宇宙力量	yu'zhou'li'liang	0
圆法师	yuan'fa'shi	0
原盖海龟	yuan'gai'hai'gui	0
远古巨蜓	yuan'gu'ju'ting	0
怨恨	yuan'hen	0
圆蝌蚪	yuan'ke'dou	0
圆陆鲨	yuan'lu'sha	0
怨念	yuan'nian	0
原始之力	yuan'shi'zhi'li	0
圆丝蛛	yuan'si'zhu	0
圆瞳	yuan'tong	0
怨影娃娃	yuan'ying'wa'wa	0
月光	yue'guang	0
月桂叶	yue'gui'ye	0
月华飞溅落灵霄	yue'hua'fei'jian'luo'ling'xiao	0
月亮伊布	yue'liang'yi'bu	0
月亮之力	yue'liang'zhi'li	0
跃起	yue'qi	0
月石	yue'shi	0
杂技	za'ji	0
再来一次	zai'lai'yi'ci	0
增强拳	zeng'qiang'quan	0
炸蛋	zha'dan	0
扎根	zha'gen	0
战槌龙	zhan'chui'long	0
战吼	zhan'hou	0
战舞郎	zhan'wu'lang	0
杖尾鳞甲龙	zhang'wei'lin'jia'long	0
章鱼桶	zhang'yu'tong	0
章鱼桶炮	zhang'yu'tong'pao	0
找伙伴	zhao'huo'ban	0
沼王	zhao'wang	0
沼跃鱼	zhao'yue'yu	0
哲尔尼亚斯	zhe'er'ni'ya'si	0
遮天蔽日暗影箭	zhe'tian'bi'ri'an'ying'jian	0
折弯汤匙	zhe'wan'tang'chi	0
珍藏	zhen'cang	0
榛果球	zhen'guo'qiu	0
震级	zhen'ji	0
真空波	zhen'kong'bo	0
真气弹	zhen'qi'dan	0
真气拳	zhen'qi'quan	0
珍珠贝	zhen'zhu'bei	0
正电拍拍	zheng'dian'pai'pai	0
蒸汽爆炸	zheng'qi'bao'zha	0
挣扎	zheng'zha	0
制裁光砾	zhi'cai'guang'li	0
直冲熊	zhi'chong'xiong	0
直冲钻	zhi'chong'zuan	0
至高精神破坏波	zhi'gao'jing'shen'po'huai'bo	0
智挥猩	zhi'hui'xing	0
掷锚	zhi'mao	0
致命针刺	zhi'ming'zhen'ci	0
掷泥	zhi'ni	0
治愈波动	zhi'yu'bo'dong	0
纸御剑	zhi'yu'jian	0
治愈铃声	zhi'yu'ling'sheng	0
治愈之愿	zhi'yu'zhi'yuan	0
重磅冲撞	zhong'bang'chong'zhuang	0
终极冲击	zhong'ji'chong'ji	0
终极伏特狂雷闪	zhong'ji'fu'te'kuang'lei'shan	0
终极吸取	zhong'ji'xi'qu	0
重力	zhong'li	0
重泥挽马	zhong'ni'wan'ma	0
重踏	zhong'ta	0
种子机关枪	zhong'zi'ji'guan'qiang	0
种子闪光	zhong'zi'shan'guang	0
种子铁球	zhong'zi'tie'qiu	0
种子炸弹	zhong'zi'zha'dan	0
逐步击破	zhu'bu'ji'po	0
烛光灵	zhu'guang'ling	0
蛛网	zhu'wang	0
抓狂	zhua'kuang	0
撞击	zhuang'ji	0
追打	zhui'da	0
浊流	zhuo'liu	0
啄食	zhuo'shi	0
浊雾	zhuo'wu	0
啄钻	zhuo'zuan	0
自爆	zi'bao	0
自爆磁怪	zi'bao'ci'guai	0
子弹拳	zi'dan'quan	0
自然之恩	zi'ran'zhi'en	0
自然之力	zi'ran'zhi'li	0
自然之怒	zi'ran'zhi'nu	0
自我暗示	zi'wo'an'shi	0
自我激励	zi'wo'ji'li	0
自我再生	zi'wo'zai'sheng	0
自由落体	zi'you'luo'ti	0
鬃岩狼人	zong'yan'lang'ren	0
走路草	zou'lu'cao	0
诅咒	zu'zhou	0
诅咒娃娃	zu'zhou'wa'wa	0
钻角犀兽	zuan'jiao'xi'shou	0
钻石风暴	zuan'shi'feng'bao	0
坐骑山羊	zuo'qi'shan'yang	0
坐骑小羊	zuo'qi'xiao'yang	0
