阿莉兹	a'li'zi	0
暴风起源	bao'feng'qi'yuan	0
爆裂蜂	bao'lie'feng	0
爆裂屏障	bao'lie'ping'zhang	0
爆裂熔炉	bao'lie'rong'lu	0
爆裂战壕	bao'lie'zhan'hao	0
扁鲨潜艇	bian'sha'qian'ting	0
兵营	bing'ying	0
豺狼机动载具	chai'lang'ji'dong'zai'ju	0
长枪战士	chang'qiang'zhan'shi	0
穿云尖塔	chuan'yun'jian'ta	0
穿云尖塔扩展	chuan'yun'jian'ta'kuo'zhan	0
地雷	di'lei	0
顶点暴风	ding'dian'bao'feng	0
独眼巨人	du'yan'ju'ren	0
断电导弹	duan'dian'dao'dan	0
多智龙火炮	duo'zhi'long'huo'pao	0
发电风箱	fa'dian'feng'xiang	0
放空鸟巢	fang'kong'niao'chao	0
飞蜥坦克	fei'xi'tan'ke	0
菲因	fei'yin	0
焚风机动建设车	fen'feng'ji'dong'jian'she'che	0
风神护盾	feng'shen'hu'dun	0
风神翼龙	feng'shen'yi'long	0
工程师	gong'cheng'shi	0
轨道舱协议	gui'dao'cang'xie'yi	0
轨道炮塔	gui'dao'pao'ta	0
海军船坞	hai'jun'chuan'wu	0
浣熊干扰车	huan'xiong'gan'rao'che	0
活动炸弹	huo'dong'zha'dan	0
激怒者	ji'nu'zhe	0
机械造物	ji'xie'zao'wu	0
加速旋塔	jia'su'xuan'ta	0
剑鱼护卫舰	jian'yu'hu'wei'jian	0
静滞网格	jing'zhi'wang'ge	0
巨齿鲨机甲	ju'chi'sha'ji'jia	0
巨齿鲨竞技场	ju'chi'sha'jing'ji'chang	0
巨鳄载具	ju'e'zai'ju	0
巨人克星	ju'ren'ke'xing	0
空降扫荡者	kong'jiang'sao'dang'zhe	0
空中哨站	kong'zhong'shao'zhan	0
矿甲虫	kuang'jia'chong	0
矿石精炼厂	kuang'shi'jing'lian'chang	0
雷鸟防空车	lei'niao'fang'kong'che	0
利维坦	li'wei'tan	0
离子切割机	li'zi'qie'ge'ji	0
离子要塞炮	li'zi'yao'sai'pao	0
蛮牛坦克	man'niu'tan'ke	0
迷幻网格	mi'huan'wang'ge	0
纳米回复场	na'mi'hui'fu'chang	0
纳米同步	na'mi'tong'bu	0
纳米纤维织机	na'mi'xian'wei'zhi'ji	0
纳米织机扩展	na'mi'zhi'ji'kuo'zhan	0
女猎手	nv'lie'shou	0
气压球使徒	qi'ya'qiu'shi'tu	0
千里眼机器人	qian'li'yan'ji'qi'ren	0
乳齿象坦克	ru'chi'xiang'tan'ke	0
扫荡者	sao'dang'zhe	0
声波发射器	sheng'bo'fa'she'qi	0
声波坦克	sheng'bo'tan'ke	0
声波侦测仪	sheng'bo'zhen'ce'yi	0
天降神兵	tian'jiang'shen'bing	0
铁骑兵	tie'qi'bing	0
同步浪人	tong'bu'lang'ren	0
涂层稳定器	tu'ceng'wen'ding'qi	0
秃鹰攻击机	tu'ying'gong'ji'ji	0
吞并	tun'bing	0
网络核心	wang'luo'he'xin	0
网络核心扩展	wang'luo'he'xin'kuo'zhan	0
无齿翼龙	wu'chi'yi'long	0
乌拉甘	wu'la'gan	0
先锋导航塔	xian'feng'dao'hang'ta	0
先锋炮艇机	xian'feng'pao'ting'ji	0
信号干扰	xin'hao'gan'rao	0
信号抑制器	xin'hao'yi'zhi'qi	0
优莱卡	you'lai'ka	0
再生室	zai'sheng'shi	0
造物惩击	zao'wu'cheng'ji	0
战车工厂	zhan'che'gong'chang	0
战龟运输艇	zhan'gui'yun'shu'ting	0
侦查扫描	zhen'cha'sao'miao	0
