阿嘉娜	a'jia'na	0
阿老	a'lao	0
阿越	a'yue	0
艾麟	ai'lin	0
艾民有	ai'min'you	0
艾启蒙	ai'qi'meng	0
爱斯基摩艺术	ai'si'ji'mo'yi'shu	0
安昌奎	an'chang'kui	0
暗橙	an'cheng	0
安德义	an'de'yi	0
安鼎文	an'ding'wen	0
安敦礼	an'dun'li	0
暗粉	an'fen	0
暗粉红	an'fen'hong	0
安宏	an'hong	0
暗绛红	an'jiang'hong	0
暗兰	an'lan	0
安良发	an'liang'fa	0
暗麦绿	an'mai'lv	0
安明阳	an'ming'yang	0
暗水绿	an'shui'lv	0
安铁军	an'tie'jun	0
安阳宋墓壁画	an'yang'song'mu'bi'hua	0
安耀华	an'yao'hua	0
暗夜蓝	an'ye'lan	0
安毅	an'yi	0
安正中	an'zheng'zhong	0
奥费主义	ao'fei'zhu'yi	0
凹凸光	ao'tu'guang	0
巴达荣桂	ba'da'rong'gui	0
八幡关太郎	ba'fan'guan'tai'lang	0
八方行笔	ba'fang'xing'bi	0
巴光明	ba'guang'ming	0
巴荒	ba'huang	0
巴黎画派	ba'li'hua'pai	0
巴洛克美术	ba'luo'ke'mei'shu	0
巴洛克艺术	ba'luo'ke'yi'shu	0
巴山蜀水壁画	ba'shan'shu'shui'bi'hua	0
白嗄力	bai'a'li	0
白伯骅	bai'bo'hua	0
拜城克孜尔石窟壁画	bai'cheng'ke'zi'er'shi'ku'bi'hua	0
白春禹	bai'chun'yu	0
柏芳景	bai'fang'jing	0
白丰中	bai'feng'zhong	0
柏恒	bai'heng	0
柏佳甫	bai'jia'fu	0
白建强	bai'jian'qiang	0
白建涛	bai'jian'tao	0
白君红	bai'jun'hong	0
百美争艳图	bai'mei'zheng'yan'tu	0
白米色	bai'mi'se	0
白描	bai'miao	0
白浅橙	bai'qian'cheng	0
白仁海	bai'ren'hai	0
白沙宋墓壁画	bai'sha'song'mu'bi'hua	0
白蛇传壁画	bai'she'zhuan'bi'hua	0
白实	bai'shi	0
柏树法	bai'shu'fa	0
白塔子村辽墓壁画	bai'ta'zi'cun'liao'mu'bi'hua	0
白文斌	bai'wen'bin	0
白新城	bai'xin'cheng	0
白亚林	bai'ya'lin	0
白彦尔登辽墓壁画	bai'yan'er'deng'liao'mu'bi'hua	0
白燕楼	bai'yan'lou	0
白燕堂主人	bai'yan'tang'zhu'ren	0
白宜芳	bai'yi'fang	0
白宜洛	bai'yi'luo	0
白音敖包辽墓壁画	bai'yin'ao'bao'liao'mu'bi'hua	0
白羽平	bai'yu'ping	0
白云迷寺图	bai'yun'mi'si'tu	0
拜占庭美术	bai'zhan'ting'mei'shu	0
白展望	bai'zhan'wang	0
白仲霞	bai'zhong'xia	0
瓣根	ban'gen	0
斑痕画家	ban'hen'hua'jia	0
瓣尖	ban'jian	0
半漂	ban'piao	0
半漂白	ban'piao'bai	0
班学俭	ban'xue'jian	0
宝贝蓝	bao'bei'lan	0
包福生	bao'fu'sheng	0
宝兰	bao'lan	0
包林	bao'lin	0
包少先	bao'shao'xian	0
包胜军	bao'sheng'jun	0
包首	bao'shou	0
鲍卫兵	bao'wei'bing	0
抱瓮主人	bao'weng'zhu'ren	0
鲍岳庭	bao'yue'ting	0
鲍云进	bao'yun'jin	0
包泽伟	bao'ze'wei	0
鲍震	bao'zhen	0
鲍振	bao'zhen	0
鲍智明	bao'zhi'ming	0
包忠	bao'zhong	0
鲍竹青	bao'zhu'qing	0
北京百万庄辽墓壁画	bei'jing'bai'wan'zhuang'liao'mu'bi'hua	0
北京大慧寺壁画	bei'jing'da'hui'si'bi'hua	0
北京法海寺壁画	bei'jing'fa'hai'si'bi'hua	0
北京国际机场壁画	bei'jing'guo'ji'ji'chang'bi'hua	0
北京密云元墓壁画	bei'jing'mi'yun'yuan'mu'bi'hua	0
北京墙纸壁画	bei'jing'qiang'zhi'bi'hua	0
北京斋堂辽墓壁画	bei'jing'zhai'tang'liao'mu'bi'hua	0
背临	bei'lin	0
北齐高润墓壁画	bei'qi'gao'run'mu'bi'hua	0
北齐库狄回洛墓壁画	bei'qi'ku'di'hui'luo'mu'bi'hua	0
北齐娄睿墓壁画	bei'qi'lou'rui'mu'bi'hua	0
北齐校书图	bei'qi'xiao'shu'tu	0
北三家村号辽墓壁画	bei'san'jia'cun'hao'liao'mu'bi'hua	0
北燕冯素弗墓壁画	bei'yan'feng'su'fu'mu'bi'hua	0
北游集	bei'you'ji	0
北镇庙壁画	bei'zhen'miao'bi'hua	0
北周杜欢墓壁画	bei'zhou'du'huan'mu'bi'hua	0
本白	ben'bai	0
本厂白	ben'chang'bai	0
本厂黑	ben'chang'hei	0
本厂克	ben'chang'ke	0
本生图	ben'sheng'tu	0
笔操于人	bi'cao'yu'ren	0
笔断意连	bi'duan'yi'lian	0
笔法	bi'fa	0
笔腹	bi'fu	0
毕闳	bi'hong	0
毕敬虎	bi'jing'hu	0
笔墨	bi'mo	0
笔墨常存	bi'mo'chang'cun	0
笔墨丹青	bi'mo'dan'qing	0
笔墨技巧	bi'mo'ji'qiao	0
笔墨意境	bi'mo'yi'jing	0
笔墨章	bi'mo'zhang	0
毕沙罗	bi'sha'luo	0
笔山驾驭	bi'shan'jia'yu	0
笔受腕	bi'shou'wan	0
毕晓冬	bi'xiao'dong	0
毕新育	bi'xin'yu	0
毕颐生	bi'yi'sheng	0
笔意纵恣	bi'yi'zong'zi	0
毕永祥	bi'yong'xiang	0
笔阵图	bi'zhen'tu	0
边巴	bian'ba	0
边炳贵	bian'bing'gui	0
边迪	bian'di	0
边东利	bian'dong'li	0
边宏伟	bian'hong'wei	0
变化章	bian'hua'zhang	0
边景昭	bian'jing'zhao	0
边鸾	bian'luan	0
边平山	bian'ping'shan	0
边寿民	bian'shou'min	0
边维祺	bian'wei'qi	0
边文进	bian'wen'jin	0
边小强	bian'xiao'qiang	0
裱褙	biao'bei	0
裱背十三科	biao'bei'shi'san'ke	0
鬓残	bin'can	0
冰湖蓝	bing'hu'lan	0
冰琳禅师	bing'lin'chan'shi	0
冰雪蓝	bing'xue'lan	0
冰雪山水	bing'xue'shan'shui	0
冰洋蓝	bing'yang'lan	0
渤海贞孝公主墓壁画	bo'hai'zhen'xiao'gong'zhu'mu'bi'hua	0
薄荷绿	bo'he'lv	0
薄菏绿	bo'he'lv	0
玻璃画	bo'li'hua	0
玻璃镶嵌壁画	bo'li'xiang'qian'bi'hua	0
波力亚	bo'li'ya	0
波普艺术	bo'pu'yi'shu	0
博乔尼	bo'qiao'ni	0
博问亭	bo'wen'ting	0
步健	bu'jian	0
不似之似	bu'si'zhi'si	0
卜孝怀	bu'xiao'huai	0
步欣农	bu'xin'nong	0
步燕萍	bu'yan'ping	0
擦染	ca'ran	0
蔡宝玉	cai'bao'yu	0
蔡传胜	cai'chuan'sheng	0
蔡东	cai'dong	0
蔡富军	cai'fu'jun	0
蔡浩	cai'hao	0
蔡鹤汀	cai'he'ting	0
彩虹色	cai'hong'se	0
蔡际平	cai'ji'ping	0
蔡嘉	cai'jia	0
蔡健	cai'jian	0
彩蓝	cai'lan	0
彩兰	cai'lan	0
蔡力武	cai'li'wu	0
蔡立武	cai'li'wu	0
蔡梦虹	cai'meng'hong	0
蔡明城	cai'ming'cheng	0
蔡明龙	cai'ming'long	0
蔡佩芬	cai'pei'fen	0
蔡旗元	cai'qi'yuan	0
蔡庆彰	cai'qing'zhang	0
蔡蓉	cai'rong	0
蔡沙	cai'sha	0
蔡树荣	cai'shu'rong	0
蔡穗芳	cai'sui'fang	0
蔡未来	cai'wei'lai	0
蔡卫星	cai'wei'xing	0
蔡小华	cai'xiao'hua	0
蔡小丽	cai'xiao'li	0
蔡雪沛	cai'xue'pei	0
蔡永辉	cai'yong'hui	0
蔡有旭	cai'you'xu	0
蔡於良	cai'yu'liang	0
蔡岳云	cai'yue'yun	0
蔡正一	cai'zheng'yi	0
蔡志平	cai'zhi'ping	0
蔡子雨	cai'zi'yu	0
苍牧	cang'mu	0
苍松老屋图	cang'song'lao'wu'tu	0
曹爱君	cao'ai'jun	0
曹霸	cao'ba	0
曹达立	cao'da'li	0
草地绿	cao'di'lv	0
曹鼎望	cao'ding'wang	0
曹辅銮	cao'fu'luan	0
曹弗兴	cao'fu'xing	0
曹冠五	cao'guan'wu	0
曹国红	cao'guo'hong	0
曹海龙	cao'hai'long	0
曹鸿书	cao'hong'shu	0
曹吉冈	cao'ji'gang	0
曹家样	cao'jia'yang	0
曹江	cao'jiang	0
曹静萍	cao'jing'ping	0
曹克家	cao'ke'jia	0
曹立鸿	cao'li'hong	0
草绿	cao'lv	0
草莓红	cao'mei'hong	0
曹培伦	cao'pei'lun	0
曹庆棠	cao'qing'tang	0
曹生均	cao'sheng'jun	0
曹士福	cao'shi'fu	0
曹喜丰	cao'xi'feng	0
曹锡辉	cao'xi'hui	0
曹西冷	cao'xi'leng	0
曹新林	cao'xin'lin	0
曹兴军	cao'xing'jun	0
曹衣出水描	cao'yi'chu'shui'miao	0
曹壹林	cao'yi'lin	0
曹衣描	cao'yi'miao	0
曹贞吉	cao'zhen'ji	0
曹仲达	cao'zhong'da	0
曹仲玄	cao'zhong'xuan	0
侧锋	ce'feng	0
岑龙	cen'long	0
岑佩嫦	cen'pei'chang	0
曾长航	ceng'chang'hang	0
曾长生	ceng'chang'sheng	0
曾传兴	ceng'chuan'xing	0
曾涤臣	ceng'di'chen	0
曾涤尘	ceng'di'chen	0
曾凡志	ceng'fan'zhi	0
曾剑雄	ceng'jian'xiong	0
曾鲸	ceng'jing	0
曾景生	ceng'jing'sheng	0
曾俊雄	ceng'jun'xiong	0
曾令仁	ceng'ling'ren	0
曾令馨	ceng'ling'xin	0
曾茂煌	ceng'mao'huang	0
曾妮	ceng'ni	0
曾清淦	ceng'qing'gan	0
层染法	ceng'ran'fa	0
曾日文	ceng'ri'wen	0
曾晚妆	ceng'wan'zhuang	0
曾维华	ceng'wei'hua	0
曾曦	ceng'xi	0
曾孝濂	ceng'xiao'lian	0
曾沂聂	ceng'yi'nie	0
曾玉华	ceng'yu'hua	0
曾昭强	ceng'zhao'qiang	0
曾正元	ceng'zheng'yuan	0
茶褐	cha'he	0
茶绿	cha'lv	0
查士标	cha'shi'biao	0
柴笔描	chai'bi'miao	0
柴作相	chai'zuo'xiang	0
颤笔	chan'bi	0
长安雪霁图	chang'an'xue'ji'tu	0
常斌平	chang'bin'ping	0
长干寺	chang'gan'si	0
常金祥	chang'jin'xiang	0
长颈圣母	chang'jing'sheng'mu	0
常宽生	chang'kuan'sheng	0
长披麻	chang'pi'ma	0
常沙娜	chang'sha'na	0
常世江	chang'shi'jiang	0
常小军	chang'xiao'jun	0
常星海	chang'xing'hai	0
常燕燕	chang'yan'yan	0
常玉	chang'yu	0
常跃泼	chang'yue'po	0
长治故漳金墓壁画	chang'zhi'gu'zhang'jin'mu'bi'hua	0
长治李村沟金墓壁画	chang'zhi'li'cun'gou'jin'mu'bi'hua	0
巢湖图	chao'hu'tu	0
巢林	chao'lin	0
超现实主义	chao'xian'shi'zhu'yi	0
朝元仙仗图	chao'yuan'xian'zhang'tu	0
车建全	che'jian'quan	0
陈安健	chen'an'jian	0
陈安建	chen'an'jian	0
陈柏州	chen'bai'zhou	0
陈半丁	chen'ban'ding	0
陈笔政	chen'bi'zheng	0
陈秉良	chen'bing'liang	0
陈昌林	chen'chang'lin	0
陈朝瑄	chen'chao'xuan	0
陈承齐	chen'cheng'qi	0
陈承卫	chen'cheng'wei	0
陈初电	chen'chu'dian	0
陈传席	chen'chuan'xi	0
陈创洛	chen'chuang'luo	0
陈椿	chen'chun	0
陈淳	chen'chun	0
陈春阳	chen'chun'yang	0
陈大羽	chen'da'yu	0
陈丹青	chen'dan'qing	0
陈道复	chen'dao'fu	0
陈登木	chen'deng'mu	0
陈鼎	chen'ding	0
陈定九	chen'ding'jiu	0
陈舫枝	chen'fang'zhi	0
陈飞龙	chen'fei'long	0
陈冠夫	chen'guan'fu	0
陈广良	chen'guang'liang	0
陈桂花	chen'gui'hua	0
沉海凡	chen'hai'fan	0
陈海强	chen'hai'qiang	0
陈和西	chen'he'xi	0
陈衡恪	chen'heng'ke	0
陈闳	chen'hong	0
陈鸿翎	chen'hong'ling	0
陈红旗	chen'hong'qi	0
陈宏庆	chen'hong'qing	0
陈宏仁	chen'hong'ren	0
陈洪绶	chen'hong'shou	0
陈宏新	chen'hong'xin	0
陈鸿志	chen'hong'zhi	0
陈活活	chen'huo'huo	0
陈吉昌	chen'ji'chang	0
陈继群	chen'ji'qun	0
陈继武	chen'ji'wu	0
陈嘉乐	chen'jia'le	0
陈鉴	chen'jian	0
陈剑清	chen'jian'qing	0
陈建榕	chen'jian'rong	0
陈健壮	chen'jian'zhuang	0
陈劼	chen'jie	0
陈金法	chen'jin'fa	0
陈锦明	chen'jin'ming	0
陈金强	chen'jin'qiang	0
陈景容	chen'jing'rong	0
陈纠	chen'jiu	0
陈遽	chen'ju	0
陈居茂	chen'ju'mao	0
陈居中	chen'ju'zhong	0
陈钧德	chen'jun'de	0
陈均德	chen'jun'de	0
陈俊穆	chen'jun'mu	0
陈军琪	chen'jun'qi	0
陈君魏	chen'jun'wei	0
陈开泉	chen'kai'quan	0
陈克雷	chen'ke'lei	0
陈克平	chen'ke'ping	0
陈克雄	chen'ke'xiong	0
陈克义	chen'ke'yi	0
陈来国	chen'lai'guo	0
陈来兴	chen'lai'xing	0
陈老莲	chen'lao'lian	0
陈丽萃	chen'li'cui	0
陈莉丽	chen'li'li	0
陈里纳	chen'li'na	0
陈立勋	chen'li'xun	0
陈联庆	chen'lian'qing	0
陈亮洁	chen'liang'jie	0
陈麟祥	chen'lin'xiang	0
陈林斋	chen'lin'zhai	0
陈玲洁	chen'ling'jie	0
陈龙生	chen'long'sheng	0
陈绿寿	chen'lv'shou	0
陈曼倩	chen'man'qian	0
陈漫天	chen'man'tian	0
陈枚	chen'mei	0
陈孟岠	chen'meng'ju	0
陈明华	chen'ming'hua	0
陈铭浓	chen'ming'nong	0
陈乃秋	chen'nai'qiu	0
陈宁尔	chen'ning'er	0
陈佩秋	chen'pei'qiu	0
陈启基	chen'qi'ji	0
陈启贤	chen'qi'xian	0
陈庆珠	chen'qing'zhu	0
陈琼琚	chen'qiong'ju	0
陈秋池	chen'qiu'chi	0
衬染	chen'ran	0
陈人钰	chen'ren'yu	0
陈容	chen'rong	0
陈汝言	chen'ru'yan	0
陈少立	chen'shao'li	0
陈少梅	chen'shao'mei	0
陈少亭	chen'shao'ting	0
陈韶瑜	chen'shao'yu	0
陈绍元	chen'shao'yuan	0
陈盛铎	chen'sheng'duo	0
陈生华	chen'sheng'hua	0
陈圣颂	chen'sheng'song	0
趁湿	chen'shi	0
陈师曾	chen'shi'ceng	0
陈世和	chen'shi'he	0
陈世集	chen'shi'ji	0
陈世君	chen'shi'jun	0
陈石梅	chen'shi'mei	0
陈石松	chen'shi'song	0
陈树东	chen'shu'dong	0
陈树人	chen'shu'ren	0
陈树中	chen'shu'zhong	0
陈腾光	chen'teng'guang	0
陈天龙	chen'tian'long	0
陈天义	chen'tian'yi	0
陈霆	chen'ting	0
陈通乾	chen'tong'qian	0
陈皖山	chen'wan'shan	0
陈万毅	chen'wan'yi	0
陈畏	chen'wei	0
陈维利	chen'wei'li	0
陈卫闽	chen'wei'min	0
陈文鉴	chen'wen'jian	0
陈闻霜	chen'wen'shuang	0
陈熙承	chen'xi'cheng	0
陈显栋	chen'xian'dong	0
陈向兵	chen'xiang'bing	0
谌孝安	chen'xiao'an	0
陈小杰	chen'xiao'jie	0
陈晓鸣	chen'xiao'ming	0
陈小鸥	chen'xiao'ou	0
陈晓钊	chen'xiao'zhao	0
陈燮君	chen'xie'jun	0
陈欣	chen'xin	0
陈新良	chen'xin'liang	0
陈雄勋	chen'xiong'xun	0
陈修范	chen'xiu'fan	0
陈秀煜	chen'xiu'yu	0
陈许	chen'xu	0
陈旭林	chen'xu'lin	0
陈轩齐	chen'xuan'qi	0
陈亚莲	chen'ya'lian	0
陈琰	chen'yan	0
陈延辉	chen'yan'hui	0
陈沿青	chen'yan'qing	0
陈逸飞	chen'yi'fei	0
陈义丰	chen'yi'feng	0
陈贻福	chen'yi'fu	0
陈毅刚	chen'yi'gang	0
陈逸鸣	chen'yi'ming	0
陈奕文	chen'yi'wen	0
陈银辉	chen'yin'hui	0
陈银梅	chen'yin'mei	0
陈荫罴	chen'yin'pi	0
陈宇飞	chen'yu'fei	0
陈育涵	chen'yu'han	0
陈育培	chen'yu'pei	0
陈雨顺	chen'yu'shun	0
陈远大	chen'yuan'da	0
陈缘督	chen'yuan'du	0
陈越刚	chen'yue'gang	0
陈跃华	chen'yue'hua	0
陈云山	chen'yun'shan	0
陈张莉	chen'zhang'li	0
陈章永	chen'zhang'yong	0
陈正军	chen'zheng'jun	0
陈之佛	chen'zhi'fo	0
陈治明	chen'zhi'ming	0
陈忠正	chen'zhong'zheng	0
陈主明	chen'zhu'ming	0
陈子	chen'zi	0
陈子达	chen'zi'da	0
陈子君	chen'zi'jun	0
陈子强	chen'zi'qiang	0
陈子雄	chen'zi'xiong	0
陈子胄	chen'zi'zhou	0
陈子庄	chen'zi'zhuang	0
陈宗光	chen'zong'guang	0
陈宗舜	chen'zong'shun	0
陈宗耀	chen'zong'yao	0
程丛林	cheng'cong'lin	0
承德安远庙壁画	cheng'de'an'yuan'miao'bi'hua	0
承德堂主人	cheng'de'tang'zhu'ren	0
程非	cheng'fei	0
程继光	cheng'ji'guang	0
程建嘉	cheng'jian'jia	0
承杰	cheng'jie	0
程静路	cheng'jing'lu	0
程俊杰	cheng'jun'jie	0
程开涛	cheng'kai'tao	0
程克	cheng'ke	0
程立春	cheng'li'chun	0
程林新	cheng'lin'xin	0
程穆倩	cheng'mu'qian	0
成南炎	cheng'nan'yan	0
程圣端	cheng'sheng'duan	0
程十发	cheng'shi'fa	0
程水生	cheng'shui'sheng	0
橙王	cheng'wang	0
程文立	cheng'wen'li	0
程相昭	cheng'xiang'zhao	0
程雪峰	cheng'xue'feng	0
程璋	cheng'zhang	0
程正揆	cheng'zheng'kui	0
程竹	cheng'zhu	0
褫画	chi'hua	0
赤人	chi'ren	0
池振明	chi'zhen'ming	0
冲彩	chong'cai	0
仇德树	chou'de'shu	0
仇林	chou'lin	0
仇实父	chou'shi'fu	0
抽象派	chou'xiang'pai	0
抽象主义	chou'xiang'zhu'yi	0
仇永波	chou'yong'bo	0
楚戈	chu'ge	0
楚觅	chu'mi	0
出如截	chu'ru'jie	0
出枝	chu'zhi	0
传綮	chuan'qing	0
传统年画	chuan'tong'nian'hua	0
传统重彩	chuan'tong'zhong'cai	0
传移模写	chuan'yi'mo'xie	0
垂露	chui'lu	0
莼菜条	chun'cai'tiao	0
纯粹主义	chun'cui'zhu'yi	0
春浮园集	chun'fu'yuan'ji	0
春江垂钓图	chun'jiang'chui'diao'tu	0
春觉斋论画	chun'jue'zhai'lun'hua	0
椿叶点	chun'ye'dian	0
春颖	chun'ying	0
瓷器蓝	ci'qi'lan	0
慈茹荃	ci'ru'quan	0
磁铁紫	ci'tie'zi	0
慈源寺	ci'yuan'si	0
丛林绿	cong'lin'lv	0
丛如日	cong'ru'ri	0
粗笔山水图扇	cu'bi'shan'shui'tu'shan	0
爨响	cuan'xiang	0
崔白	cui'bai	0
崔宝茹	cui'bao'ru	0
崔炳良	cui'bing'liang	0
崔彩霞	cui'cai'xia	0
崔道勇	cui'dao'yong	0
崔根男	cui'gen'nan	0
崔广平	cui'guang'ping	0
崔国强	cui'guo'qiang	0
崔国泰	cui'guo'tai	0
崔稼夫	cui'jia'fu	0
翠蛟峰	cui'jiao'feng	0
翠蛟峰观泉图	cui'jiao'feng'guan'quan'tu	0
崔锦	cui'jin	0
崔开尔	cui'kai'er	0
崔龙虎	cui'long'hu	0
崔全成	cui'quan'cheng	0
崔泉溪	cui'quan'xi	0
崔悫	cui'que	0
崔如琢	cui'ru'zhuo	0
崔宪基	cui'xian'ji	0
崔小东	cui'xiao'dong	0
崔小冬	cui'xiao'dong	0
崔新周	cui'xin'zhou	0
崔彦伟	cui'yan'wei	0
崔永虎	cui'yong'hu	0
皴擦	cun'ca	0
皴法章	cun'fa'zhang	0
大本堂	da'ben'tang	0
大丛	da'cong	0
达达主义	da'da'zhu'yi	0
大涤草堂图	da'di'cao'tang'tu	0
大涤堂	da'di'tang	0
大涤子	da'di'zi	0
大斧劈	da'fu'pi	0
搭杆	da'gan	0
大红灰	da'hong'hui	0
打虎亭汉墓壁画	da'hu'ting'han'mu'bi'hua	0
大混点	da'hun'dian	0
大间小	da'jian'xiao	0
大青绿	da'qing'lv	0
大同华严寺壁画	da'tong'hua'yan'si'bi'hua	0
大同马家堡辽墓壁画	da'tong'ma'jia'pu'liao'mu'bi'hua	0
大同善化寺壁画	da'tong'shan'hua'si'bi'hua	0
大托	da'tuo	0
大小曲直	da'xiao'qu'zhi	0
大写意	da'xie'yi	0
达则变	da'ze'bian	0
戴碧韵	dai'bi'yun	0
戴秉心	dai'bing'xin	0
戴成华	dai'cheng'hua	0
戴成熙	dai'cheng'xi	0
戴闯	dai'chuang	0
戴都都	dai'dou'dou	0
戴刚峰	dai'gang'feng	0
戴国顺	dai'guo'shun	0
戴海鹰	dai'hai'ying	0
戴家峰	dai'jia'feng	0
戴剑波	dai'jian'bo	0
戴进	dai'jin	0
戴克鉴	dai'ke'jian	0
戴逵	dai'kui	0
玳瑁红	dai'mao'hong	0
戴名杰	dai'ming'jie	0
代平	dai'ping	0
戴沈松	dai'shen'song	0
戴世和	dai'shi'he	0
戴仕和	dai'shi'he	0
代书斌	dai'shu'bin	0
戴双清	dai'shuang'qing	0
戴嵩	dai'song	0
代涛	dai'tao	0
戴熙	dai'xi	0
戴雪生	dai'xue'sheng	0
戴泽伟	dai'ze'wei	0
岱瞻	dai'zhan	0
戴仲光	dai'zhong'guang	0
淡白紫	dan'bai'zi	0
单邦显	dan'bang'xian	0
蛋彩	dan'cai	0
单凡	dan'fan	0
淡粉	dan'fen	0
淡粉红	dan'fen'hong	0
单刚	dan'gang	0
旦黄	dan'huang	0
淡绿	dan'lv	0
淡玫瑰	dan'mei'gui	0
淡墨	dan'mo	0
淡墨皴擦	dan'mo'cun'ca	0
淡设色	dan'she'se	0
弹窝皴	dan'wo'cun	0
单智	dan'zhi	0
淡子	dan'zi	0
党保华	dang'bao'hua	0
当代油画家	dang'dai'you'hua'jia	0
党建平	dang'jian'ping	0
党景贺	dang'jing'he	0
党章龙	dang'zhang'long	0
稻草黄	dao'cao'huang	0
倒景	dao'jing	0
德珍	de'zhen	0
邓安克	deng'an'ke	0
邓白	deng'bai	0
邓邦镇	deng'bang'zhen	0
邓春雷	deng'chun'lei	0
邓春儒	deng'chun'ru	0
邓福帮	deng'fu'bang	0
邓改山	deng'gai'shan	0
邓光宝	deng'guang'bao	0
邓国源	deng'guo'yuan	0
邓海燕	deng'hai'yan	0
邓箭今	deng'jian'jin	0
邓锦波	deng'jin'bo	0
邓金德	deng'jin'de	0
邓乃荣	deng'nai'rong	0
邓平祥	deng'ping'xiang	0
邓绍义	deng'shao'yi	0
邓澍	deng'shu	0
邓淑君	deng'shu'jun	0
邓旭	deng'xu	0
邓育林	deng'yu'lin	0
邓中华	deng'zhong'hua	0
狄静	di'jing	0
邸立丰	di'li'feng	0
地狱变相图	di'yu'bian'xiang'tu	0
点彩派	dian'cai'pai	0
点厾法	dian'du'fa	0
点垛	dian'duo	0
点刻法	dian'ke'fa	0
淀蓝	dian'lan	0
点苔	dian'tai	0
点叶法	dian'ye'fa	0
刁光胤	diao'guang'yin	0
吊屏	diao'ping	0
刁毅	diao'yi	0
蝶翅贴画	die'chi'tie'hua	0
蝶野论画	die'ye'lun'hua	0
丁宝书	ding'bao'shu	0
顶春生	ding'chun'sheng	0
丁慈康	ding'ci'kang	0
丁聪伟	ding'cong'wei	0
定点法	ding'dian'fa	0
丁东亚	ding'dong'ya	0
丁皋	ding'gao	0
丁观鹏	ding'guan'peng	0
丁光燮	ding'guang'xie	0
丁魁楚	ding'kui'chu	0
丁孟芳	ding'meng'fang	0
丁明亮	ding'ming'liang	0
丁荣魁	ding'rong'kui	0
丁枢	ding'shu	0
丁天缺	ding'tian'que	0
钉头鼠尾	ding'tou'shu'wei	0
钉头鼠尾描	ding'tou'shu'wei'miao	0
定县号宋代塔基壁画	ding'xian'hao'song'dai'ta'ji'bi'hua	0
定襄关王庙壁画	ding'xiang'guan'wang'miao'bi'hua	0
丁小兵	ding'xiao'bing	0
丁衍庸	ding'yan'yong	0
丁一军	ding'yi'jun	0
丁一林	ding'yi'lin	0
丁颖成	ding'ying'cheng	0
丁永昌	ding'yong'chang	0
丁云鹏	ding'yun'peng	0
丁喆	ding'zhe	0
丁振华	ding'zhen'hua	0
丁振清	ding'zhen'qing	0
丁卓芹	ding'zhuo'qin	0
丁宗江	ding'zong'jiang	0
冬白	dong'bai	0
董帮达	dong'bang'da	0
董伯仁	dong'bo'ren	0
董琛	dong'chen	0
董春凤	dong'chun'feng	0
董春生	dong'chun'sheng	0
董从民	dong'cong'min	0
岽方	dong'fang	0
董福壤	dong'fu'rang	0
董钢	dong'gang	0
东皋主人	dong'gao'zhu'ren	0
董贵晗	dong'gui'han	0
董国才	dong'guo'cai	0
董皓云	dong'hao'yun	0
东晋霍承嗣墓壁画	dong'jin'huo'cheng'si'mu'bi'hua	0
董久平	dong'jiu'ping	0
董可	dong'ke	0
董璐	dong'lu	0
董其昌	dong'qi'chang	0
董启瑜	dong'qi'yu	0
董勤欣	dong'qin'xin	0
董勍	dong'qing	0
冬寿墓壁画	dong'shou'mu'bi'hua	0
董寿平	dong'shou'ping	0
董顺伟	dong'shun'wei	0
董婷秀	dong'ting'xiu	0
东魏茹茹公主墓壁画	dong'wei'ru'ru'gong'zhu'mu'bi'hua	0
董文杰	dong'wen'jie	0
董文通	dong'wen'tong	0
董仙舟	dong'xian'zhou	0
董辛冈	dong'xin'gang	0
董学强	dong'xue'qiang	0
董永健	dong'yong'jian	0
董羽	dong'yu	0
董源	dong'yuan	0
董朝阳	dong'zhao'yang	0
董重	dong'zhong	0
豆瓣皴	dou'ban'cun	0
斗方	dou'fang	0
豆红	dou'hong	0
窦鸿	dou'hong	0
豆绿	dou'lv	0
豆沙红	dou'sha'hong	0
豆沙色	dou'sha'se	0
杜安安	du'an'an	0
读碑窠石图	du'bei'ke'shi'tu	0
杜苍略	du'cang'lve	0
杜成发	du'cheng'fa	0
杜崇刚	du'chong'gang	0
杜方晓	du'fang'xiao	0
杜非	du'fei	0
独峰石桥图	du'feng'shi'qiao'tu	0
杜洪鸣	du'hong'ming	0
杜红早	du'hong'zao	0
杜纪海	du'ji'hai	0
杜键	du'jian	0
杜堇	du'jin	0
杜可西	du'ke'xi	0
杜明远	du'ming'yuan	0
杜启锋	du'qi'feng	0
杜琼	du'qiong	0
杜日天	du'ri'tian	0
杜荣坤	du'rong'kun	0
杜慎翔	du'shen'xiang	0
都市蓝	du'shi'lan	0
杜晓东	du'xiao'dong	0
杜学	du'xue	0
杜应红	du'ying'hong	0
杜泳樵	du'yong'qiao	0
杜元	du'yuan	0
段常鹏	duan'chang'peng	0
段春晓	duan'chun'xiao	0
段建宇	duan'jian'yu	0
段江华	duan'jiang'hua	0
断截横斜	duan'jie'heng'xie	0
段明	duan'ming	0
段娜娜	duan'na'na	0
段小刚	duan'xiao'gang	0
段义松	duan'yi'song	0
段玉海	duan'yu'hai	0
段震中	duan'zhen'zhong	0
段正渠	duan'zheng'qu	0
对景不对山	dui'jing'bu'dui'shan	0
堆绢	dui'juan	0
对临	dui'lin	0
对牛弹琴图轴	dui'niu'tan'qin'tu'zhou	0
对山不对景	dui'shan'bu'dui'jing	0
敦煌藏经洞壁画	dun'huang'cang'jing'dong'bi'hua	0
敦煌睒子本生图壁画	dun'huang'shan'zi'ben'sheng'tu'bi'hua	0
敦煌石窟北朝壁画	dun'huang'shi'ku'bei'chao'bi'hua	0
敦煌石窟壁画	dun'huang'shi'ku'bi'hua	0
敦煌石窟隋唐壁画	dun'huang'shi'ku'sui'tang'bi'hua	0
敦煌石窟五代宋壁画	dun'huang'shi'ku'wu'dai'song'bi'hua	0
敦煌狩猎图壁画	dun'huang'shou'lie'tu'bi'hua	0
敦煌四菩萨壁画	dun'huang'si'pu'sa'bi'hua	0
敦煌维摩诘变壁画	dun'huang'wei'mo'jie'bian'bi'hua	0
敦煌五台山围壁画	dun'huang'wu'tai'shan'wei'bi'hua	0
敦煌西方净土变壁画	dun'huang'xi'fang'jing'tu'bian'bi'hua	0
敦煌西千佛洞壁画	dun'huang'xi'qian'fo'dong'bi'hua	0
多层薄染	duo'ceng'bo'ran	0
鄂圭俊	e'gui'jun	0
峨眉峰	e'mei'feng	0
鹅仔黄	e'zai'huang	0
恩广智	en'guang'zhi	0
而画可从心	er'hua'ke'cong'xin	0
二绿	er'lv	0
二色式装裱	er'se'shi'zhuang'biao	0
二羊图	er'yang'tu	0
法常	fa'chang	0
法若真	fa'ruo'zhen	0
法无障	fa'wu'zhang	0
发舟西苔岛	fa'zhou'xi'tai'dao	0
法自画生	fa'zi'hua'sheng	0
范安翔	fan'an'xiang	0
范长寿	fan'chang'shou	0
樊川春远图	fan'chuan'chun'yuan'tu	0
范春艳	fan'chun'yan	0
凡代棕	fan'dai'zong	0
范迪宽	fan'di'kuan	0
范额伦	fan'e'lun	0
反复托	fan'fu'tuo	0
范贯中	fan'guan'zhong	0
樊桂贞	fan'gui'zhen	0
樊海忠	fan'hai'zhong	0
范洪涛	fan'hong'tao	0
范久鹏	fan'jiu'peng	0
樊俊	fan'jun	0
樊俊娥	fan'jun'e	0
范宽	fan'kuan	0
范佩俊	fan'pei'jun	0
范朴	fan'pu	0
樊圻	fan'qi	0
番茄红	fan'qie'hong	0
帆山子	fan'shan'zi	0
樊少云	fan'shao'yun	0
繁峙岩山寺壁画	fan'shi'yan'shan'si'bi'hua	0
范泰炯	fan'tai'jiong	0
矾头皴	fan'tou'cun	0
樊威	fan'wei	0
范新林	fan'xin'lin	0
范秀琴	fan'xiu'qin	0
范翼	fan'yi	0
范蕴蕴	fan'yun'yun	0
范曾	fan'zeng	0
范昭平	fan'zhao'ping	0
方冰山	fang'bing'shan	0
方从礼	fang'cong'li	0
访戴鹰阿图	fang'dai'ying'a'tu	0
方得林	fang'de'lin	0
方昉	fang'fang	0
方格放大法	fang'ge'fang'da'fa	0
方广泓	fang'guang'hong	0
方鹤	fang'he	0
房恒勃	fang'heng'bo	0
方济众	fang'ji'zhong	0
方见尘	fang'jian'chen	0
房建平	fang'jian'ping	0
方介堪	fang'jie'kan	0
方金河	fang'jin'he	0
方景华	fang'jing'hua	0
方君璧	fang'jun'bi	0
方濬颐	fang'jun'yi	0
方力钧	fang'li'jun	0
方力均	fang'li'jun	0
方人定	fang'ren'ding	0
方士庶	fang'shi'shu	0
方婉仪	fang'wan'yi	0
方伟绩	fang'wei'ji	0
方闻	fang'wen	0
方晓宝	fang'xiao'bao	0
方兴国	fang'xing'guo	0
方薰	fang'xun	0
方樟连	fang'zhang'lian	0
方照华	fang'zhao'hua	0
方镇养	fang'zhen'yang	0
飞衬	fei'chen	0
费春	fei'chun	0
翡翠绿	fei'cui'lv	0
费丹旭	fei'dan'xu	0
啡黑	fei'hei	0
啡红	fei'hong	0
啡红色	fei'hong'se	0
废肩	fei'jian	0
非受也	fei'shou'ye	0
飞托	fei'tuo	0
费新我	fei'xin'wo	0
啡杏色	fei'xing'se	0
费扬滔	fei'yang'tao	0
费以复	fei'yi'fu	0
非洲岩洞艺术	fei'zhou'yan'dong'yi'shu	0
非洲紫	fei'zhou'zi	0
粉本	fen'ben	0
粉橙	fen'cheng	0
粉红白	fen'hong'bai	0
粉兰	fen'lan	0
粉绿	fen'lv	0
粉玫红	fen'mei'hong	0
粉末蓝	fen'mo'lan	0
粉茄紫	fen'qie'zi	0
分染	fen'ran	0
分散黑色	fen'san'hei'se	0
分色法	fen'se'fa	0
汾阳圣母庙壁画	fen'yang'sheng'mu'miao'bi'hua	0
粉紫	fen'zi	0
粉紫红	fen'zi'hong	0
粉紫色	fen'zi'se	0
冯帮俊	feng'bang'jun	0
冯炳文	feng'bing'wen	0
冯超然	feng'chao'ran	0
冯大中	feng'da'zhong	0
凤丹白	feng'dan'bai	0
枫丹白露派	feng'dan'bai'lu'pai	0
冯法祀	feng'fa'si	0
冯国东	feng'guo'dong	0
冯怀荣	feng'huai'rong	0
奉家丽	feng'jia'li	0
冯健慈	feng'jian'ci	0
冯健亲	feng'jian'qin	0
冯椒生	feng'jiao'sheng	0
冯劲草	feng'jing'cao	0
冯丽安	feng'li'an	0
冯莉莉	feng'li'li	0
冯路敏	feng'lu'min	0
蜂蜜黄	feng'mi'huang	0
封明清	feng'ming'qing	0
冯少协	feng'shao'xie	0
冯巍	feng'wei	0
冯文彪	feng'wen'biao	0
冯晓东	feng'xiao'dong	0
冯耀宗	feng'yao'zong	0
封永辉	feng'yong'hui	0
冯玉琪	feng'yu'qi	0
俸振杰	feng'zhen'jie	0
俸正杰	feng'zheng'jie	0
俸正泉	feng'zheng'quan	0
冯忠莲	feng'zhong'lian	0
冯中起	feng'zhong'qi	0
丰子恺	feng'zi'kai	0
傅抱石	fu'bao'shi	0
复背	fu'bei	0
富春山居图	fu'chun'shan'ju'tu	0
傅从深	fu'cong'shen	0
付栋	fu'dong	0
复勾	fu'gou	0
付泓	fu'hong	0
复画	fu'hua	0
夫画贵乎思	fu'hua'gui'hu'si	0
傅慧瑶	fu'hui'yao	0
付经岩	fu'jing'yan	0
弗拉戈纳尔	fu'la'ge'na'er	0
傅丽莉	fu'li'li	0
甫立亚	fu'li'ya	0
符罗飞	fu'luo'fei	0
傅乃琳	fu'nai'lin	0
斧劈皴	fu'pi'cun	0
傅庆丰	fu'qing'feng	0
赋色	fu'se	0
傅色	fu'se	0
复色	fu'se	0
傅申	fu'shen	0
夫受	fu'shou	0
夫水	fu'shui	0
复托	fu'tuo	0
付万福	fu'wan'fu	0
付巍巍	fu'wei'wei	0
付湘灵	fu'xiang'ling	0
付毅	fu'yi	0
复羽	fu'yu	0
傅榆翔	fu'yu'xiang	0
傅泽南	fu'ze'nan	0
傅振杰	fu'zhen'jie	0
付植桂	fu'zhi'gui	0
改琦	gai'qi	0
干草绿	gan'cao'lv	0
干皴	gan'cun	0
甘家伟	gan'jia'wei	0
橄榄黄	gan'lan'huang	0
橄榄描	gan'lan'miao	0
甘明智	gan'ming'zhi	0
甘学明	gan'xue'ming	0
高岑	gao'cen	0
高长宝	gao'chang'bao	0
高昌故城遗址壁画	gao'chang'gu'cheng'yi'zhi'bi'hua	0
高大钢	gao'da'gang	0
高栋	gao'dong	0
高凤翰	gao'feng'han	0
高古游丝描	gao'gu'you'si'miao	0
高冠华	gao'guan'hua	0
高广斌	gao'guang'bin	0
高国芳	gao'guo'fang	0
高海戈	gao'hai'ge	0
高罕宇	gao'han'yu	0
膏肓子	gao'huang'zi	0
高剑父	gao'jian'fu	0
高剑僧	gao'jian'seng	0
高建卓	gao'jian'zhuo	0
高玠瑜	gao'jie'yu	0
高居翰	gao'ju'han	0
高克恭	gao'ke'gong	0
高锟鹏	gao'kun'peng	0
高临安	gao'lin'an	0
高仑	gao'lun	0
高莽	gao'mang	0
高梦琳	gao'meng'lin	0
高鸣峰	gao'ming'feng	0
高明炬	gao'ming'ju	0
高平开化寺壁画	gao'ping'kai'hua'si'bi'hua	0
高平圣姑庙壁画	gao'ping'sheng'gu'miao'bi'hua	0
高奇峰	gao'qi'feng	0
高其佩	gao'qi'pei	0
高骞	gao'qian	0
高且园	gao'qie'yuan	0
高少飞	gao'shao'fei	0
郜少华	gao'shao'hua	0
高胜伟	gao'sheng'wei	0
高士闲居图	gao'shi'xian'ju'tu	0
高嗣昌	gao'si'chang	0
高思桦	gao'si'hua	0
高涛	gao'tao	0
高王禹	gao'wang'yu	0
高伟刚	gao'wei'gang	0
高伟明	gao'wei'ming	0
高文建	gao'wen'jian	0
高文进	gao'wen'jin	0
高西唐	gao'xi'tang	0
高翔	gao'xiang	0
高小翡	gao'xiao'fei	0
高小华	gao'xiao'hua	0
高雄山	gao'xiong'shan	0
高秀德	gao'xiu'de	0
高亚光	gao'ya'guang	0
高延	gao'yan	0
高艳慧	gao'yan'hui	0
高炀	gao'yang	0
高益	gao'yi	0
高一呼	gao'yi'hu	0
高一民	gao'yi'min	0
高迎春	gao'ying'chun	0
高邕	gao'yong	0
高永强	gao'yong'qiang	0
高煜	gao'yu	0
高瑀	gao'yu	0
高远法	gao'yuan'fa	0
高元享	gao'yuan'xiang	0
高振美	gao'zhen'mei	0
高钟炎	gao'zhong'yan	0
高宗英	gao'zong'ying	0
蛤粉	ge'fen	0
葛贵勇	ge'gui'yong	0
铬红	ge'hong	0
镉黄	ge'huang	0
葛鹏仁	ge'peng'ren	0
葛千涛	ge'qian'tao	0
葛世娟	ge'shi'juan	0
葛书清	ge'shu'qing	0
哥特式艺术	ge'te'shi'yi'shu	0
葛维墨	ge'wei'mo	0
戈湘岚	ge'xiang'lan	0
哥雅	ge'ya	0
格言派	ge'yan'pai	0
葛永荟	ge'yong'hui	0
葛煜冬	ge'yu'dong	0
戈跃	ge'yue	0
戈云	ge'yun	0
葛运波	ge'yun'bo	0
葛征	ge'zheng	0
耕庵老人	geng'an'lao'ren	0
耿洪贤	geng'hong'xian	0
耿建翌	geng'jian'yi	0
耕烟散人	geng'yan'san'ren	0
龚半千	gong'ban'qian	0
工笔淡彩	gong'bi'dan'cai	0
工笔国画	gong'bi'guo'hua	0
工笔荷花	gong'bi'he'hua	0
工笔花鸟	gong'bi'hua'niao	0
工笔翎毛	gong'bi'ling'mao	0
工笔牡丹	gong'bi'mu'dan	0
工笔山水	gong'bi'shan'shui	0
工笔重彩	gong'bi'zhong'cai	0
工笔走兽	gong'bi'zou'shou	0
龚晨	gong'chen	0
宫臣	gong'chen	0
巩大君	gong'da'jun	0
龚洪正	gong'hong'zheng	0
龚建庆	gong'jian'qing	0
龚景充	gong'jing'chong	0
龚隽	gong'juan	0
龚开	gong'kai	0
巩克祥	gong'ke'xiang	0
宫立龙	gong'li'long	0
龚顺	gong'shun	0
龚文修	gong'wen'xiu	0
龚文桢	gong'wen'zhen	0
龚武	gong'wu	0
龚贤	gong'xian	0
巩县稍柴村宋墓壁画	gong'xian'shao'chai'cun'song'mu'bi'hua	0
龚星宇	gong'xing'yu	0
宫艳惠	gong'yan'hui	0
龚余辉	gong'yu'hui	0
龚泽贤	gong'ze'xian	0
贡振宝	gong'zhen'bao	0
龚著剑	gong'zhu'jian	0
勾皴	gou'cun	0
垢道人	gou'dao'ren	0
勾花点叶法	gou'hua'dian'ye'fa	0
勾填	gou'tian	0
钩填法	gou'tian'fa	0
苟勖	gou'xu	0
勾须	gou'xu	0
勾晕法	gou'yun'fa	0
顾安	gu'an	0
古波	gu'bo	0
顾重光	gu'chong'guang	0
古典画风	gu'dian'hua'feng	0
古董白	gu'dong'bai	0
顾恩选	gu'en'xuan	0
古格王国遗址壁画	gu'ge'wang'guo'yi'zhi'bi'hua	0
顾公度	gu'gong'du	0
顾国建	gu'guo'jian	0
顾宏强	gu'hong'qiang	0
顾闳中	gu'hong'zhong	0
古画品录	gu'hua'pin'lu	0
顾惠平	gu'hui'ping	0
顾见龙	gu'jian'long	0
骨角画	gu'jiao'hua	0
顾劲松	gu'jin'song	0
谷久文	gu'jiu'wen	0
顾恺之	gu'kai'zhi	0
顾坤伯	gu'kun'bo	0
钴蓝	gu'lan	0
顾亮	gu'liang	0
谷嶙	gu'lin	0
顾洛	gu'luo	0
辜敏	gu'min	0
觚剩	gu'sheng	0
古生	gu'sheng	0
古铜色	gu'tong'se	0
顾伟飞	gu'wei'fei	0
顾维群	gu'wei'qun	0
辜曦	gu'xi	0
顾晓璐	gu'xiao'lu	0
谷旭	gu'xu	0
顾延春	gu'yan'chun	0
古意绿	gu'yi'lv	0
古原	gu'yuan	0
顾致农	gu'zhi'nong	0
钴紫	gu'zi	0
古棕	gu'zong	0
辜宗泽	gu'zong'ze	0
刮除法	gua'chu'fa	0
瓜菱莲蓬图	gua'ling'lian'peng'tu	0
关宏臣	guan'hong'chen	0
贯会学	guan'hui'xue	0
关健	guan'jian	0
管君章	guan'jun'zhang	0
关良	guan'liang	0
关纽	guan'niu	0
管朴学	guan'pu'xue	0
官其格	guan'qi'ge	0
管齐骏	guan'qi'jun	0
关山月	guan'shan'yue	0
关仝	guan'tong	0
管伟骏	guan'wei'jun	0
关维兴	guan'wei'xing	0
关一劲	guan'yi'jin	0
管勇	guan'yong	0
关则驱	guan'ze'qu	0
管镇伟	guan'zhen'wei	0
关紫兰	guan'zi'lan	0
官宗兴	guan'zong'xing	0
光暗紫红	guang'an'zi'hong	0
广汉龙居寺壁画	guang'han'long'ju'si'bi'hua	0
光热蓝	guang're'lan	0
广廷渤	guang'ting'bo	0
光紫红	guang'zi'hong	0
鬼脸皴	gui'lian'cun	0
鬼面皴	gui'mian'cun	0
鲑鱼红	gui'yu'hong	0
国朝画征录	guo'chao'hua'zheng'lu	0
郭侈	guo'chi	0
郭传璋	guo'chuan'zhang	0
郭德海	guo'de'hai	0
郭逢晨	guo'feng'chen	0
过稿	guo'gao	0
郭宏军	guo'hong'jun	0
郭吉超	guo'ji'chao	0
国际绿	guo'ji'lv	0
郭佳慧	guo'jia'hui	0
郭健濂	guo'jian'lian	0
郭建濂	guo'jian'lian	0
郭鉴文	guo'jian'wen	0
郭金平	guo'jin'ping	0
郭金逸	guo'jin'yi	0
郭炯伟	guo'jiong'wei	0
郭凯军	guo'kai'jun	0
郭利莎	guo'li'sha	0
郭利伟	guo'li'wei	0
郭利众	guo'li'zhong	0
郭敏	guo'min	0
郭铭宗	guo'ming'zong	0
国旗红	guo'qi'hong	0
郭茜	guo'qian	0
郭全喜	guo'quan'xi	0
郭群鹏	guo'qun'peng	0
郭仁海	guo'ren'hai	0
郭润文	guo'run'wen	0
郭胜利	guo'sheng'li	0
郭淑莉	guo'shu'li	0
郭味蕖	guo'wei'qu	0
郭维新	guo'wei'xin	0
郭伟璇	guo'wei'xuan	0
郭纹秀	guo'wen'xiu	0
郭熙	guo'xi	0
郭希铨	guo'xi'quan	0
郭晓辉	guo'xiao'hui	0
郭欣荣	guo'xin'rong	0
郭诩	guo'xu	0
郭永文	guo'yong'wen	0
郭友就	guo'you'jiu	0
郭榆生	guo'yu'sheng	0
郭振昌	guo'zhen'chang	0
郭振翔	guo'zhen'xiang	0
郭正善	guo'zheng'shan	0
郭忠恕	guo'zhong'shu	0
郭祖昌	guo'zu'chang	0
海潮阁	hai'chao'ge	0
海军兰	hai'jun'lan	0
海军绿	hai'jun'lv	0
海螺红	hai'luo'hong	0
海幔	hai'man	0
海幕	hai'mu	0
海涛章	hai'tao'zhang	0
海屋奇观图	hai'wu'qi'guan'tu	0
海晏河清图	hai'yan'he'qing'tu	0
海洋蓝	hai'yang'lan	0
韩冰凝	han'bing'ning	0
汉卜千秋墓壁画	han'bu'qian'qiu'mu'bi'hua	0
韩潮	han'chao	0
韩德林	han'de'lin	0
韩干	han'gan	0
韩高璐	han'gao'lu	0
韩国大红	han'guo'da'hong	0
韩国红	han'guo'hong	0
韩海生	han'hai'sheng	0
韩红兵	han'hong'bing	0
韩滉	han'huang	0
韩建宇	han'jian'yu	0
韩景生	han'jing'sheng	0
韩克贺	han'ke'he	0
韩乐基	han'le'ji	0
韩林德	han'lin'de	0
汉墓壁画	han'mu'bi'hua	0
韩培生	han'pei'sheng	0
韩鹏帅	han'peng'shuai	0
韩胜祥	han'sheng'xiang	0
韩世骅	han'shi'hua	0
韩希明	han'xi'ming	0
韩喜增	han'xi'zeng	0
韩向辉	han'xiang'hui	0
韩湘宁	han'xiang'ning	0
韩小莉	han'xiao'li	0
韩旭成	han'xu'cheng	0
韩学铭	han'xue'ming	0
韩娅娟	han'ya'juan	0
韩言松	han'yan'song	0
韩佑	han'you	0
韩祐	han'you	0
韩宇光	han'yu'guang	0
韩原	han'yuan	0
韩枣红	han'zao'hong	0
汉至南北朝寺观壁画	han'zhi'nan'bei'chao'si'guan'bi'hua	0
韩中人	han'zhong'ren	0
韩子川	han'zi'chuan	0
杭春晓	hang'chun'xiao	0
郝澄	hao'cheng	0
郝瑾	hao'jin	0
郝明明	hao'ming'ming	0
郝思维	hao'si'wei	0
郝文杰	hao'wen'jie	0
郝忻中	hao'xin'zhong	0
郝一航	hao'yi'hang	0
郝永明	hao'yong'ming	0
郝友友	hao'you'you	0
郝玉群	hao'yu'qun	0
贺白龙	he'bai'long	0
何灿波	he'can'bo	0
何畅生	he'chang'sheng	0
贺昌泰	he'chang'tai	0
何澄	he'cheng	0
何大桥	he'da'qiao	0
贺大田	he'da'tian	0
贺丹	he'dan	0
贺德华	he'de'hua	0
何登霄	he'deng'xiao	0
何多苓	he'duo'ling	0
何多岺	he'duo'ling	0
何冠霖	he'guan'lin	0
何桂林	he'gui'lin	0
何海霞	he'hai'xia	0
何红舟	he'hong'zhou	0
贺吉德	he'ji'de	0
何家英	he'jia'ying	0
鹤涧	he'jian	0
何净	he'jing	0
贺娟	he'juan	0
何孔德	he'kong'de	0
和丽斌	he'li'bin	0
何立民	he'li'min	0
何立明	he'li'ming	0
贺龙元	he'long'yuan	0
贺明	he'ming	0
何沛礼	he'pei'li	0
何绮兰	he'qi'lan	0
何启陶	he'qi'tao	0
何漆园	he'qi'yuan	0
何庆佳	he'qing'jia	0
何锐强	he'rui'qiang	0
何瑞卿	he'rui'qing	0
何润辉	he'run'hui	0
河上花图卷	he'shang'hua'tu'juan	0
何绍教	he'shao'jiao	0
何水法	he'shui'fa	0
喝涛	he'tao	0
贺天	he'tian	0
贺天健	he'tian'jian	0
何天丽	he'tian'li	0
何天泉	he'tian'quan	0
和铁龙	he'tie'long	0
何维洪	he'wei'hong	0
何维朴	he'wei'pu	0
何玟玦	he'wen'jue	0
河西魏晋墓壁画	he'xi'wei'jin'mu'bi'hua	0
何喜忠	he'xi'zhong	0
何香凝	he'xiang'ning	0
何旭和	he'xu'he	0
何学升	he'xue'sheng	0
贺勋	he'xun	0
贺阳	he'yang	0
何旸	he'yang	0
荷译	he'yi	0
何永方	he'yong'fang	0
何永顺	he'yong'shun	0
何云昌	he'yun'chang	0
何肇衢	he'zhao'qu	0
何振浩	he'zhen'hao	0
何振祥	he'zhen'xiang	0
何祯祥	he'zhen'xiang	0
贺志朴	he'zhi'pu	0
贺枝俏	he'zhi'qiao	0
何仲仪	he'zhong'yi	0
贺祖斌	he'zu'bin	0
黑宝蓝	hei'bao'lan	0
黑宝兰	hei'bao'lan	0
黑灰白	hei'hui'bai	0
黑绿色	hei'lv'se	0
横卷	heng'juan	0
洪丹	hong'dan	0
洪帆	hong'fan	0
洪陔华	hong'gai'hua	0
洪陔华画像	hong'gai'hua'hua'xiang	0
洪浩昌	hong'hao'chang	0
红灰	hong'hui	0
洪嘉植	hong'jia'zhi	0
洪江波	hong'jiang'bo	0
弘觉禅师	hong'jue'chan'shi	0
洪雷	hong'lei	0
虹鸣	hong'ming	0
洪琪	hong'qi	0
弘仁	hong'ren	0
洪瑞生	hong'rui'sheng	0
洪曙强	hong'shu'qiang	0
洪太武	hong'tai'wu	0
洪洞广胜寺壁画	hong'tong'guang'sheng'si'bi'hua	0
洪毅	hong'yi	0
洪郁大	hong'yu'da	0
烘晕	hong'yun	0
洪正治	hong'zheng'zhi	0
厚庵	hou'an	0
侯宝川	hou'bao'chuan	0
侯滨	hou'bin	0
候翠杏	hou'cui'xing	0
侯大春	hou'da'chun	0
侯德	hou'de	0
侯烽民	hou'feng'min	0
侯吉明	hou'ji'ming	0
侯继明	hou'ji'ming	0
侯继尧	hou'ji'yao	0
侯佳良	hou'jia'liang	0
侯俊明	hou'jun'ming	0
侯黎明	hou'li'ming	0
侯路	hou'lu	0
侯马宋墓壁画	hou'ma'song'mu'bi'hua	0
侯荣	hou'rong	0
后蜀孟知祥墓壁画	hou'shu'meng'zhi'xiang'mu'bi'hua	0
后现代艺术	hou'xian'dai'yi'shu	0
候一民	hou'yi'min	0
后印象派	hou'yin'xiang'pai	0
侯钺	hou'yue	0
侯耘	hou'yun	0
侯震	hou'zhen	0
候志峰	hou'zhi'feng	0
侯志民	hou'zhi'min	0
胡本山	hu'ben'shan	0
胡昶	hu'chang	0
胡赤骏	hu'chi'jun	0
胡大虎	hu'da'hu	0
胡大乐	hu'da'le	0
胡道昌	hu'dao'chang	0
胡公寿	hu'gong'shou	0
胡国辉	hu'guo'hui	0
胡国良	hu'guo'liang	0
胡环	hu'huan	0
胡镬	hu'huo	0
胡迹	hu'ji	0
胡继宁	hu'ji'ning	0
胡建斌	hu'jian'bin	0
胡静婷	hu'jing'ting	0
胡榘	hu'ju	0
湖蓝	hu'lan	0
湖兰	hu'lan	0
胡李海	hu'li'hai	0
胡连江	hu'lian'jiang	0
虎林关帝庙壁画	hu'lin'guan'di'miao'bi'hua	0
葫芦皮贴画	hu'lu'pi'tie'hua	0
胡明全	hu'ming'quan	0
胡明之	hu'ming'zhi	0
琥珀粉	hu'po'fen	0
胡棋	hu'qi	0
胡任乂	hu'ren'ai	0
胡仁樵	hu'ren'qiao	0
胡若思	hu'ruo'si	0
瑚山	hu'shan	0
胡善余	hu'shan'yu	0
胡绍生	hu'shao'sheng	0
胡升太	hu'sheng'tai	0
胡世钢	hu'shi'gang	0
胡树明	hu'shu'ming	0
湖水兰	hu'shui'lan	0
湖水绿	hu'shui'lv	0
胡舜臣	hu'shun'chen	0
胡悌麟	hu'ti'lin	0
胡天穹	hu'tian'qiong	0
胡伟达	hu'wei'da	0
胡委伦	hu'wei'lun	0
胡卫明	hu'wei'ming	0
胡炜彦	hu'wei'yan	0
胡文丹	hu'wen'dan	0
胡锡圭	hu'xi'gui	0
胡祥龙	hu'xiang'long	0
胡亚强	hu'ya'qiang	0
胡也佛	hu'ye'fo	0
胡毅	hu'yi	0
胡一川	hu'yi'chuan	0
胡懿勋	hu'yi'xun	0
胡应康	hu'ying'kang	0
胡月峰	hu'yue'feng	0
胡慥	hu'zao	0
胡展	hu'zhan	0
胡朝阳	hu'zhao'yang	0
胡振德	hu'zhen'de	0
胡振宇	hu'zhen'yu	0
胡志鹏	hu'zhi'peng	0
胡志荣	hu'zhi'rong	0
胡专一	hu'zhuan'yi	0
华兵	hua'bing	0
画道彰矣	hua'dao'zhang'yi	0
华堤	hua'di	0
花啡	hua'fei	0
花粉红	hua'fen'hong	0
画风高古	hua'feng'gao'gu	0
画杆	hua'gan	0
画工画	hua'gong'hua	0
花谷	hua'gu	0
滑寒冰	hua'han'bing	0
花黑	hua'hei	0
花灰	hua'hui	0
花灰色	hua'hui'se	0
华继明	hua'ji'ming	0
华剑坤	hua'jian'kun	0
华剑堃	hua'jian'kun	0
花介黄	hua'jie'huang	0
化九	hua'jiu	0
花咖啡	hua'ka'fei	0
花克	hua'ke	0
画卵	hua'luan	0
华鸟	hua'niao	0
花鸟册	hua'niao'ce	0
华喦	hua'nie	0
花青	hua'qing	0
华三川	hua'san'chuan	0
花深灰	hua'shen'hui	0
画受墨	hua'shou'mo	0
滑田友	hua'tian'you	0
画心托纸	hua'xin'tuo'zhi	0
画影线	hua'ying'xian	0
花永	hua'yong	0
花元	hua'yuan	0
画云台山记	hua'yun'tai'shan'ji	0
画爪	hua'zhao	0
淮安宋杨公佐墓壁画	huai'an'song'yang'gong'zuo'mu'bi'hua	0
怀谢楼	huai'xie'lou	0
淮扬洁秋图	huai'yang'jie'qiu'tu	0
郇海霞	huan'hai'xia	0
黄滨	huang'bin	0
黄宾虹	huang'bin'hong	0
黄承志	huang'cheng'zhi	0
黄达诚	huang'da'cheng	0
黄大来	huang'da'lai	0
黄大路	huang'da'lu	0
黄德珍	huang'de'zhen	0
黄登贵	huang'deng'gui	0
黄娣	huang'di	0
黄发策	huang'fa'ce	0
黄发祥	huang'fa'xiang	0
黄凤文	huang'feng'wen	0
黄富满	huang'fu'man	0
黄福霆	huang'fu'ting	0
黄拱烘	huang'gong'hong	0
黄公望	huang'gong'wang	0
黄冠腾	huang'guan'teng	0
黄冠余	huang'guan'yu	0
黄海蓉	huang'hai'rong	0
黄海洋	huang'hai'yang	0
黄汉成	huang'han'cheng	0
黄豪	huang'hao	0
黄河东	huang'he'dong	0
黄红屏	huang'hong'ping	0
黄户	huang'hu	0
黄怀现	huang'huai'xian	0
黄幻吾	huang'huan'wu	0
黄灰色	huang'hui'se	0
黄慧莺	huang'hui'ying	0
黄楫	huang'ji	0
黄吉淳	huang'ji'chun	0
黄家雄	huang'jia'xiong	0
黄建川	huang'jian'chuan	0
黄剑武	huang'jian'wu	0
黄进龙	huang'jin'long	0
黄今声	huang'jin'sheng	0
黄菁	huang'jing	0
黄箐	huang'jing	0
黄景春	huang'jing'chun	0
黄璟翔	huang'jing'xiang	0
黄景哲	huang'jing'zhe	0
黄炯	huang'jiong	0
黄居宝	huang'ju'bao	0
黄居寀	huang'ju'cai	0
黄君璧	huang'jun'bi	0
黄俊峰	huang'jun'feng	0
黄堃源	huang'kun'yuan	0
黄里	huang'li	0
黄丽敏	huang'li'min	0
黄力生	huang'li'sheng	0
黄淋	huang'lin	0
黄律	huang'lv	0
黄茂强	huang'mao'qiang	0
黄苗子	huang'miao'zi	0
黄民辉	huang'min'hui	0
黄铭昌	huang'ming'chang	0
黄鸣六	huang'ming'liu	0
黄明秋	huang'ming'qiu	0
黄铭哲	huang'ming'zhe	0
黄乃源	huang'nai'yuan	0
黄培祯	huang'pei'zhen	0
黄启后	huang'qi'hou	0
黄启覃	huang'qi'qin	0
黄秋园	huang'qiu'yuan	0
黄秋月	huang'qiu'yue	0
黄筌	huang'quan	0
黄权山	huang'quan'shan	0
黄润生	huang'run'sheng	0
黄三胜	huang'san'sheng	0
黄山八胜册	huang'shan'ba'sheng'ce	0
黄山寿	huang'shan'shou	0
黄慎	huang'shen	0
黄世坚	huang'shi'jian	0
黄书林	huang'shu'lin	0
黄淑英	huang'shu'ying	0
黄水安	huang'shui'an	0
黄思法	huang'si'fa	0
黄思熙	huang'si'xi	0
黄腾辉	huang'teng'hui	0
黄题师	huang'ti'shi	0
黄同江	huang'tong'jiang	0
黄惟亮	huang'wei'liang	0
黄位政	huang'wei'zheng	0
黄文韬	huang'wen'tao	0
黄曦农	huang'xi'nong	0
黄希舜	huang'xi'shun	0
黄仙裳	huang'xian'shang	0
黄显之	huang'xian'zhi	0
黄向前	huang'xiang'qian	0
黄萧	huang'xiao	0
黄箫	huang'xiao	0
黄小平	huang'xiao'ping	0
黄小园	huang'xiao'yuan	0
黄学辉	huang'xue'hui	0
黄燕思	huang'yan'si	0
黄彦云	huang'yan'yun	0
黄叶村	huang'ye'cun	0
黄易	huang'yi	0
黄一凡	huang'yi'fan	0
黄因聪	huang'yin'cong	0
黄英浩	huang'ying'hao	0
黄永森	huang'yong'sen	0
黄永玉	huang'yong'yu	0
黄裕平	huang'yu'ping	0
黄云璨	huang'yun'can	0
黄芸芸	huang'yun'yun	0
黄增炎	huang'zeng'yan	0
黄朝华	huang'zhao'hua	0
黄正丹	huang'zheng'dan	0
黄正南	huang'zheng'nan	0
潢治	huang'zhi	0
黄智根	huang'zhi'gen	0
黄志华	huang'zhi'hua	0
黄志琼	huang'zhi'qiong	0
湟中塔尔寺壁画	huang'zhong'ta'er'si'bi'hua	0
黄胄	huang'zhou	0
黄壮	huang'zhuang	0
灰大红	hui'da'hong	0
灰啡	hui'fei	0
灰湖绿	hui'hu'lv	0
灰咖啡	hui'ka'fei	0
灰卡其	hui'ka'qi	0
灰克	hui'ke	0
灰蓝	hui'lan	0
灰兰	hui'lan	0
灰绿	hui'lv	0
灰浅蓝	hui'qian'lan	0
灰深灰	hui'shen'hui	0
回丝画	hui'si'hua	0
惠唯	hui'wei	0
惠欣	hui'xin	0
灰杏	hui'xing	0
蕙岩	hui'yan	0
惠远富	hui'yuan'fu	0
灰丈青	hui'zhang'qing	0
混合技法	hun'he'ji'fa	0
混描	hun'miao	0
浑源永安寺壁画	hun'yuan'yong'an'si'bi'hua	0
火笔画	huo'bi'hua	0
霍春阳	huo'chun'yang	0
霍根仲	huo'gen'zhong	0
霍加斯	huo'jia'si	0
火烙画	huo'lao'hua	0
活性黑	huo'xing'hei	0
霍绪德	huo'xu'de	0
霍昀	huo'yun	0
集安长川号墓壁画	ji'an'chang'chuan'hao'mu'bi'hua	0
集安洞沟号墓壁画	ji'an'dong'gou'hao'mu'bi'hua	0
集安高句丽古墓壁画	ji'an'gao'gou'li'gu'mu'bi'hua	0
集安角抵墓壁画	ji'an'jiao'di'mu'bi'hua	0
集安麻线沟号墓壁画	ji'an'ma'xian'gou'hao'mu'bi'hua	0
集安三室墓壁画	ji'an'san'shi'mu'bi'hua	0
集安四神墓壁画	ji'an'si'shen'mu'bi'hua	0
集安五盔坟号墓壁画	ji'an'wu'kui'fen'hao'mu'bi'hua	0
集安舞踊墓壁画	ji'an'wu'yong'mu'bi'hua	0
集安禹山下号墓壁画	ji'an'yu'shan'xia'hao'mu'bi'hua	0
汲成	ji'cheng	0
季宏敏	ji'hong'min	0
吉厚明	ji'hou'ming	0
集锦版画	ji'jin'ban'hua	0
冀金平	ji'jin'ping	0
纪军郁	ji'jun'yu	0
吉磊	ji'lei	0
肌理效果	ji'li'xiao'guo	0
吉琳	ji'lin	0
济南金墓壁画	ji'nan'jin'mu'bi'hua	0
济南元墓壁画	ji'nan'yuan'mu'bi'hua	0
纪清和	ji'qing'he	0
蓟色	ji'se	0
稷山青龙寺壁画	ji'shan'qing'long'si'bi'hua	0
纪世伟	ji'shi'wei	0
积水法	ji'shui'fa	0
季彤	ji'tong	0
纪炜	ji'wei	0
季翁	ji'weng	0
蓟县观音阁壁画	ji'xian'guan'yin'ge'bi'hua	0
吉小宝	ji'xiao'bao	0
吉晓美	ji'xiao'mei	0
纪晓萍	ji'xiao'ping	0
姬英楠	ji'ying'nan	0
贾涤非	jia'di'fei	0
贾贡	jia'gong	0
贾广健	jia'guang'jian	0
贾靖	jia'jing	0
贾鹃丽	jia'juan'li	0
贾俊龙	jia'jun'long	0
贾励	jia'li	0
贾利涛	jia'li'tao	0
贾利珠	jia'li'zhu	0
贾墨	jia'mo	0
贾启文	jia'qi'wen	0
贾穹	jia'qiong	0
嘉善明墓壁画	jia'shan'ming'mu'bi'hua	0
贾师古	jia'shi'gu	0
佳县白云山庙壁画	jia'xian'bai'yun'shan'miao'bi'hua	0
贾雪东	jia'xue'dong	0
夹叶法	jia'ye'fa	0
贾永光	jia'yong'guang	0
嘉峪关魏晋墓壁画	jia'yu'guan'wei'jin'mu'bi'hua	0
减笔	jian'bi	0
减笔描	jian'bi'miao	0
剪彩贴绒	jian'cai'tie'rong	0
鉴藏印	jian'cang'yin	0
简崇民	jian'chong'min	0
简崇志	jian'chong'zhi	0
剑阁觉苑寺壁画	jian'ge'jue'yuan'si'bi'hua	0
兼工带写	jian'gong'dai'xie	0
碱化黑	jian'hua'hei	0
建平辽墓壁画	jian'ping'liao'mu'bi'hua	0
简正雄	jian'zheng'xiong	0
江岸望山图扇	jiang'an'wang'shan'tu'shan	0
姜宝星	jiang'bao'xing	0
江秉德	jiang'bing'de	0
姜勃	jiang'bo	0
蒋采苹	jiang'cai'ping	0
江参	jiang'can	0
姜长弓	jiang'chang'gong	0
蒋长虹	jiang'chang'hong	0
蒋陈阡	jiang'chen'qian	0
江大海	jiang'da'hai	0
蒋德斌	jiang'de'bin	0
蒋德芳	jiang'de'fang	0
江都县续志	jiang'du'xian'xu'zhi	0
江芳	jiang'fang	0
蒋高仪	jiang'gao'yi	0
江寒汀	jiang'han'ting	0
姜鹤涧	jiang'he'jian	0
蒋恒	jiang'heng	0
江宏伟	jiang'hong'wei	0
蒋焕	jiang'huan	0
姜慧晶	jiang'hui'jing	0
姜甲夫	jiang'jia'fu	0
蒋建军	jiang'jian'jun	0
姜进	jiang'jin	0
姜靖	jiang'jing	0
姜婧	jiang'jing	0
江景云	jiang'jing'yun	0
蒋九痴	jiang'jiu'chi	0
姜骊	jiang'li	0
江利宇	jiang'li'yu	0
蒋梁	jiang'liang	0
江牧庭	jiang'mu'ting	0
蒋启军	jiang'qi'jun	0
姜倩	jiang'qian	0
蒋庆北	jiang'qing'bei	0
蒋如胜	jiang'ru'sheng	0
蒋瑞坑	jiang'rui'keng	0
江山秋色图	jiang'shan'qiu'se'tu	0
江世栋	jiang'shi'dong	0
江树海	jiang'shu'hai	0
蒋嵩	jiang'song	0
姜天雨	jiang'tian'yu	0
蒋庭锡	jiang'ting'xi	0
蒋廷锡	jiang'ting'xi	0
姜旺	jiang'wang	0
蒋巍涛	jiang'wei'tao	0
绛县金墓壁画	jiang'xian'jin'mu'bi'hua	0
姜小靖	jiang'xiao'jing	0
姜晓静	jiang'xiao'jing	0
江宵萍	jiang'xiao'ping	0
江小竽	jiang'xiao'yu	0
江学庆	jiang'xue'qing	0
姜燕	jiang'yan	0
江严冰	jiang'yan'bing	0
蒋烨	jiang'ye	0
蒋逸	jiang'yi	0
姜隐	jiang'yin	0
姜迎久	jiang'ying'jiu	0
姜永杰	jiang'yong'jie	0
江永亭	jiang'yong'ting	0
蒋友舜	jiang'you'shun	0
蒋有作	jiang'you'zuo	0
蒋云仲	jiang'yun'zhong	0
蒋则涌	jiang'ze'yong	0
蒋兆和	jiang'zhao'he	0
姜振文	jiang'zhen'wen	0
姜中立	jiang'zhong'li	0
江孜白居寺壁画	jiang'zi'bai'ju'si'bi'hua	0
蒋宗强	jiang'zong'qiang	0
焦宝愿	jiao'bao'yuan	0
焦秉贞	jiao'bing'zhen	0
焦点透视	jiao'dian'tou'shi	0
角雕画	jiao'diao'hua	0
胶矾	jiao'fan	0
焦方斌	jiao'fang'bin	0
嚼公大师	jiao'gong'da'shi	0
焦可群	jiao'ke'qun	0
矫凌奕	jiao'ling'yi	0
焦墨	jiao'mo	0
矫饰主义	jiao'shi'zhu'yi	0
矫首游观图	jiao'shou'you'guan'tu	0
焦锡	jiao'xi	0
焦小健	jiao'xiao'jian	0
蕉竹菊石图	jiao'zhu'ju'shi'tu	0
焦作老万庄金墓壁画	jiao'zuo'lao'wan'zhuang'jin'mu'bi'hua	0
芥菜绿	jie'cai'lv	0
解放营子辽墓壁画	jie'fang'ying'zi'liao'mu'bi'hua	0
解国平	jie'guo'ping	0
界画	jie'hua	0
介黄	jie'huang	0
介绿	jie'lv	0
芥绿色	jie'lv'se	0
芥末黄	jie'mo'huang	0
芥茉绿	jie'mo'lv	0
接染	jie'ran	0
接染法	jie'ran'fa	0
解索皴	jie'suo'cun	0
介王	jie'wang	0
芥苿绿	jie'wei'lv	0
解文林	jie'wen'lin	0
解玉林	jie'yu'lin	0
介字点	jie'zi'dian	0
金柏松	jin'bai'song	0
金碧皴	jin'bi'cun	0
金碧山水	jin'bi'shan'shui	0
金长安	jin'chang'an	0
金城	jin'cheng	0
金处士	jin'chu'shi	0
金春鹤	jin'chun'he	0
金春霞	jin'chun'xia	0
金春芽	jin'chun'ya	0
金代虞寅墓壁画	jin'dai'yu'yin'mu'bi'hua	0
金殿铭	jin'dian'ming	0
靳东泓	jin'dong'hong	0
金恩绂	jin'en'fu	0
金凡	jin'fan	0
金芬华	jin'fen'hua	0
金辅堂	jin'fu'tang	0
金光真	jin'guang'zhen	0
金海旭	jin'hai'xu	0
劲黑	jin'hei	0
金鸿钧	jin'hong'jun	0
金纪发	jin'ji'fa	0
金甲镇	jin'jia'zhen	0
金坚	jin'jian	0
金俊明	jin'jun'ming	0
金康年	jin'kang'nian	0
金礼浩	jin'li'hao	0
金利虎	jin'li'hu	0
金陵八家	jin'ling'ba'jia	0
金陵梵刹志	jin'ling'fan'cha'zhi	0
金陵十景册	jin'ling'shi'jing'ce	0
金隆贵	jin'long'gui	0
金露庵	jin'lu'an	0
金轮峰	jin'lun'feng	0
金满洙	jin'man'zhu	0
锦眉	jin'mei	0
金纳	jin'na	0
金农	jin'nong	0
靳尚宜	jin'shang'yi	0
金绍凯	jin'shao'kai	0
金属灰	jin'shu'hui	0
金廷标	jin'ting'biao	0
金小民	jin'xiao'min	0
金秀文	jin'xiu'wen	0
锦衣鸿	jin'yi'hong	0
金永镐	jin'yong'gao	0
靳永红	jin'yong'hong	0
金毓清	jin'yu'qing	0
金贞玉	jin'zhen'yu	0
靳之林	jin'zhi'lin	0
金竺朝霞图	jin'zhu'zhao'xia'tu	0
金子禾	jin'zi'he	0
荆安民	jing'an'min	0
京裱	jing'biao	0
荆浩	jing'hao	0
静慧寺	jing'hui'si	0
景嘉录	jing'jia'lu	0
靖江后人	jing'jiang'hou'ren	0
靖江王	jing'jiang'wang	0
景柯文	jing'ke'wen	0
警名派	jing'ming'pai	0
惊绳	jing'sheng	0
静玮	jing'wei	0
镜心	jing'xin	0
惊燕带	jing'yan'dai	0
景玉书	jing'yu'shu	0
荆曰政	jing'yue'zheng	0
经折式	jing'zhe'shi	0
九痴	jiu'chi	0
酒泉丁家闸晋墓壁画	jiu'quan'ding'jia'zha'jin'mu'bi'hua	0
酒泉文殊山石窟壁画	jiu'quan'wen'shu'shan'shi'ku'bi'hua	0
局部复勒	ju'bu'fu'le	0
居巢	ju'chao	0
桔红	ju'hong	0
桔红色	ju'hong'se	0
桔黄	ju'huang	0
橘黄	ju'huang	0
居廉	ju'lian	0
巨然	ju'ran	0
鞠日春	ju'ri'chun	0
巨拴灯	ju'shuan'deng	0
巨云和	ju'yun'he	0
桔子色	ju'zi'se	0
卷勺亭主	juan'shao'ting'zhu	0
卷翁	juan'weng	0
绢印版画	juan'yin'ban'hua	0
卷云皴	juan'yun'cun	0
蠲斋	juan'zhai	0
撅头丁	jue'tou'ding	0
橛头描	jue'tou'miao	0
军湖蓝	jun'hu'lan	0
咖啡红	ka'fei'hong	0
卡萝	ka'luo	0
卡其黄	ka'qi'huang	0
卡其灰	ka'qi'hui	0
卡其绿	ka'qi'lv	0
卡其杏	ka'qi'xing	0
喀什三仙洞壁画	ka'shi'san'xian'dong'bi'hua	0
开先寺	kai'xian'si	0
阚淑萍	kan'shu'ping	0
看杏花诗意图	kan'xing'hua'shi'yi'tu	0
康璨	kang'can	0
康定斯基	kang'ding'si'ji	0
康蕾	kang'lei	0
康连顺	kang'lian'shun	0
康明宇	kang'ming'yu	0
康全安	kang'quan'an	0
炕围画	kang'wei'hua	0
康小华	kang'xiao'hua	0
康营子辽墓壁画	kang'ying'zi'liao'mu'bi'hua	0
康羽	kang'yu	0
康忠勤	kang'zhong'qin	0
拷贝台	kao'bei'tai	0
克宝蓝	ke'bao'lan	0
渴笔	ke'bi	0
渴笔淡墨	ke'bi'dan'mo	0
柯河龙	ke'he'long	0
克灰	ke'hui	0
柯金海	ke'jin'hai	0
柯坎法	ke'kan'fa	0
可可色	ke'ke'se	0
柯科施卡	ke'ke'shi'ka	0
柯兰亭	ke'lan'ting	0
柯利娜	ke'li'na	0
克米白	ke'mi'bai	0
渴墨	ke'mo	0
柯萍	ke'ping	0
克色	ke'se	0
柯适中	ke'shi'zhong	0
柯兴发	ke'xing'fa	0
柯研	ke'yan	0
孔柏基	kong'bai'ji	0
空而妙	kong'er'miao	0
孔凡平	kong'fan'ping	0
孔凡涛	kong'fan'tao	0
孔俊	kong'jun	0
空军深蓝	kong'jun'shen'lan	0
孔兰	kong'lan	0
孔羚	kong'ling	0
孔令泉	kong'ling'quan	0
孔令昕	kong'ling'xin	0
孔绿	kong'lv	0
孔平	kong'ping	0
孔千	kong'qian	0
孔雀蓝	kong'que'lan	0
孔嵩	kong'song	0
孔巍蒙	kong'wei'meng	0
孔向阳	kong'xiang'yang	0
枯柴描	ku'chai'miao	0
库车苏巴什佛寺壁画	ku'che'su'ba'shi'fo'si'bi'hua	0
苦瓜和尚画语录	ku'gua'he'shang'hua'yu'lu	0
骷髅皴	ku'lou'cun	0
库伦号辽墓壁画	ku'lun'hao'liao'mu'bi'hua	0
枯木竹石图	ku'mu'zhu'shi'tu	0
蒯连会	kuai'lian'hui	0
旷昌龙	kuang'chang'long	0
匡剑	kuang'jian	0
邝思雁	kuang'si'yan	0
匡晓英	kuang'xiao'ying	0
邝玉珊	kuang'yu'shan	0
喟翁	kui'weng	0
琨布雷	kun'bu'lei	0
髡残	kun'can	0
拉萨布达拉宫壁画	la'sa'bu'da'la'gong'bi'hua	0
拉萨大昭寺壁画	la'sa'da'zhao'si'bi'hua	0
拉萨小昭寺壁画	la'sa'xiao'zhao'si'bi'hua	0
赖传鉴	lai'chuan'jian	0
赖坤平	lai'kun'ping	0
赖少其	lai'shao'qi	0
赖新龙	lai'xin'long	0
赖征云	lai'zheng'yun	0
兰承兵	lan'cheng'bing	0
蓝充	lan'chong	0
兰凤禹	lan'feng'yu	0
兰海彬	lan'hai'bin	0
蓝弘	lan'hong	0
兰灰	lan'hui	0
兰立斌	lan'li'bin	0
蓝丽娜	lan'li'na	0
兰绿	lan'lv	0
榄绿	lan'lv	0
兰庆星	lan'qing'xing	0
蓝深绿	lan'shen'lv	0
蓝晓辉	lan'xiao'hui	0
蓝妍	lan'yan	0
兰叶描	lan'ye'miao	0
蓝易章	lan'yi'zhang	0
蓝瑛	lan'ying	0
兰紫	lan'zi	0
浪漫主义	lang'man'zhu'yi	0
郎绍君	lang'shao'jun	0
郎世宁	lang'shi'ning	0
阆仙	lang'xian	0
郎小杞	lang'xiao'qi	0
朗雪波	lang'xue'bo	0
琅琊峰	lang'ya'feng	0
狼族绿	lang'zu'lv	0
老涛	lao'tao	0
烙铁画	lao'tie'hua	0
劳宜超	lao'yi'chao	0
劳永乐	lao'yong'le	0
老枝	lao'zhi	0
乐都瞿昙寺壁画	le'du'qu'tan'si'bi'hua	0
勒筋	le'jin	0
勒廓	le'kuo	0
乐龙耀	le'long'yao	0
乐齐弘	le'qi'hong	0
乐石	le'shi	0
雷玻	lei'bo	0
雷刚进	lei'gang'jin	0
雷海帆	lei'hai'fan	0
雷黎明	lei'li'ming	0
雷蕊	lei'rui	0
雷坦	lei'tan	0
雷虞	lei'yu	0
雷运华	lei'yun'hua	0
雷子人	lei'zi'ren	0
冷宏	leng'hong	0
冷金栋	leng'jin'dong	0
冷军	leng'jun	0
冷枚	leng'mei	0
冷萍	leng'ping	0
冷芮萁	leng'rui'qi	0
冷先平	leng'xian'ping	0
李安其	li'an'qi	0
李安忠	li'an'zhong	0
李邦耀	li'bang'yao	0
李保福	li'bao'fu	0
李宝堂	li'bao'tang	0
李宝义	li'bao'yi	0
李本贵	li'ben'gui	0
李本立	li'ben'li	0
李秉刚	li'bing'gang	0
李秉恺	li'bing'kai	0
李秉绶	li'bing'shou	0
李博娜	li'bo'na	0
李昌龙	li'chang'long	0
李长璞	li'chang'pu	0
李朝繁	li'chao'fan	0
李陈辰	li'chen'chen	0
李成	li'cheng	0
李承秀	li'cheng'xiu	0
李成荫	li'cheng'yin	0
李传久	li'chuan'jiu	0
李春耀	li'chun'yao	0
李大方	li'da'fang	0
李大山	li'da'shan	0
李大洋	li'da'yang	0
李德惠	li'de'hui	0
李德镁	li'de'mei	0
李德洙	li'de'zhu	0
李迪	li'di	0
李东东	li'dong'dong	0
李东鸣	li'dong'ming	0
李东霞	li'dong'xia	0
李冬云	li'dong'yun	0
李东泽	li'dong'ze	0
李端	li'duan	0
李二东	li'er'dong	0
黎发标	li'fa'biao	0
李方明	li'fang'ming	0
李方赝	li'fang'yan	0
李方膺	li'fang'ying	0
里非彐	li'fei'ji	0
立粉	li'fen	0
立粉法	li'fen'fa	0
李凤军	li'feng'jun	0
李芙	li'fu	0
李福荣	li'fu'rong	0
李复堂	li'fu'tang	0
李福岩	li'fu'yan	0
李付元	li'fu'yuan	0
李革	li'ge	0
李公麟	li'gong'lin	0
李谷雨	li'gu'yu	0
李广德	li'guang'de	0
黎广修淡墨山水壁画	li'guang'xiu'dan'mo'shan'shui'bi'hua	0
李广元	li'guang'yuan	0
李贵军	li'gui'jun	0
李贵君	li'gui'jun	0
李贵南	li'gui'nan	0
李贵男	li'gui'nan	0
李国成	li'guo'cheng	0
李国麟	li'guo'lin	0
李海兵	li'hai'bing	0
李海建	li'hai'jian	0
李海良	li'hai'liang	0
李海旺	li'hai'wang	0
李鸿昌	li'hong'chang	0
李红春	li'hong'chun	0
李红东	li'hong'dong	0
李化吉	li'hua'ji	0
李华琪	li'hua'qi	0
李华文	li'hua'wen	0
李华英	li'hua'ying	0
李槐惠	li'huai'hui	0
李彗	li'hui	0
李慧勇	li'hui'yong	0
李集春	li'ji'chun	0
李佶华	li'ji'hua	0
李继开	li'ji'kai	0
李吉平	li'ji'ping	0
李继森	li'ji'sen	0
李济勇	li'ji'yong	0
厉家恩	li'jia'en	0
黎简	li'jian	0
李剑果	li'jian'guo	0
黎建明	li'jian'ming	0
丽江壁画	li'jiang'bi'hua	0
丽江大宝积宫壁画	li'jiang'da'bao'ji'gong'bi'hua	0
李江峰	li'jiang'feng	0
李杰华	li'jie'hua	0
李晋庚	li'jin'geng	0
李劲堃	li'jin'kun	0
李金泉	li'jin'quan	0
厉靖	li'jing	0
李景芳	li'jing'fang	0
李竞飞	li'jing'fei	0
李居银	li'ju'yin	0
李觉	li'jue	0
李珺	li'jun	0
李俊彪	li'jun'biao	0
李钧西	li'jun'xi	0
李俊潇	li'jun'xiao	0
李衎	li'kan	0
李克难	li'ke'nan	0
李可染	li'ke'ran	0
李苦禅	li'ku'chan	0
李魁正	li'kui'zheng	0
李老十	li'lao'shi	0
李利峰	li'li'feng	0
李立人	li'li'ren	0
李驎	li'lin	0
李林祥	li'lin'xiang	0
李霖珍	li'lin'zhen	0
李林琢	li'lin'zhuo	0
李领	li'ling	0
李玲燕	li'ling'yan	0
李马林	li'ma'lin	0
李卯	li'mao	0
李茂虎	li'mao'hu	0
李孟军	li'meng'jun	0
李葂	li'mian	0
李敏强	li'min'qiang	0
李鸣鸣	li'ming'ming	0
李沛聪	li'pei'cong	0
李培真	li'pei'zhen	0
李朋林	li'peng'lin	0
李平秋	li'ping'qiu	0
李平生	li'ping'sheng	0
李启林	li'qi'lin	0
李前	li'qian	0
李钦华	li'qin'hua	0
李青萍	li'qing'ping	0
李庆文	li'qing'wen	0
李群力	li'qun'li	0
李荣洲	li'rong'zhou	0
李瑞锋	li'rui'feng	0
李瑞年	li'rui'nian	0
李瑞清	li'rui'qing	0
李瑞祥	li'rui'xiang	0
李瑞兆	li'rui'zhao	0
李鱓	li'shan	0
李山	li'shan	0
李绍平	li'shao'ping	0
李胜民	li'sheng'min	0
李世南	li'shi'nan	0
李石樵	li'shi'qiao	0
李诗润	li'shi'run	0
李士学	li'shi'xue	0
李师中	li'shi'zhong	0
李世倬	li'shi'zhuo	0
李寿远	li'shou'yuan	0
李书成	li'shu'cheng	0
李姝青	li'shu'qing	0
李顺砚	li'shun'yan	0
李思训	li'si'xun	0
李丝云	li'si'yun	0
李丝竹	li'si'zhu	0
李嵩	li'song	0
李松青	li'song'qing	0
李松松	li'song'song	0
李坦克	li'tan'ke	0
李唐	li'tang	0
立体派	li'ti'pai	0
立体主义	li'ti'zhu'yi	0
李天基	li'tian'ji	0
李天军	li'tian'jun	0
李天祥	li'tian'xiang	0
李天元	li'tian'yuan	0
李铁夫	li'tie'fu	0
李铁香	li'tie'xiang	0
黎望一	li'wang'yi	0
李伟光	li'wei'guang	0
李卫明	li'wei'ming	0
李伟年	li'wei'nian	0
李文菁	li'wen'jing	0
李文素	li'wen'su	0
黎文旺	li'wen'wang	0
李喜成	li'xi'cheng	0
李锡武	li'xi'wu	0
李鲜	li'xian	0
李宪	li'xian	0
李先锋	li'xian'feng	0
李先润	li'xian'run	0
李祥震	li'xiang'zhen	0
李小澄	li'xiao'cheng	0
李效成	li'xiao'cheng	0
李小镜	li'xiao'jing	0
李啸军	li'xiao'jun	0
李新兰	li'xin'lan	0
李新月	li'xin'yue	0
李行简	li'xing'jian	0
黎雄才	li'xiong'cai	0
李秀实	li'xiu'shi	0
李旭鹤	li'xu'he	0
黎洵	li'xun	0
李焱	li'yan	0
李延洲	li'yan'zhou	0
李夜冰	li'ye'bing	0
李一丙	li'yi'bing	0
李奕家	li'yi'jia	0
李毅士	li'yi'shi	0
李义堂	li'yi'tang	0
李依依	li'yi'yi	0
李胤	li'yin	0
黎永泰	li'yong'tai	0
李永裕	li'yong'yu	0
李勇哲	li'yong'zhe	0
李友昌	li'you'chang	0
李友宜	li'you'yi	0
李昱成	li'yu'cheng	0
李玉峰	li'yu'feng	0
李昱华	li'yu'hua	0
李于昆	li'yu'kun	0
李豫闽	li'yu'min	0
李育勤	li'yu'qin	0
李驭时	li'yu'shi	0
立于一画	li'yu'yi'hua	0
李裕源	li'yu'yuan	0
李源恒	li'yuan'heng	0
李院立	li'yuan'li	0
李岳	li'yue	0
栗月	li'yue	0
李月领	li'yue'ling	0
李云锋	li'yun'feng	0
李泽浩	li'ze'hao	0
李增国	li'zeng'guo	0
李占鸿	li'zhan'hong	0
李占卿	li'zhan'qing	0
李昭道	li'zhao'dao	0
李召明	li'zhao'ming	0
李真	li'zhen	0
李振飞	li'zhen'fei	0
李振宏	li'zhen'hong	0
李振凯	li'zhen'kai	0
李真胜	li'zhen'sheng	0
李正康	li'zheng'kang	0
李忠新	li'zhong'xin	0
李忠元	li'zhong'yuan	0
立轴	li'zhou	0
李著	li'zhu	0
李灼	li'zhuo	0
李卓杰	li'zhuo'jie	0
李自刚	li'zi'gang	0
李自建	li'zi'jian	0
李宗海	li'zong'hai	0
莲泊居士	lian'bo'ju'shi	0
廉夫	lian'fu	0
莲红色	lian'hong'se	0
连建兴	lian'jian'xing	0
连淑蕙	lian'shu'hui	0
楝亭	lian'ting	0
廉学铭	lian'xue'ming	0
廉学洺	lian'xue'ming	0
梁秉森	liang'bing'sen	0
亮部	liang'bu	0
梁承坚	liang'cheng'jian	0
梁福莲	liang'fu'lian	0
梁古一	liang'gu'yi	0
梁海阳	liang'hai'yang	0
梁昊鹏	liang'hao'peng	0
亮红	liang'hong	0
梁宏理	liang'hong'li	0
梁华涛	liang'hua'tao	0
梁楷	liang'kai	0
梁蓝波	liang'lan'bo	0
梁力宏	liang'li'hong	0
亮面	liang'mian	0
梁佩兰	liang'pei'lan	0
梁山汉墓壁画	liang'shan'han'mu'bi'hua	0
梁树年	liang'shu'nian	0
梁树鹏	liang'shu'peng	0
梁欣基	liang'xin'ji	0
梁新宙	liang'xin'zhou	0
梁雄德	liang'xiong'de	0
梁彦达	liang'yan'da	0
梁耀辉	liang'yao'hui	0
梁药亭	liang'yao'ting	0
梁奕焚	liang'yi'fen	0
梁一杰	liang'yi'jie	0
梁玉龙	liang'yu'long	0
梁玉玺	liang'yu'xi	0
梁云庭	liang'yun'ting	0
梁志东	liang'zhi'dong	0
梁智龙	liang'zhi'long	0
梁宗孟	liang'zong'meng	0
梁宗梦	liang'zong'meng	0
蓼葊	liao'an	0
廖邦铭	liao'bang'ming	0
廖本生	liao'ben'sheng	0
辽陈国公主墓壁画	liao'chen'guo'gong'zhu'mu'bi'hua	0
廖德政	liao'de'zheng	0
辽韩佚墓壁画	liao'han'yi'mu'bi'hua	0
廖炯模	liao'jiong'mo	0
廖曼	liao'man	0
辽墓壁画	liao'mu'bi'hua	0
廖宁	liao'ning	0
辽庆陵壁画	liao'qing'ling'bi'hua	0
廖汝友	liao'ru'you	0
廖瑞容	liao'rui'rong	0
廖梧城	liao'wu'cheng	0
廖修平	liao'xiu'ping	0
辽阳棒台子汉墓壁画	liao'yang'bang'tai'zi'han'mu'bi'hua	0
辽阳棒台子号墓壁画	liao'yang'bang'tai'zi'hao'mu'bi'hua	0
辽阳北园汉墓壁画	liao'yang'bei'yuan'han'mu'bi'hua	0
辽阳北园号墓壁画	liao'yang'bei'yuan'hao'mu'bi'hua	0
辽阳鹅房村号墓壁画	liao'yang'e'fang'cun'hao'mu'bi'hua	0
辽阳汉墓壁画	liao'yang'han'mu'bi'hua	0
辽阳三道壕汉墓壁画	liao'yang'san'dao'hao'han'mu'bi'hua	0
辽阳三道壕号墓壁画	liao'yang'san'dao'hao'hao'mu'bi'hua	0
辽阳魏晋墓壁画	liao'yang'wei'jin'mu'bi'hua	0
辽阳窑厂汉墓壁画	liao'yang'yao'chang'han'mu'bi'hua	0
廖羽	liao'yu	0
廖跃	liao'yue	0
辽赵德钧墓壁画	liao'zhao'de'jun'mu'bi'hua	0
林彩君	lin'cai'jun	0
林晨曦	lin'chen'xi	0
林椿	lin'chun	0
林纯孝	lin'chun'xiao	0
林春岩	lin'chun'yan	0
林达川	lin'da'chuan	0
林大为	lin'da'wei	0
林大梓	lin'da'zi	0
林道福	lin'dao'fu	0
林得芳	lin'de'fang	0
林风眠	lin'feng'mian	0
林贵洪	lin'gui'hong	0
林海春	lin'hai'chun	0
林宏基	lin'hong'ji	0
林鸿铭	lin'hong'ming	0
林加冰	lin'jia'bing	0
林剑峰	lin'jian'feng	0
林江团	lin'jiang'tuan	0
林金宝	lin'jin'bao	0
林金福	lin'jin'fu	0
林景超	lin'jing'chao	0
林静文	lin'jing'wen	0
林俊民	lin'jun'min	0
林良	lin'liang	0
林鸰	lin'ling	0
林玲兰	lin'ling'lan	0
林隆发	lin'long'fa	0
林茂雄	lin'mao'xiong	0
林梅芳	lin'mei'fang	0
林美均	lin'mei'jun	0
林鸣岗	lin'ming'gang	0
林能超	lin'neng'chao	0
林攀科	lin'pan'ke	0
林鹏飞	lin'peng'fei	0
林启天	lin'qi'tian	0
林琴南	lin'qin'nan	0
林泉高致集	lin'quan'gao'zhi'ji	0
林善文	lin'shan'wen	0
林少东	lin'shao'dong	0
林胜正	lin'sheng'zheng	0
林时九	lin'shi'jiu	0
林仕乐	lin'shi'le	0
林淑如	lin'shu'ru	0
林松雄	lin'song'xiong	0
林俗成	lin'su'cheng	0
临榻	lin'ta	0
林泰然	lin'tai'ran	0
林庭珪	lin'ting'gui	0
林伟祥	lin'wei'xiang	0
林锡堂	lin'xi'tang	0
林贤才	lin'xian'cai	0
林宪茂	lin'xian'mao	0
林祥庚	lin'xiang'geng	0
林旭	lin'xu	0
林雪玲	lin'xue'ling	0
林学伟	lin'xue'wei	0
林耀中	lin'yao'zhong	0
林一鹤	lin'yi'he	0
林以友	lin'yi'you	0
林印吉	lin'yin'ji	0
林永康	lin'yong'kang	0
林友智	lin'you'zhi	0
林有志	lin'you'zhi	0
林钰源	lin'yu'yuan	0
林曰惠	lin'yue'hui	0
林则军	lin'ze'jun	0
林昭延	lin'zhao'yan	0
林正文	lin'zheng'wen	0
林钟远	lin'zhong'yuan	0
林子超	lin'zi'chao	0
灵宝晋墓壁画	ling'bao'jin'mu'bi'hua	0
凌必正	ling'bi'zheng	0
零丁老人	ling'ding'lao'ren	0
凌徽涛	ling'hui'tao	0
凌金华	ling'jin'hua	0
铃木敬	ling'mu'jing	0
凌启宁	ling'qi'ning	0
凌清	ling'qing	0
灵石资寿寺壁画	ling'shi'zi'shou'si'bi'hua	0
凌行志	ling'xing'zhi	0
柳岸清秋图	liu'an'qing'qiu'tu	0
刘白山	liu'bai'shan	0
刘比华	liu'bi'hua	0
刘采	liu'cai	0
刘寀	liu'cai	0
刘长新	liu'chang'xin	0
六朝四家	liu'chao'si'jia	0
刘春建	liu'chun'jian	0
刘春龙	liu'chun'long	0
刘大为	liu'da'wei	0
刘道醇	liu'dao'chun	0
刘德进	liu'de'jin	0
刘德六	liu'de'liu	0
刘德润	liu'de'run	0
刘德维	liu'de'wei	0
刘登科	liu'deng'ke	0
刘东京	liu'dong'jing	0
刘东路	liu'dong'lu	0
六法论	liu'fa'lun	0
刘非	liu'fei	0
刘枫桦	liu'feng'hua	0
刘凤兰	liu'feng'lan	0
刘凤林	liu'feng'lin	0
刘锋植	liu'feng'zhi	0
刘福鹏	liu'fu'peng	0
刘芙蓉	liu'fu'rong	0
刘福忠	liu'fu'zhong	0
刘港顺	liu'gang'shun	0
刘贯道	liu'guan'dao	0
刘冠伦	liu'guan'lun	0
刘光光	liu'guang'guang	0
刘贵宾	liu'gui'bin	0
刘桂炳	liu'gui'bing	0
刘国安	liu'guo'an	0
刘国夫	liu'guo'fu	0
刘国枢	liu'guo'shu	0
刘海栗	liu'hai'li	0
刘海粟	liu'hai'su	0
刘海湾	liu'hai'wan	0
刘汉鼎	liu'han'ding	0
刘洪伟	liu'hong'wei	0
刘红艺	liu'hong'yi	0
硫化克	liu'hua'ke	0
柳黄	liu'huang	0
刘会民	liu'hui'min	0
刘惠政	liu'hui'zheng	0
刘火红	liu'huo'hong	0
刘吉川	liu'ji'chuan	0
刘继卤	liu'ji'lu	0
刘继卣	liu'ji'you	0
刘佳林	liu'jia'lin	0
刘嘉伟	liu'jia'wei	0
刘渐郡	liu'jian'jun	0
刘剑伟	liu'jian'wei	0
刘鲸	liu'jing	0
刘箐华	liu'jing'hua	0
刘景胜	liu'jing'sheng	0
刘竞生	liu'jing'sheng	0
刘静涛	liu'jing'tao	0
刘景鑫	liu'jing'xin	0
刘九庵	liu'jiu'an	0
刘竣	liu'jun	0
刘俊彪	liu'jun'biao	0
刘君量	liu'jun'liang	0
刘慨	liu'kai	0
刘奎龄	liu'kui'ling	0
刘冷月	liu'leng'yue	0
刘礼波	liu'li'bo	0
刘立冬	liu'li'dong	0
刘丽芬	liu'li'fen	0
刘力上	liu'li'shang	0
刘立业	liu'li'ye	0
刘凌沧	liu'ling'cang	0
刘令华	liu'ling'hua	0
刘履中	liu'lv'zhong	0
刘满全	liu'man'quan	0
刘曼文	liu'man'wen	0
刘勐	liu'meng	0
刘明彪	liu'ming'biao	0
刘明孝	liu'ming'xiao	0
刘南	liu'nan	0
刘南一	liu'nan'yi	0
刘佩丽	liu'pei'li	0
刘沛沛	liu'pei'pei	0
刘其昌	liu'qi'chang	0
刘骐鸣	liu'qi'ming	0
刘其伟	liu'qi'wei	0
刘启祥	liu'qi'xiang	0
柳青波	liu'qing'bo	0
刘青砚	liu'qing'yan	0
刘仁杰	liu'ren'jie	0
刘仁庆	liu'ren'qing	0
刘榕	liu'rong	0
刘荣春	liu'rong'chun	0
刘三多	liu'san'duo	0
柳瑟曼	liu'se'man	0
刘绍隽	liu'shao'juan	0
刘绍昆	liu'shao'kun	0
刘少牛	liu'shao'niu	0
刘声宏	liu'sheng'hong	0
刘时栋	liu'shi'dong	0
刘世键	liu'shi'jian	0
刘世健	liu'shi'jian	0
刘士嶙	liu'shi'lin	0
刘守祯	liu'shou'zhen	0
刘淑芬	liu'shu'fen	0
刘淑敏	liu'shu'min	0
刘水英	liu'shui'ying	0
刘思昂	liu'si'ang	0
刘松年	liu'song'nian	0
刘溯	liu'su	0
刘遂海	liu'sui'hai	0
刘穗艳	liu'sui'yan	0
刘天呈	liu'tian'cheng	0
刘婉	liu'wan	0
刘维标	liu'wei'biao	0
刘维海	liu'wei'hai	0
刘维里	liu'wei'li	0
刘维强	liu'wei'qiang	0
刘文进	liu'wen'jin	0
刘文星	liu'wen'xing	0
刘武安	liu'wu'an	0
留溪外传	liu'xi'wai'zhuan	0
刘献中	liu'xian'zhong	0
刘向久	liu'xiang'jiu	0
刘骁纯	liu'xiao'chun	0
刘小旦	liu'xiao'dan	0
刘晓第	liu'xiao'di	0
刘小冀	liu'xiao'ji	0
刘晓姝	liu'xiao'shu	0
刘心河	liu'xin'he	0
刘芯涛	liu'xin'tao	0
刘兴涛	liu'xing'tao	0
刘幸伟	liu'xing'wei	0
刘秀鸣	liu'xiu'ming	0
刘旭川	liu'xu'chuan	0
刘旭阳	liu'xu'yang	0
刘学伦	liu'xue'lun	0
刘寻	liu'xun	0
刘洵	liu'xun	0
刘亚安	liu'ya'an	0
刘雅慧	liu'ya'hui	0
刘雅男	liu'ya'nan	0
柳严	liu'yan	0
刘彦赤	liu'yan'chi	0
刘延明	liu'yan'ming	0
刘延顺	liu'yan'shun	0
刘彦勇	liu'yan'yong	0
柳叶描	liu'ye'miao	0
刘溢	liu'yi	0
刘一层	liu'yi'ceng	0
刘义山	liu'yi'shan	0
刘艺斯	liu'yi'si	0
刘依闻	liu'yi'wen	0
刘颖林	liu'ying'lin	0
刘颖悟	liu'ying'wu	0
刘影钊	liu'ying'zhao	0
刘颙	liu'yong	0
刘拥	liu'yong	0
刘永成	liu'yong'cheng	0
刘永培	liu'yong'pei	0
刘庸之	liu'yong'zhi	0
刘宇钢	liu'yu'gang	0
刘玉兰	liu'yu'lan	0
刘宇廉	liu'yu'lian	0
刘玉山	liu'yu'shan	0
刘运环	liu'yun'huan	0
刘芸芸	liu'yun'yun	0
刘兆武	liu'zhao'wu	0
刘哲志	liu'zhe'zhi	0
刘震力	liu'zhen'li	0
刘政瑜	liu'zheng'yu	0
刘治	liu'zhi	0
刘之光	liu'zhi'guang	0
刘志平	liu'zhi'ping	0
刘忠臣	liu'zhong'chen	0
刘忠法	liu'zhong'fa	0
刘洲军	liu'zhou'jun	0
柳子谷	liu'zi'gu	0
刘子平	liu'zi'ping	0
刘宗古	liu'zong'gu	0
刘祖英	liu'zu'ying	0
刘作筹	liu'zuo'chou	0
龙戈凡	long'ge'fan	0
龙克渊	long'ke'yuan	0
龙力游	long'li'you	0
龙全	long'quan	0
陇任	long'ren	0
龙升	long'sheng	0
陇艺梅	long'yi'mei	0
漏矾	lou'fan	0
娄婕	lou'jie	0
娄溥义	lou'pu'yi	0
娄齐贵	lou'qi'gui	0
娄申义	lou'shen'yi	0
娄师白	lou'shi'bai	0
陋轩集	lou'xuan'ji	0
卢柏森	lu'bai'sen	0
鲁邦林	lu'bang'lin	0
陆琤	lu'cheng	0
陆成钢	lu'cheng'gang	0
陆成刚	lu'cheng'gang	0
鹿成君	lu'cheng'jun	0
卢成翔	lu'cheng'xiang	0
陆驰	lu'chi	0
卢东明	lu'dong'ming	0
鲁凡	lu'fan	0
卢光照	lu'guang'zhao	0
陆国英	lu'guo'ying	0
陆国源	lu'guo'yuan	0
鲁恒心	lu'heng'xin	0
路宏	lu'hong	0
陆怀道	lu'huai'dao	0
陆恢	lu'hui	0
芦继庆	lu'ji'qing	0
卢家华	lu'jia'hua	0
路家明	lu'jia'ming	0
鹿角啡	lu'jiao'fei	0
鹿角树法	lu'jiao'shu'fa	0
鹿角枝	lu'jiao'zhi	0
陆静波	lu'jing'bo	0
路巨鼎	lu'ju'ding	0
卢坤峰	lu'kun'feng	0
陆磊	lu'lei	0
卢楞迦	lu'leng'jia	0
陆铭	lu'ming	0
卢明德	lu'ming'de	0
卢明远	lu'ming'yuan	0
路鹏	lu'peng	0
陆琦	lu'qi	0
陆巧玲	lu'qiao'ling	0
陆青	lu'qing	0
陆庆龙	lu'qing'long	0
陆全根	lu'quan'gen	0
陆润痒	lu'run'yang	0
庐山志	lu'shan'zhi	0
鹿少君	lu'shao'jun	0
鲁树凯	lu'shu'kai	0
鲁顺	lu'shun	0
芦粟皮贴画	lu'su'pi'tie'hua	0
庐梭伽	lu'suo'jia	0
麓台	lu'tai	0
麓台题画稿	lu'tai'ti'hua'gao	0
陆探微	lu'tan'wei	0
陆天宁	lu'tian'ning	0
卢铁柱	lu'tie'zhu	0
陆维钊	lu'wei'zhao	0
鹿翁	lu'weng	0
鲁晓波	lu'xiao'bo	0
陆薪	lu'xin	0
陆信忠	lu'xin'zhong	0
鹿逊理	lu'xun'li	0
陆俨少	lu'yan'shao	0
芦雁图	lu'yan'tu	0
卢野	lu'ye	0
陆逸	lu'yi	0
陆抑非	lu'yi'fei	0
卢怡仲	lu'yi'zhong	0
卢英能	lu'ying'neng	0
卢禹舜	lu'yu'shun	0
陆煜玮	lu'yu'wei	0
陆源	lu'yuan	0
卢云峰	lu'yun'feng	0
卢云亭	lu'yun'ting	0
路璋	lu'zhang	0
陆治	lu'zhi	0
陆志宏	lu'zhi'hong	0
卢忠臣	lu'zhong'chen	0
卢忠免	lu'zhong'mian	0
陆宗	lu'zong	0
鲁宗贵	lu'zong'gui	0
卢宗远	lu'zong'yuan	0
乱柴皴	luan'chai'cun	0
乱麻皴	luan'ma'cun	0
栾小杰	luan'xiao'jie	0
罗必武	luo'bi'wu	0
罗炳芳	luo'bing'fang	0
罗春建	luo'chun'jian	0
罗春杰	luo'chun'jie	0
罗尔纯	luo'er'chun	0
罗发辉	luo'fa'hui	0
罗芙奥	luo'fu'ao	0
骆根兴	luo'gen'xing	0
罗国贤	luo'guo'xian	0
罗和	luo'he	0
罗洪洁	luo'hong'jie	0
罗珲	luo'hui	0
罗健玲	luo'jian'ling	0
洛可可风格	luo'ke'ke'feng'ge	0
洛可可艺术	luo'ke'ke'yi'shu	0
罗徕	luo'lai	0
罗蓝紫	luo'lan'zi	0
罗兰紫	luo'lan'zi	0
罗丽丽	luo'li'li	0
罗灵	luo'ling	0
骆楠	luo'nan	0
罗聘	luo'pin	0
罗庆发	luo'qing'fa	0
罗青红	luo'qing'hong	0
罗荃	luo'quan	0
罗荃木	luo'quan'mu	0
罗如琪	luo'ru'qi	0
罗锐和	luo'rui'he	0
罗三行	luo'san'hang	0
罗实	luo'shi	0
骆太生	luo'tai'sheng	0
罗田喜	luo'tian'xi	0
骆驼色	luo'tuo'se	0
罗文健	luo'wen'jian	0
罗文勇	luo'wen'yong	0
罗晓波	luo'xiao'bo	0
罗晓航	luo'xiao'hang	0
罗亚岚	luo'ya'lan	0
洛阳八里台汉墓壁画	luo'yang'ba'li'tai'han'mu'bi'hua	0
洛阳北魏墓壁画	luo'yang'bei'wei'mu'bi'hua	0
洛阳西汉墓壁画	luo'yang'xi'han'mu'bi'hua	0
罗耀辉	luo'yao'hui	0
罗应龙	luo'ying'long	0
罗允绍	luo'yun'shao	0
罗允缵	luo'yun'zuan	0
洛贞	luo'zhen	0
罗稚川	luo'zhi'chuan	0
吕成友	lv'cheng'you	0
吕恩谊	lv'en'yi	0
吕锋平	lv'feng'ping	0
吕凤子	lv'feng'zi	0
吕冠慧	lv'guan'hui	0
吕广磊	lv'guang'lei	0
吕浩元	lv'hao'yuan	0
吕红光	lv'hong'guang	0
绿灰色	lv'hui'se	0
吕纪	lv'ji	0
吕吉人	lv'ji'ren	0
绿兰	lv'lan	0
吕山川	lv'shan'chuan	0
吕顺	lv'shun	0
吕斯百	lv'si'bai	0
吕晓丹	lv'xiao'dan	0
吕小鹏	lv'xiao'peng	0
吕裕民	lv'yu'min	0
吕玉祥	lv'yu'xiang	0
吕远清	lv'yuan'qing	0
吕志鹏	lv'zhi'peng	0
吕仲华	lv'zhong'hua	0
麻爱周	ma'ai'zhou	0
马柏龄	ma'bai'ling	0
马伯龄	ma'bo'ling	0
马楚	ma'chu	0
马东锡	ma'dong'xi	0
马方静	ma'fang'jing	0
马格利特	ma'ge'li'te	0
马光剑	ma'guang'jian	0
马贵中	ma'gui'zhong	0
马国峰	ma'guo'feng	0
马和之	ma'he'zhi	0
马红宾	ma'hong'bin	0
马洪彦	ma'hong'yan	0
蚂蝗描	ma'huang'miao	0
马蝗描	ma'huang'miao	0
马惠生	ma'hui'sheng	0
马家桐	ma'jia'tong	0
马建初	ma'jian'chu	0
马晋	ma'jin	0
马金梁	ma'jin'liang	0
马君详	ma'jun'xiang	0
马克佑	ma'ke'you	0
马逵	ma'kui	0
马立华	ma'li'hua	0
马利民	ma'li'min	0
马鳞	ma'lin	0
马琦	ma'qi	0
马秋丽	ma'qiu'li	0
马全富	ma'quan'fu	0
马群雄	ma'qun'xiong	0
马榕君	ma'rong'jun	0
马善程	ma'shan'cheng	0
马绍仁	ma'shao'ren	0
马珅	ma'shen	0
马世峰	ma'shi'feng	0
马寿斌	ma'shou'bin	0
马树林	ma'shu'lin	0
马树青	ma'shu'qing	0
马斯黑	ma'si'hei	0
马松林	ma'song'lin	0
马素华	ma'su'hua	0
马天戈	ma'tian'ge	0
马田宽	ma'tian'kuan	0
马琬	ma'wan	0
马惟军	ma'wei'jun	0
马文婷	ma'wen'ting	0
马贤昌	ma'xian'chang	0
麻显钢	ma'xian'gang	0
马晓光	ma'xiao'guang	0
马啸天	ma'xiao'tian	0
马小勇	ma'xiao'yong	0
马新平	ma'xin'ping	0
马星华	ma'xing'hua	0
马兴祖	ma'xing'zu	0
马学文	ma'xue'wen	0
马雪妍	ma'xue'yan	0
马亚萍	ma'ya'ping	0
马延红	ma'yan'hong	0
马雁生	ma'yan'sheng	0
马野	ma'ye	0
马一丹	ma'yi'dan	0
马艺星	ma'yi'xing	0
马玉红	ma'yu'hong	0
马远	ma'yuan	0
马元驳	ma'yuan'bo	0
马云萍	ma'yun'ping	0
马志文	ma'zhi'wen	0
麦秆剪贴	mai'gan'jian'tie	0
麦秸画	mai'jie'hua	0
麦秸剪贴	mai'jie'jian'tie	0
麦时炜	mai'shi'wei	0
麦时玮	mai'shi'wei	0
麦水蓝	mai'shui'lan	0
毛本华	mao'ben'hua	0
茅丛英	mao'cong'ying	0
毛毳	mao'cui	0
毛东升	mao'dong'sheng	0
毛凤德	mao'feng'de	0
毛进	mao'jin	0
毛毛绿	mao'mao'lv	0
毛明跃	mao'ming'yue	0
毛胜达	mao'sheng'da	0
毛松	mao'song	0
毛同强	mao'tong'qiang	0
毛文佐	mao'wen'zuo	0
毛信科	mao'xin'ke	0
毛艳阳	mao'yan'yang	0
毛益	mao'yi	0
毛以钢	mao'yi'gang	0
毛以岗	mao'yi'gang	0
茅以芸	mao'yi'yun	0
茅斋著书图	mao'zhai'zhu'shu'tu	0
毛宗种	mao'zong'zhong	0
梅东升	mei'dong'sheng	0
没骨	mei'gu	0
没骨皴	mei'gu'cun	0
没骨法	mei'gu'fa	0
玫瑰红	mei'gui'hong	0
美国洛杉矶市美术馆	mei'guo'luo'shan'ji'shi'mei'shu'guan	0
煤黑	mei'hei	0
玫红粉	mei'hong'fen	0
梅清	mei'qing	0
美术批评家	mei'shu'pi'ping'jia	0
梅新武	mei'xin'wu	0
梅渊公	mei'yuan'gong	0
门简成	men'jian'cheng	0
孟二虎	meng'er'hu	0
孟凡江	meng'fan'jiang	0
孟光	meng'guang	0
孟黎	meng'li	0
孟丽丽	meng'li'li	0
孟禄丁	meng'lu'ding	0
孟庆湘	meng'qing'xiang	0
蒙绍华	meng'shao'hua	0
孟宪文	meng'xian'wen	0
孟新宇	meng'xin'yu	0
孟薛光	meng'xue'guang	0
孟远洪	meng'yuan'hong	0
孟远烘	meng'yuan'hong	0
梦园书画录	meng'yuan'shu'hua'lu	0
蒙志刚	meng'zhi'gang	0
米白黄	mi'bai'huang	0
米白灰	mi'bai'hui	0
米白桔色	mi'bai'ju'se	0
米白克	mi'bai'ke	0
米白色	mi'bai'se	0
米点皴	mi'dian'cun	0
米芾	mi'fu	0
米红	mi'hong	0
米龙果	mi'long'guo	0
密绿	mi'lv	0
米王	mi'wang	0
米晓波	mi'xiao'bo	0
米杏	mi'xing	0
米友仁	mi'you'ren	0
秘园雅集	mi'yuan'ya'ji	0
秘云腾	mi'yun'teng	0
眠生子	mian'sheng'zi	0
苗福生	miao'fu'sheng	0
苗景昌	miao'jing'chang	0
闵华	min'hua	0
闽江春色图	min'jiang'chun'se'tu	0
闵廉风	min'lian'feng	0
闵希文	min'xi'wen	0
闵一耀	min'yi'yao	0
闵贞	min'zhen	0
明暗法	ming'an'fa	0
明代寺观壁画	ming'dai'si'guan'bi'hua	0
明代院体	ming'dai'yuan'ti	0
名号章	ming'hao'zhang	0
明皇幸蜀图	ming'huang'xing'shu'tu	0
鸣六	ming'liu	0
明四家	ming'si'jia	0
明星峰	ming'xing'feng	0
明则化	ming'ze'hua	0
命纸	ming'zhi	0
缪炳泰	miu'bing'tai	0
缪惠新	miu'hui'xin	0
缪远洋	miu'yuan'yang	0
莫宾	mo'bin	0
墨不碍色	mo'bu'ai'se	0
莫大风	mo'da'feng	0
莫大林	mo'da'lin	0
墨分五彩	mo'fen'wu'cai	0
墨分五色	mo'fen'wu'se	0
墨海青龙	mo'hai'qing'long	0
莫鸿勋	mo'hong'xun	0
莫建成	mo'jian'cheng	0
墨绛红	mo'jiang'hong	0
墨蓝	mo'lan	0
墨破色	mo'po'se	0
墨青色	mo'qing'se	0
墨染	mo'ran	0
墨洒金	mo'sa'jin	0
磨石绿	mo'shi'lv	0
墨受笔	mo'shou'bi	0
墨水蓝	mo'shui'lan	0
莫晓松	mo'xiao'song	0
莫晓旭	mo'xiao'xu	0
莫也	mo'ye	0
墨玉绿	mo'yu'lv	0
墨韵	mo'yun	0
墨紫	mo'zi	0
牟达器	mou'da'qi	0
牟恒	mou'heng	0
牟林童	mou'lin'tong	0
穆滨	mu'bin	0
木陈道忞	mu'chen'dao'min	0
牡丹红	mu'dan'hong	0
母军	mu'jun	0
牡蛎白	mu'li'bai	0
慕凌飞	mu'ling'fei	0
目绿	mu'lv	0
穆倩	mu'qian	0
木蕊画	mu'rui'hua	0
墓室壁画	mu'shi'bi'hua	0
穆婷	mu'ting	0
牧溪	mu'xi	0
穆小飞	mu'xiao'fei	0
那比派	na'bi'pai	0
娜仁花	na'ren'hua	0
娜乌拉	na'wu'la	0
乃东昌珠寺壁画	nai'dong'chang'zhu'si'bi'hua	0
乃东赞塘寺壁画	nai'dong'zan'tang'si'bi'hua	0
乃东则错巴寺壁画	nai'dong'ze'cuo'ba'si'bi'hua	0
奶油杏	nai'you'xing	0
南北宗	nan'bei'zong	0
南超	nan'chao	0
南海岩	nan'hai'yan	0
南山云树卷	nan'shan'yun'shu'juan	0
南宋四家	nan'song'si'jia	0
南唐钦陵壁画	nan'tang'qin'ling'bi'hua	0
南阳公主祠壁画	nan'yang'gong'zhu'ci'bi'hua	0
哪吒闹海壁画	ne'zha'nao'hai'bi'hua	0
嫩芽绿	nen'ya'lv	0
嫩牙绿	nen'ya'lv	0
能圆能方	neng'yuan'neng'fang	0
能直能曲	neng'zhi'neng'qu	0
倪端	ni'duan	0
逆锋	ni'feng	0
霓红绿	ni'hong'lv	0
倪洪气	ni'hong'qi	0
泥黄	ni'huang	0
泥灰蓝	ni'hui'lan	0
倪林海	ni'lin'hai	0
倪墨耕	ni'mo'geng	0
倪田	ni'tian	0
倪云林	ni'yun'lin	0
倪瓒	ni'zan	0
念扎	nian'zha	0
鸟兽草木	niao'shou'cao'mu	0
聂南祥	nie'nan'xiang	0
聂炜	nie'wei	0
宁冬来	ning'dong'lai	0
宁方倩	ning'fang'qian	0
柠黄	ning'huang	0
柠檬黄	ning'meng'huang	0
柠檬绿	ning'meng'lv	0
柠檬王	ning'meng'wang	0
宁维贵	ning'wei'gui	0
宁霄冲	ning'xiao'chong	0
牛丹	niu'dan	0
牛津黑	niu'jin'hei	0
牛津蓝	niu'jin'lan	0
牛力生	niu'li'sheng	0
牛连和	niu'lian'he	0
牛毛皴	niu'mao'cun	0
牛敏	niu'min	0
牛学勇	niu'xue'yong	0
牛运功	niu'yun'gong	0
牛仔蓝	niu'zai'lan	0
牛仔兰	niu'zai'lan	0
农安万金塔基壁画	nong'an'wan'jin'ta'ji'bi'hua	0
浓淡干湿	nong'dan'gan'shi	0
农应龙	nong'ying'long	0
农永梅	nong'yong'mei	0
暖阳橙	nuan'yang'cheng	0
欧楚坚	ou'chu'jian	0
欧国和	ou'guo'he	0
藕红	ou'hong	0
欧姬芙	ou'ji'fu	0
欧普主义	ou'pu'zhu'yi	0
鸥阳	ou'yang	0
欧阳飞	ou'yang'fei	0
欧阳杰	ou'yang'jie	0
欧玉龙	ou'yu'long	0
欧展昂	ou'zhan'ang	0
拍拓	pai'tuo	0
拍拓法	pai'tuo'fa	0
潘德彬	pan'de'bin	0
潘德海	pan'de'hai	0
潘崮	pan'gu	0
潘桂	pan'gui	0
潘国华	pan'guo'hua	0
潘蘅生	pan'heng'sheng	0
潘鸿海	pan'hong'hai	0
潘鸿倩	pan'hong'qian	0
潘家峻	pan'jia'jun	0
潘建涛	pan'jian'tao	0
潘惊雷	pan'jing'lei	0
潘罗敏	pan'luo'min	0
潘世勋	pan'shi'xun	0
潘天寿	pan'tian'shou	0
潘廷章	pan'ting'zhang	0
潘文亮	pan'wen'liang	0
潘文艳	pan'wen'yan	0
潘文逸	pan'wen'yi	0
潘小东	pan'xiao'dong	0
潘晓冬	pan'xiao'dong	0
潘小海	pan'xiao'hai	0
潘潇潇	pan'xiao'xiao	0
潘雄易	pan'xiong'yi	0
潘耀辉	pan'yao'hui	0
潘璎	pan'ying	0
潘映熹	pan'ying'xi	0
潘志平	pan'zhi'ping	0
庞淳	pang'chun	0
庞浩淼	pang'hao'miao	0
庞惠宇	pang'hui'yu	0
庞均	pang'jun	0
庞珂	pang'ke	0
庞茂坤	pang'mao'kun	0
庞薰琹	pang'xun'qin	0
庞熏琴	pang'xun'qin	0
庞熏琹	pang'xun'qin	0
庞元济	pang'yuan'ji	0
庞钟霖	pang'zhong'lin	0
跑墨	pao'mo	0
佩恩灰	pei'en'hui	0
裴晶	pei'jing	0
裴林安	pei'lin'an	0
佩文斋书画谱	pei'wen'zhai'shu'hua'pu	0
裴小平	pei'xiao'ping	0
裴咏梅	pei'yong'mei	0
配纸	pei'zhi	0
裴庄欣	pei'zhuang'xin	0
彭爱明	peng'ai'ming	0
彭比德	peng'bi'de	0
彭承军	peng'cheng'jun	0
彭传芳	peng'chuan'fang	0
彭栋梁	peng'dong'liang	0
彭恭甫	peng'gong'fu	0
彭鸿远	peng'hong'yuan	0
彭建忠	peng'jian'zhong	0
彭军军	peng'jun'jun	0
彭丕	peng'pi	0
彭麒	peng'qi	0
彭燃	peng'ran	0
彭伟蘅	peng'wei'heng	0
蓬溪宝梵寺壁画	peng'xi'bao'fan'si'bi'hua	0
彭毅	peng'yi	0
彭有全	peng'you'quan	0
彭育中	peng'yu'zhong	0
彭智仁	peng'zhi'ren	0
彭志信	peng'zhi'xin	0
彭中杰	peng'zhong'jie	0
劈斧皴	pi'fu'cun	0
匹练峰	pi'lian'feng	0
披麻皴	pi'ma'cun	0
批毛	pi'mao	0
批毛法	pi'mao'fa	0
皮秋丽	pi'qiu'li	0
片状羽	pian'zhuang'yu	0
品正	pin'zheng	0
平定元墓壁画	ping'ding'yuan'mu'bi'hua	0
平陆枣园汉墓壁画	ping'lu'zao'yuan'han'mu'bi'hua	0
平顺大云院壁画	ping'shun'da'yun'yuan'bi'hua	0
平头点	ping'tou'dian	0
平涂	ping'tu	0
平远法	ping'yuan'fa	0
坡石	po'shi	0
朴承浩	pu'cheng'hao	0
朴光燮	pu'guang'xie	0
铺毫	pu'hao	0
蒲华	pu'hua	0
浦捷	pu'jie	0
溥伒	pu'jin	0
普蓝	pu'lan	0
溥儒	pu'ru	0
蒲生文	pu'sheng'wen	0
葡萄红	pu'tao'hong	0
葡萄色	pu'tao'se	0
菩提纱画	pu'ti'sha'hua	0
溥僴	pu'xian	0
蒲鑫	pu'xin	0
溥心畬	pu'xin'she	0
朴学成	pu'xue'cheng	0
溥佐	pu'zuo	0
祁百成	qi'bai'cheng	0
齐白石	qi'bai'shi	0
亓兵	qi'bing	0
启朝荣	qi'chao'rong	0
齐程翔	qi'cheng'xiang	0
齐传玉	qi'chuan'yu	0
齐春江	qi'chun'jiang	0
其春曰	qi'chun'yue	0
祁大夔	qi'da'kui	0
漆德琰	qi'de'yan	0
其冬日	qi'dong'ri	0
祁海平	qi'hai'ping	0
祁辉浪	qi'hui'lang	0
齐捷	qi'jie	0
祁崑	qi'kun	0
漆蓝	qi'lan	0
齐良迟	qi'liang'chi	0
岂梦光	qi'meng'guang	0
齐梦慧	qi'meng'hui	0
齐牧冬	qi'mu'dong	0
其秋日	qi'qiu'ri	0
起田	qi'tian	0
齐文清	qi'wen'qing	0
其夏曰	qi'xia'yue	0
齐潇	qi'xiao	0
齐英石	qi'ying'shi	0
祁志龙	qi'zhi'long	0
浅宝蓝	qian'bao'lan	0
浅宝兰	qian'bao'lan	0
浅彩兰	qian'cai'lan	0
浅橙	qian'cheng	0
浅橙色	qian'cheng'se	0
钱大经	qian'da'jing	0
钱德华	qian'de'hua	0
浅豆绿	qian'dou'lv	0
钱杜	qian'du	0
浅啡	qian'fei	0
浅啡红	qian'fei'hong	0
浅粉	qian'fen	0
浅粉橙	qian'fen'cheng	0
浅粉红	qian'fen'hong	0
浅粉蓝	qian'fen'lan	0
浅粉兰	qian'fen'lan	0
浅海蓝	qian'hai'lan	0
浅褐绿	qian'he'lv	0
浅湖蓝	qian'hu'lan	0
钱化佛	qian'hua'fo	0
浅花杏	qian'hua'xing	0
钱惠安	qian'hui'an	0
钱慧安	qian'hui'an	0
浅灰蓝	qian'hui'lan	0
浅灰兰	qian'hui'lan	0
浅灰绿	qian'hui'lv	0
浅绛	qian'jiang	0
浅绛红	qian'jiang'hong	0
浅金黄	qian'jin'huang	0
浅桔	qian'ju	0
浅桔黄	qian'ju'huang	0
浅军绿	qian'jun'lv	0
浅咖啡	qian'ka'fei	0
浅卡其	qian'ka'qi	0
浅兰	qian'lan	0
欠冷	qian'leng	0
千里江山图	qian'li'jiang'shan'tu	0
浅莲红	qian'lian'hong	0
浅绿	qian'lv	0
浅麻灰	qian'ma'hui	0
浅梅红	qian'mei'hong	0
浅玫红	qian'mei'hong	0
浅柠黄	qian'ning'huang	0
浅牛仔蓝	qian'niu'zai'lan	0
钱鹏虎	qian'peng'hu	0
浅青绿	qian'qing'lv	0
浅深灰	qian'shen'hui	0
钱瘦铁	qian'shou'tie	0
钱松喦	qian'song'nie	0
钱松岩	qian'song'yan	0
钱松碞	qian'song'yan	0
浅碳灰	qian'tan'hui	0
浅桃红	qian'tao'hong	0
钱铁石	qian'tie'shi	0
浅驼	qian'tuo	0
浅驼色	qian'tuo'se	0
钱维城	qian'wei'cheng	0
浅瑕黄	qian'xia'huang	0
钱晓敏	qian'xiao'min	0
浅杏	qian'xing	0
浅杏色	qian'xing'se	0
钱选	qian'xuan	0
千阳汉墓壁画	qian'yang'han'mu'bi'hua	0
浅洋红	qian'yang'hong	0
钱忆锋	qian'yi'feng	0
钱逸敏	qian'yi'min	0
钱员	qian'yuan	0
钱志林	qian'zhi'lin	0
浅紫白	qian'zi'bai	0
浅紫红	qian'zi'hong	0
浅子兰	qian'zi'lan	0
浅紫蓝	qian'zi'lan	0
蔷眉紫	qiang'mei'zi	0
强润伟	qiang'run'wei	0
强桑	qiang'sang	0
墙围画	qiang'wei'hua	0
乔保华	qiao'bao'hua	0
峭峰插天图轴	qiao'feng'cha'tian'tu'zhou	0
乔浩	qiao'hao	0
乔晓光	qiao'xiao'guang	0
乔业美	qiao'ye'mei	0
且憨斋	qie'han'zhai	0
茄红	qie'hong	0
秦宝利	qin'bao'li	0
秦恩锦	qin'en'jin	0
秦富春	qin'fu'chun	0
秦寒光	qin'han'guang	0
秦和平	qin'he'ping	0
秦皇岛孟姜女庙壁画	qin'huang'dao'meng'jiang'nv'miao'bi'hua	0
秦建川	qin'jian'chuan	0
秦建新	qin'jian'xin	0
秦克温	qin'ke'wen	0
沁蕾	qin'lei	0
秦龙妹	qin'long'mei	0
秦琦	qin'qi	0
沁水圣天寺壁画	qin'shui'sheng'tian'si'bi'hua	0
秦旺才	qin'wang'cai	0
秦文清	qin'wen'qing	0
琴弦描	qin'xian'miao	0
秦秀杰	qin'xiu'jie	0
秦元魁	qin'yuan'kui	0
秦元阅	qin'yuan'yue	0
秦赞军	qin'zan'jun	0
秦祖永	qin'zu'yong	0
清白音	qing'bai'yin	0
青草绿	qing'cao'lv	0
清初四王	qing'chu'si'wang	0
青春绿	qing'chun'lv	0
青古铜色	qing'gu'tong'se	0
清画家诗史	qing'hua'jia'shi'shi	0
青灰	qing'hui	0
清晖画跋	qing'hui'hua'ba	0
卿科军	qing'ke'jun	0
青莲	qing'lian	0
青莲草阁	qing'lian'cao'ge	0
青绿	qing'lv	0
青绿山水	qing'lv'shan'shui	0
青绿山水法	qing'lv'shan'shui'fa	0
清墨	qing'mo	0
卿清	qing'qing	0
清四家	qing'si'jia	0
清四僧	qing'si'seng	0
清态	qing'tai	0
青藤白阳	qing'teng'bai'yang	0
青王	qing'wang	0
清溪小舟图	qing'xi'xiao'zhou'tu	0
清湘	qing'xiang	0
清湘陈人	qing'xiang'chen'ren	0
清湘大涤子	qing'xiang'da'di'zi	0
清湘道人	qing'xiang'dao'ren	0
清湘老人	qing'xiang'lao'ren	0
穷款	qiong'kuan	0
邱秉恒	qiu'bing'heng	0
龟兹壁画	qiu'ci'bi'hua	0
邱慈波	qiu'ci'bo	0
丘堤	qiu'di	0
虬峰	qiu'feng	0
裘凤	qiu'feng	0
虬峰文集	qiu'feng'wen'ji	0
裘高太	qiu'gao'tai	0
邱光平	qiu'guang'ping	0
邱炯炯	qiu'jiong'jiong	0
秋绿	qiu'lv	0
秋趣图	qiu'qu'tu	0
邱胜贤	qiu'sheng'xian	0
邱世海	qiu'shi'hai	0
邱世华	qiu'shi'hua	0
邱松妙	qiu'song'miao	0
丘卫军	qiu'wei'jun	0
秋香绿	qiu'xiang'lv	0
邱新良	qiu'xin'liang	0
邱亚才	qiu'ya'cai	0
邱野	qiu'ye	0
蚯蚓描	qiu'yin'miao	0
仇英	qiu'ying	0
邱兆宗	qiu'zhao'zong	0
区柏	qu'bai	0
区础坚	qu'chu'jian	0
屈鼎	qu'ding	0
区焕礼	qu'huan'li	0
曲尽其态	qu'jin'qi'tai	0
区景山	qu'jing'shan	0
曲佩林	qu'pei'lin	0
瞿山	qu'shan	0
去芜	qu'wu	0
曲湘建	qu'xiang'jian	0
区欣文	qu'xin'wen	0
取形用势	qu'xing'yong'shi	0
曲岩	qu'yan	0
曲阳北岳庙壁画	qu'yang'bei'yue'miao'bi'hua	0
全东植	quan'dong'zhi	0
权善姬	quan'shan'ji	0
全山石	quan'shan'shi	0
全贤国	quan'xian'guo	0
全镇范	quan'zhen'fan	0
雀蓝	que'lan	0
雀绿	que'lv	0
阙正纲	que'zheng'gang	0
群青	qun'qing	0
染庵居士	ran'an'ju'shi	0
染古	ran'gu	0
冉国洪	ran'guo'hong	0
冉劲松	ran'jin'song	0
冉玲	ran'ling	0
冉茂芹	ran'mao'qin	0
饶国安	rao'guo'an	0
饶松青	rao'song'qing	0
饶湘平	rao'xiang'ping	0
饶宇朴	rao'yu'pu	0
忍庵	ren'an	0
任伯年	ren'bo'nian	0
任伯温	ren'bo'wen	0
任承达	ren'cheng'da	0
任传文	ren'chuan'wen	0
任福生	ren'fu'sheng	0
任洪杰	ren'hong'jie	0
任堇	ren'jin	0
任俊明	ren'jun'ming	0
任克涛	ren'ke'tao	0
任丽君	ren'li'jun	0
任率英	ren'lv'ying	0
任梦璋	ren'meng'zhang	0
任仁发	ren'ren'fa	0
任士龙	ren'shi'long	0
任世民	ren'shi'min	0
任思鸿	ren'si'hong	0
任伟全	ren'wei'quan	0
人为物蔽	ren'wei'wu'bi	0
人为物使	ren'wei'wu'shi	0
任雯	ren'wen	0
任霞	ren'xia	0
任晓斌	ren'xiao'bin	0
任小林	ren'xiao'lin	0
任熊	ren'xiong	0
任薰	ren'xun	0
任亚胜	ren'ya'sheng	0
任颐	ren'yi	0
任预	ren'yu	0
任站芳	ren'zhan'fang	0
任之玉	ren'zhi'yu	0
任志忠	ren'zhi'zhong	0
任重	ren'zhong	0
任自忠	ren'zi'zhong	0
日出黄	ri'chu'huang	0
日光黄	ri'guang'huang	0
日喀则拉当寺壁画	ri'ka'ze'la'dang'si'bi'hua	0
日喀则夏鲁寺壁画	ri'ka'ze'xia'lu'si'bi'hua	0
日喀则庄孜寺壁画	ri'ka'ze'zhuang'zi'si'bi'hua	0
荣小鹏	rong'xiao'peng	0
荣小朋	rong'xiao'peng	0
荣志彬	rong'zhi'bin	0
绒状羽	rong'zhuang'yu	0
揉纸	rou'zhi	0
入如揭	ru'ru'jie	0
阮界望	ruan'jie'wang	0
软绿	ruan'lv	0
软木画	ruan'mu'hua	0
阮庆祥	ruan'qing'xiang	0
阮友仁	ruan'you'ren	0
洒红	sa'hong	0
萨迦寺壁画	sa'jia'si'bi'hua	0
散点透视	san'dian'tou'shi	0
三矾九染	san'fan'jiu'ran	0
三间色	san'jian'se	0
三青	san'qing	0
三色式装裱	san'se'shi'zhuang'biao	0
桑建国	sang'jian'guo	0
桑建新	sang'jian'xin	0
色不碍墨	se'bu'ai'mo	0
色破墨	se'po'mo	0
森林之歌壁画	sen'lin'zhi'ge'bi'hua	0
纱白	sha'bai	0
沙德安	sha'de'an	0
沙馥	sha'fu	0
纱画	sha'hua	0
沙璘	sha'lin	0
沙柳木	sha'liu'mu	0
沙耆	sha'qi	0
沙智滨	sha'zhi'bin	0
沙棕	sha'zong	0
山川人物	shan'chuan'ren'wu	0
山窗读书图	shan'chuang'du'shu'tu	0
山林乐事图	shan'lin'le'shi'tu	0
山路听泉图	shan'lu'ting'quan'tu	0
鄯善土峪沟石窟壁画	shan'shan'tu'yu'gou'shi'ku'bi'hua	0
山水清音图	shan'shui'qing'yin'tu	0
山堂读书图	shan'tang'du'shu'tu	0
山嘴子号墓壁画	shan'zui'zi'hao'mu'bi'hua	0
山作	shan'zuo	0
尚德周	shang'de'zhou	0
上官周	shang'guan'zhou	0
尚沪生	shang'hu'sheng	0
尚立滨	shang'li'bin	0
尚苏阳	shang'su'yang	0
上题下图	shang'ti'xia'tu	0
上尾筒	shang'wei'tong	0
尚扬	shang'yang	0
尚扬亦	shang'yang'yi	0
商应丽	shang'ying'li	0
上元花	shang'yuan'hua	0
商振纯	shang'zhen'chun	0
邵传榖	shao'chuan'gu	0
韶关号宋墓壁画	shao'guan'hao'song'mu'bi'hua	0
邵晶坤	shao'jing'kun	0
邵丽华	shao'li'hua	0
邵黎明	shao'li'ming	0
邵念慈	shao'nian'ci	0
邵伟尧	shao'wei'yao	0
邵新	shao'xin	0
绍兴太平天国壁画	shao'xing'tai'ping'tian'guo'bi'hua	0
邵雪	shao'xue	0
邵亚川	shao'ya'chuan	0
邵泽军	shao'ze'jun	0
邵增虎	shao'zeng'hu	0
邵智	shao'zhi	0
佘芳涛	she'fang'tao	0
佘国纲	she'guo'gang	0
社会写实主义	she'hui'xie'shi'zhu'yi	0
歙县圣僧庵壁画	she'xian'sheng'seng'an'bi'hua	0
佘兴利	she'xing'li	0
慎庵	shen'an	0
深暗红	shen'an'hong	0
深宝蓝	shen'bao'lan	0
深宝兰	shen'bao'lan	0
深彩蓝	shen'cai'lan	0
深彩兰	shen'cai'lan	0
深蔵青	shen'cang'qing	0
深草绿	shen'cao'lv	0
深橙	shen'cheng	0
深橙红	shen'cheng'hong	0
深橙色	shen'cheng'se	0
沈大慈	shen'da'ci	0
沈道鸿	shen'dao'hong	0
沈德坤	shen'de'kun	0
沈东荣	shen'dong'rong	0
沈尔调	shen'er'tiao	0
申凡	shen'fan	0
深粉	shen'fen	0
深粉红	shen'fen'hong	0
沈复明	shen'fu'ming	0
深铬绿	shen'ge'lv	0
沈广耀	shen'guang'yao	0
沈光宇	shen'guang'yu	0
深果绿	shen'guo'lv	0
深海蓝	shen'hai'lan	0
沈汉武	shen'han'wu	0
深褐绿	shen'he'lv	0
沈红泉	shen'hong'quan	0
深湖蓝	shen'hu'lan	0
深湖绿	shen'hu'lv	0
深花灰	shen'hua'hui	0
深灰蓝	shen'hui'lan	0
深灰兰	shen'hui'lan	0
深灰紫	shen'hui'zi	0
深活性黑	shen'huo'xing'hei	0
沈加蔚	shen'jia'wei	0
沈嘉蔚	shen'jia'wei	0
深介绿	shen'jie'lv	0
沈晶照	shen'jing'zhao	0
深桔红	shen'ju'hong	0
深桔黄	shen'ju'huang	0
沈俊杰	shen'jun'jie	0
深军蓝	shen'jun'lan	0
深军绿	shen'jun'lv	0
深咖啡	shen'ka'fei	0
深卡其	shen'ka'qi	0
深克	shen'ke	0
沈克荣	shen'ke'rong	0
深兰	shen'lan	0
沈雷震	shen'lei'zhen	0
深绿	shen'lv	0
深梅红	shen'mei'hong	0
深玫红	shen'mei'hong	0
深梅紫	shen'mei'zi	0
深玫紫	shen'mei'zi	0
沈铭存	shen'ming'cun	0
沈名存	shen'ming'cun	0
深木绿	shen'mu'lv	0
申木养	shen'mu'yang	0
深葡萄红	shen'pu'tao'hong	0
沈其斌	shen'qi'bin	0
申晴华	shen'qing'hua	0
深青灰	shen'qing'hui	0
深青绿	shen'qing'lv	0
沈铨	shen'quan	0
沈韶	shen'shao	0
申胜秋	shen'sheng'qiu	0
沈士充	shen'shi'chong	0
申石伽	shen'shi'jia	0
沈曙	shen'shu	0
深炭灰	shen'tan'hui	0
深桃红	shen'tao'hong	0
深天蓝	shen'tian'lan	0
深天兰	shen'tian'lan	0
沈天万	shen'tian'wan	0
深驼	shen'tuo	0
深王	shen'wang	0
申伟光	shen'wei'guang	0
深玟红	shen'wen'hong	0
沈五集	shen'wu'ji	0
沈希远	shen'xi'yuan	0
深杏	shen'xing	0
沈行工	shen'xing'gong	0
沈也	shen'ye	0
沈伊默	shen'yi'mo	0
沈一斋	shen'yi'zhai	0
沈永燕	shen'yong'yan	0
深远法	shen'yuan'fa	0
深月	shen'yue	0
深枣红	shen'zao'hong	0
沈兆涵	shen'zhao'han	0
沈哲哉	shen'zhe'zai	0
沈志鸿	shen'zhi'hong	0
沈志全	shen'zhi'quan	0
沈周	shen'zhou	0
沈祝华	shen'zhu'hua	0
深子	shen'zi	0
深子红	shen'zi'hong	0
深紫红	shen'zi'hong	0
深紫蓝	shen'zi'lan	0
深棕灰	shen'zong'hui	0
沈宗骞	shen'zong'qian	0
盛昌年	sheng'chang'nian	0
盛二龙	sheng'er'long	0
生褐	sheng'he	0
生绢	sheng'juan	0
圣歧	sheng'qi	0
盛琦	sheng'qi	0
盛万清	sheng'wan'qing	0
生宣	sheng'xuan	0
圣延绿	sheng'yan'lv	0
生赭	sheng'zhe	0
石爱雄	shi'ai'xiong	0
实庵	shi'an	0
十八描	shi'ba'miao	0
石白	shi'bai	0
十百斋主人	shi'bai'zhai'zhu'ren	0
湿笔	shi'bi	0
湿壁画	shi'bi'hua	0
石壁山人	shi'bi'shan'ren	0
石成峰	shi'cheng'feng	0
石冲	shi'chong	0
施初晓	shi'chu'xiao	0
师帆	shi'fan	0
石分三面	shi'fen'san'mian	0
史凤军	shi'feng'jun	0
士夫画	shi'fu'hua	0
石膏翻模法	shi'gao'fan'mo'fa	0
实公	shi'gong	0
石谷	shi'gu	0
石广武	shi'guang'wu	0
史国良	shi'guo'liang	0
史国强	shi'guo'qiang	0
石泓	shi'hong	0
石宏建	shi'hong'jian	0
石画	shi'hua	0
诗画合璧卷	shi'hua'he'bi'juan	0
时惠	shi'hui	0
石灰绿	shi'hui'lv	0
石家庄毗卢寺壁画	shi'jia'zhuang'pi'lu'si'bi'hua	0
石建都	shi'jian'du	0
施剑华	shi'jian'hua	0
施锦荣	shi'jin'rong	0
史晶	shi'jing	0
石卡其	shi'ka'qi	0
石恪	shi'ke	0
蚀刻法	shi'ke'fa	0
石窟壁画	shi'ku'bi'hua	0
石蓝	shi'lan	0
施乐群	shi'le'qun	0
石立峰	shi'li'feng	0
石梁观瀑图轴	shi'liang'guan'pu'tu'zhou	0
史良友	shi'liang'you	0
石榴萱草图	shi'liu'xuan'cao'tu	0
十六应真图卷	shi'liu'ying'zhen'tu'juan	0
石鲁	shi'lu	0
石绿	shi'lv	0
石梦	shi'meng	0
石罴	shi'pi	0
石奇人	shi'qi'ren	0
史前美术	shi'qian'mei'shu	0
石青	shi'qing	0
湿染	shi'ran	0
湿染法	shi'ran'fa	0
是任也	shi'ren'ye	0
石荣强	shi'rong'qiang	0
施荣政	shi'rong'zheng	0
石锐	shi'rui	0
石色	shi'se	0
诗堂	shi'tang	0
石涛	shi'tao	0
石涛画集	shi'tao'hua'ji	0
石涛评传	shi'tao'ping'zhuan	0
石涛诗录	shi'tao'shi'lu	0
石铁民	shi'tie'min	0
石头色	shi'tou'se	0
湿托	shi'tuo	0
石巍	shi'wei	0
时卫平	shi'wei'ping	0
石溪	shi'xi	0
石祥强	shi'xiang'qiang	0
施晓杰	shi'xiao'jie	0
时砚亮	shi'yan'liang	0
史野	shi'ye	0
施义之	shi'yi'zhi	0
石瀛潮	shi'ying'chao	0
石煜	shi'yu	0
施愚山	shi'yu'shan	0
史朝阳	shi'zhao'yang	0
时振宪	shi'zhen'xian	0
施振宗	shi'zhen'zong	0
施峥	shi'zheng	0
石志民	shi'zhi'min	0
十竹斋	shi'zhu'zhai	0
石自东	shi'zi'dong	0
石子乾	shi'zi'qian	0
手卷	shou'juan	0
受与识	shou'yu'shi	0
寿舟旦	shou'zhou'dan	0
舒昊	shu'hao	0
熟褐	shu'he	0
书画鉴影	shu'hua'jian'ying	0
熟绢	shu'juan	0
舒均欢	shu'jun'huan	0
疏勒佛寺遗址壁画	shu'le'fo'si'yi'zhi'bi'hua	0
树绿	shu'lv	0
疏密聚散	shu'mi'ju'san	0
树皮贴画	shu'pi'tie'hua	0
殊属	shu'shu	0
舒欣	shu'xin	0
舒月华	shu'yue'hua	0
熟赭	shu'zhe	0
双钩填色	shuang'gou'tian'se	0
双松灵芝图卷	shuang'song'ling'zhi'tu'juan	0
双松泉石图	shuang'song'quan'shi'tu	0
水阁抚琴图	shui'ge'fu'qin'tu	0
水晶绿	shui'jing'lv	0
水晶色	shui'jing'se	0
水口法	shui'kou'fa	0
水墨观音像	shui'mo'guan'yin'xiang	0
水墨淋漓	shui'mo'lin'li	0
水墨写意画	shui'mo'xie'yi'hua	0
睡牛图	shui'niu'tu	0
水桃红	shui'tao'hong	0
朔县崇福寺壁画	shuo'xian'chong'fu'si'bi'hua	0
四尺整纸	si'chi'zheng'zhi	0
丝绸剪贴画	si'chou'jian'tie'hua	0
寺观壁画	si'guan'bi'hua	0
巳军	si'jun	0
司兰星	si'lan'xing	0
丝毛法	si'mao'fa	0
思其一	si'qi'yi	0
四青	si'qing	0
丝绒画	si'rong'hua	0
四条屏	si'tiao'ping	0
司徒立	si'tu'li	0
司子杰	si'zi'jie	0
司子桀	si'zi'jie	0
松柏绿	song'bai'lv	0
宋奔	song'ben	0
宋柄	song'bing	0
宋辞	song'ci	0
宋次伟	song'ci'wei	0
宋代寺观壁画	song'dai'si'guan'bi'hua	0
宋代院体	song'dai'yuan'ti	0
宋登明	song'deng'ming	0
宋涤	song'di	0
宋冬	song'dong	0
松风堂主人	song'feng'tang'zhu'ren	0
宋光宝	song'guang'bao	0
宋广袤	song'guang'mao	0
宋海永	song'hai'yong	0
宋宏刚	song'hong'gang	0
宋宏杰	song'hong'jie	0
松壶画忆	song'hu'hua'yi	0
松花绿	song'hua'lv	0
宋焕成	song'huan'cheng	0
宋建宏	song'jian'hong	0
宋建社	song'jian'she	0
宋建伟	song'jian'wei	0
宋杰生	song'jie'sheng	0
宋克	song'ke	0
宋克静	song'ke'jing	0
宋克西	song'ke'xi	0
宋黎明	song'li'ming	0
松瀑鸣琴图	song'pu'ming'qin'tu	0
宋齐鸣	song'qi'ming	0
松泉图	song'quan'tu	0
宋人画风	song'ren'hua'feng	0
宋人花鸟	song'ren'hua'niao	0
宋仁伟	song'ren'wei	0
松石绿	song'shi'lv	0
松石梧桐图	song'shi'wu'tong'tu	0
松树法	song'shu'fa	0
宋四家	song'si'jia	0
宋玮	song'wei	0
宋文翔	song'wen'xiang	0
宋文治	song'wen'zhi	0
宋孝慈	song'xiao'ci	0
宋效民	song'xiao'min	0
宋旭	song'xu	0
宋学智	song'xue'zhi	0
宋永进	song'yong'jin	0
宋永军	song'yong'jun	0
宋永兴	song'yong'xing	0
宋雨桂	song'yu'gui	0
宋远风	song'yuan'feng	0
宋玥	song'yue	0
宋真	song'zhen	0
宋征殷	song'zheng'yin	0
宋志江	song'zhi'jiang	0
苏巴朗	su'ba'lang	0
苏百钧	su'bai'jun	0
苏葆桢	su'bao'zhen	0
苏裱	su'biao	0
苏长春	su'chang'chun	0
苏东天	su'dong'tian	0
苏高礼	su'gao'li	0
宿光明	su'guang'ming	0
苏海生	su'hai'sheng	0
苏汉臣	su'han'chen	0
苏华聪	su'hua'cong	0
苏会丽	su'hui'li	0
苏继海	su'ji'hai	0
苏六朋	su'liu'peng	0
苏明新	su'ming'xin	0
苏仁山	su'ren'shan	0
苏淑义	su'shu'yi	0
苏万里	su'wan'li	0
苏旺伸	su'wang'shen	0
苏显祖	su'xian'zu	0
苏笑柏	su'xiao'bai	0
苏晓佳	su'xiao'jia	0
苏晓民	su'xiao'min	0
苏新宏	su'xin'hong	0
苏有源	su'you'yuan	0
苏雨涵	su'yu'han	0
隋代寺观壁画	sui'dai'si'guan'bi'hua	0
隋建明	sui'jian'ming	0
隋李和墓壁画	sui'li'he'mu'bi'hua	0
虽值冬	sui'zhi'dong	0
孙艾	sun'ai	0
孙才清	sun'cai'qing	0
孙长川	sun'chang'chuan	0
孙长喜	sun'chang'xi	0
孙超红	sun'chao'hong	0
孙晨光	sun'chen'guang	0
孙澄宇	sun'cheng'yu	0
孙纯田	sun'chun'tian	0
孙大志	sun'da'zhi	0
孙多慈	sun'duo'ci	0
孙福顺	sun'fu'shun	0
孙纲	sun'gang	0
孙葛	sun'ge	0
孙国岐	sun'guo'qi	0
孙国双	sun'guo'shuang	0
孙海青	sun'hai'qing	0
孙海翔	sun'hai'xiang	0
孙洪敏	sun'hong'min	0
孙红武	sun'hong'wu	0
孙会中	sun'hui'zhong	0
孙冀林	sun'ji'lin	0
孙嘉彬	sun'jia'bin	0
孙家铨	sun'jia'quan	0
孙佳昕	sun'jia'xin	0
孙佳音	sun'jia'yin	0
孙见光	sun'jian'guang	0
孙建平	sun'jian'ping	0
孙进东	sun'jin'dong	0
孙景波	sun'jing'bo	0
孙景刚	sun'jing'gang	0
孙景全	sun'jing'quan	0
孙敬群	sun'jing'qun	0
孙克纲	sun'ke'gang	0
孙克弘	sun'ke'hong	0
孙立沙	sun'li'sha	0
孙隆	sun'long	0
孙蛮	sun'man	0
孙念秋	sun'nian'qiu	0
孙宁全	sun'ning'quan	0
孙全义	sun'quan'yi	0
孙若楠	sun'ruo'nan	0
孙尚之	sun'shang'zhi	0
孙盛仁	sun'sheng'ren	0
孙世伟	sun'shi'wei	0
孙淑珍	sun'shu'zhen	0
孙顺正	sun'shun'zheng	0
孙濌	sun'ta	0
孙韬	sun'tao	0
孙位	sun'wei	0
孙晓瑜	sun'xiao'yu	0
孙新川	sun'xin'chuan	0
孙行旭	sun'xing'xu	0
孙亚光	sun'ya'guang	0
孙延卓	sun'yan'zhuo	0
孙耀珊	sun'yao'shan	0
孙翊	sun'yi	0
孙永印	sun'yong'yin	0
孙有福	sun'you'fu	0
孙有杰	sun'you'jie	0
孙玉海	sun'yu'hai	0
孙原	sun'yuan	0
孙云台	sun'yun'tai	0
孙兆海	sun'zhao'hai	0
孙震生	sun'zhen'sheng	0
孙振武	sun'zhen'wu	0
孙真艺	sun'zhen'yi	0
孙正德	sun'zheng'de	0
孙正东	sun'zheng'dong	0
孙志宜	sun'zhi'yi	0
孙忠祥	sun'zhong'xiang	0
孙滋溪	sun'zi'xi	0
孙宗歧	sun'zong'qi	0
孙宗慰	sun'zong'wei	0
太白诗意图	tai'bai'shi'yi'tu	0
苔点	tai'dian	0
太古无法	tai'gu'wu'fa	0
酞箐蓝	tai'jing'lan	0
苔绿	tai'lv	0
太平天国壁画	tai'ping'tian'guo'bi'hua	0
太平洋蓝	tai'ping'yang'lan	0
酞青蓝	tai'qing'lan	0
泰山岱庙壁画	tai'shan'dai'miao'bi'hua	0
苔藓绿	tai'xian'lv	0
太原多福寺壁画	tai'yuan'duo'fu'si'bi'hua	0
太原瓦窑村元墓壁画	tai'yuan'wa'yao'cun'yuan'mu'bi'hua	0
太原义井村金墓壁画	tai'yuan'yi'jing'cun'jin'mu'bi'hua	0
谭保健	tan'bao'jian	0
谭宝军	tan'bao'jun	0
谭德一	tan'de'yi	0
谭德枝	tan'de'zhi	0
谭涤夫	tan'di'fu	0
谭根雄	tan'gen'xiong	0
谭昊	tan'hao	0
炭黑	tan'hei	0
炭花灰	tan'hua'hui	0
碳灰	tan'hui	0
炭灰色	tan'hui'se	0
谭钧烈	tan'jun'lie	0
谭俊玲	tan'jun'ling	0
碳克	tan'ke	0
谭立群	tan'li'qun	0
檀宁凯	tan'ning'kai	0
谭全昌	tan'quan'chang	0
谭天	tan'tian	0
谭雪生	tan'xue'sheng	0
谭亚平	tan'ya'ping	0
谭延恺	tan'yan'kai	0
谈一峰	tan'yi'feng	0
潭玉涛	tan'yu'tao	0
谭志锋	tan'zhi'feng	0
谭智群	tan'zhi'qun	0
檀梓栋	tan'zi'dong	0
谭自力	tan'zi'li	0
唐阿史那忠墓壁画	tang'a'shi'na'zhong'mu'bi'hua	0
汤传杰	tang'chuan'jie	0
搪瓷壁画	tang'ci'bi'hua	0
唐代道观壁画	tang'dai'dao'guan'bi'hua	0
唐代佛寺壁画	tang'dai'fo'si'bi'hua	0
汤德利	tang'de'li	0
汤定之	tang'ding'zhi	0
汤风	tang'feng	0
汤富淳	tang'fu'chun	0
唐海文	tang'hai'wen	0
唐恒勋	tang'heng'xun	0
烫画	tang'hua	0
唐坚	tang'jian	0
唐建安	tang'jian'an	0
汤进峰	tang'jin'feng	0
唐李凤墓壁画	tang'li'feng'mu'bi'hua	0
唐李寿墓壁画	tang'li'shou'mu'bi'hua	0
唐李爽墓壁画	tang'li'shuang'mu'bi'hua	0
唐李勋墓壁画	tang'li'xun'mu'bi'hua	0
汤沐黎	tang'mu'li	0
唐汝川	tang'ru'chuan	0
唐三彩壁画	tang'san'cai'bi'hua	0
唐绍云	tang'shao'yun	0
唐书民	tang'shu'min	0
唐顺锋	tang'shun'feng	0
唐苏思勖墓壁画	tang'su'si'xu'mu'bi'hua	0
唐廷强	tang'ting'qiang	0
唐韦泂墓壁画	tang'wei'jiong'mu'bi'hua	0
唐小禾	tang'xiao'he	0
汤小胤	tang'xiao'yin	0
唐秀菊	tang'xiu'ju	0
唐雪根	tang'xue'gen	0
唐薛元超墓壁画	tang'xue'yuan'chao'mu'bi'hua	0
唐荀	tang'xun	0
汤尧	tang'yao	0
唐耀忠	tang'yao'zhong	0
汤贻芬	tang'yi'fen	0
唐一文	tang'yi'wen	0
唐寅	tang'yin	0
唐应山	tang'ying'shan	0
唐勇钢	tang'yong'gang	0
唐勇刚	tang'yong'gang	0
唐勇力	tang'yong'li	0
唐云	tang'yun	0
唐张九龄墓壁画	tang'zhang'jiu'ling'mu'bi'hua	0
唐赵澄墓壁画	tang'zhao'cheng'mu'bi'hua	0
唐昭陵壁画	tang'zhao'ling'bi'hua	0
唐郑仁泰墓壁画	tang'zheng'ren'tai'mu'bi'hua	0
唐志冈	tang'zhi'gang	0
陶博吾	tao'bo'wu	0
陶成	tao'cheng	0
陶大珉	tao'da'min	0
桃粉红	tao'fen'hong	0
桃花海棠图卷	tao'hua'hai'tang'tu'juan	0
陶家齐	tao'jia'qi	0
陶鉴敏	tao'jian'min	0
陶冷月	tao'leng'yue	0
套染法	tao'ran'fa	0
陶少波	tao'shao'bo	0
陶世虎	tao'shi'hu	0
陶思旭	tao'si'xu	0
陶天月	tao'tian'yue	0
陶蔚	tao'wei	0
陶贤辉	tao'xian'hui	0
陶兴科	tao'xing'ke	0
陶旭泉	tao'xu'quan	0
陶一清	tao'yi'qing	0
陶咏白	tao'yong'bai	0
陶忠	tao'zhong	0
特深啡	te'shen'fei	0
特深灰	te'shen'hui	0
特深蓝	te'shen'lan	0
藤昌佑	teng'chang'you	0
滕锋	teng'feng	0
滕昊天	teng'hao'tian	0
藤黄	teng'huang	0
藤田德次郎	teng'tian'de'ci'lang	0
滕铁军	teng'tie'jun	0
题跋	ti'ba	0
提白	ti'bai	0
提粉	ti'fen	0
题款	ti'kuan	0
提染	ti'ran	0
题识	ti'shi	0
题月	ti'yue	0
提紫	ti'zi	0
添长	tian'chang	0
田长发	tian'chang'fa	0
田夫	tian'fu	0
田广华	tian'guang'hua	0
天国蓝	tian'guo'lan	0
田海鹏	tian'hai'peng	0
田恒刚	tian'heng'gang	0
天津独乐寺壁画	tian'jin'du'le'si'bi'hua	0
田俊民	tian'jun'min	0
田克盛	tian'ke'sheng	0
天空蓝	tian'kong'lan	0
田黎明	tian'li'ming	0
田流沙	tian'liu'sha	0
天马峰	tian'ma'feng	0
田茂林	tian'mao'lin	0
田少鹏	tian'shao'peng	0
天使白	tian'shi'bai	0
田世光	tian'shi'guang	0
田舒羽	tian'shu'yu	0
天水麦积山石窟壁画	tian'shui'mai'ji'shan'shi'ku'bi'hua	0
天堂红	tian'tang'hong	0
田铁峰	tian'tie'feng	0
田崴	tian'wai	0
田卫平	tian'wei'ping	0
田武松	tian'wu'song	0
田兴明	tian'xing'ming	0
田学森	tian'xue'sen	0
田亚洲	tian'ya'zhou	0
天延阁后集	tian'yan'ge'hou'ji	0
天延阁集	tian'yan'ge'ji	0
田义	tian'yi	0
田友庄	tian'you'zhuang	0
田玉岭	tian'yu'ling	0
田郁文	tian'yu'wen	0
田志	tian'zhi	0
田忠锋	tian'zhong'feng	0
田子种	tian'zi'zhong	0
田宗源	tian'zong'yuan	0
铁线描	tie'xian'miao	0
铁锈红	tie'xiu'hong	0
铁扬	tie'yang	0
佟宝全	tong'bao'quan	0
童昌信	tong'chang'xin	0
童大年	tong'da'nian	0
彤华	tong'hua	0
通景屏	tong'jing'ping	0
桐林	tong'lin	0
同仁五屯寺壁画	tong'ren'wu'tun'si'bi'hua	0
佟世良	tong'shi'liang	0
佟耀文	tong'yao'wen	0
童奕奕	tong'yi'yi	0
桐荫论画	tong'yin'lun'hua	0
佟中	tong'zhong	0
头绿	tou'lv	0
头青	tou'qing	0
凸凹突兀	tu'ao'tu'wu	0
土耳其蓝	tu'er'qi'lan	0
涂刚	tu'gang	0
涂光明	tu'guang'ming	0
土红	tu'hong	0
屠宏涛	tu'hong'tao	0
图画见闻志	tu'hua'jian'wen'zhi	0
图绘宝鉴	tu'hui'bao'jian	0
凃克	tu'ke	0
涂克	tu'ke	0
土绿	tu'lv	0
土泥灰	tu'ni'hui	0
涂世骧	tu'shi'xiang	0
涂曦	tu'xi	0
涂艺颖	tu'yi'ying	0
涂永健	tu'yong'jian	0
图月坡	tu'yue'po	0
屠赞赞	tu'zan'zan	0
涂志伟	tu'zhi'wei	0
推蓬式	tui'peng'shi	0
托裱	tuo'biao	0
托裱画心	tuo'biao'hua'xin	0
托法	tuo'fa	0
拖肥啡	tuo'fei'fei	0
拖肥色	tuo'fei'se	0
庹光焰	tuo'guang'yan	0
托克托汉墓壁画	tuo'ke'tuo'han'mu'bi'hua	0
脱蜡法	tuo'la'fa	0
托料	tuo'liao	0
托色	tuo'se	0
托镶料	tuo'xiang'liao	0
托永寿	tuo'yong'shou	0
万兵	wan'bing	0
万昌平	wan'chang'ping	0
万基元	wan'ji'yuan	0
万金声	wan'jin'sheng	0
万均	wan'jun	0
宛俊勇	wan'jun'yong	0
晚蓝	wan'lan	0
万露	wan'lu	0
皖派	wan'pai	0
万启仁	wan'qi'ren	0
万青力	wan'qing'li	0
万石园	wan'shi'yuan	0
腕受心	wan'shou'xin	0
万太丰	wan'tai'feng	0
万象之根	wan'xiang'zhi'gen	0
万晓笳	wan'xiao'jia	0
万新君	wan'xin'jun	0
完颜畴	wan'yan'chou	0
万韵	wan'yun	0
王阿敏	wang'a'min	0
王霭	wang'ai	0
王艾婷	wang'ai'ting	0
汪安康	wang'an'kang	0
王安欣	wang'an'xin	0
王百顺	wang'bai'shun	0
王保岩	wang'bao'yan	0
王宝增	wang'bao'zeng	0
王斌华	wang'bin'hua	0
王彬羽	wang'bin'yu	0
王炳东	wang'bing'dong	0
王波浪	wang'bo'lang	0
望彩堂主人	wang'cai'tang'zhu'ren	0
王昌楷	wang'chang'kai	0
王朝斌	wang'chao'bin	0
王朝刚	wang'chao'gang	0
王超山	wang'chao'shan	0
王辰岳	wang'chen'yue	0
王橙	wang'cheng	0
王成喜	wang'cheng'xi	0
王承玉	wang'cheng'yu	0
王承云	wang'cheng'yun	0
王崇学	wang'chong'xue	0
王村谷	wang'cun'gu	0
王大同	wang'da'tong	0
汪大学	wang'da'xue	0
王大志	wang'da'zhi	0
王大治	wang'da'zhi	0
王丹玲	wang'dan'ling	0
王道真	wang'dao'zhen	0
王德怀	wang'de'huai	0
王德娟	wang'de'juan	0
王德伦	wang'de'lun	0
王东彪	wang'dong'biao	0
王东男	wang'dong'nan	0
王东弋	wang'dong'yi	0
望都号汉墓壁画	wang'du'hao'han'mu'bi'hua	0
王铎	wang'duo	0
王谔	wang'e	0
王二水	wang'er'shui	0
王方宇	wang'fang'yu	0
王非凡	wang'fei'fan	0
王凤国	wang'feng'guo	0
王风华	wang'feng'hua	0
王绂	wang'fu	0
王福庵	wang'fu'an	0
汪福民	wang'fu'min	0
王富强	wang'fu'qiang	0
王福阳	wang'fu'yang	0
王干生	wang'gan'sheng	0
汪港清	wang'gang'qing	0
王高宾	wang'gao'bin	0
王革滨	wang'ge'bin	0
王个簃	wang'ge'yi	0
王公甫	wang'gong'fu	0
王冠英	wang'guan'ying	0
王光乐	wang'guang'le	0
王国俊	wang'guo'jun	0
王国征	wang'guo'zheng	0
王国柱	wang'guo'zhu	0
王海鸥	wang'hai'ou	0
王海鹰	wang'hai'ying	0
王汉乐	wang'han'le	0
王汉英	wang'han'ying	0
王浩辉	wang'hao'hui	0
王洪	wang'hong	0
王宏剑	wang'hong'jian	0
王洪升	wang'hong'sheng	0
王洪水	wang'hong'shui	0
王宏造	wang'hong'zao	0
王洪志	wang'hong'zhi	0
王怀庆	wang'huai'qing	0
王焕青	wang'huan'qing	0
王璜生	wang'huang'sheng	0
王翚	wang'hui	0
王季华	wang'ji'hua	0
王继民	wang'ji'min	0
王季迁	wang'ji'qian	0
王吉松	wang'ji'song	0
王继先	wang'ji'xian	0
王霁昕	wang'ji'xin	0
王棘旋	wang'ji'xuan	0
王家儒	wang'jia'ru	0
王佳义	wang'jia'yi	0
王鉴	wang'jian	0
王建顺	wang'jian'shun	0
王剑云	wang'jian'yun	0
王疆	wang'jiang	0
王江鸿	wang'jiang'hong	0
汪玠	wang'jie	0
王介明	wang'jie'ming	0
王今	wang'jin	0
王金才	wang'jin'cai	0
王锦清	wang'jin'qing	0
汪静	wang'jing	0
王靖国	wang'jing'guo	0
王景岚	wang'jing'lan	0
王敬武	wang'jing'wu	0
王敬祥	wang'jing'xiang	0
王举春	wang'ju'chun	0
王居龙	wang'ju'long	0
汪鋆	wang'jun	0
王俊标	wang'jun'biao	0
王开宇	wang'kai'yu	0
王可大	wang'ke'da	0
王克举	wang'ke'ju	0
王可伟	wang'ke'wei	0
王坤蓉	wang'kun'rong	0
王立成	wang'li'cheng	0
王力华	wang'li'hua	0
王力克	wang'li'ke	0
王犁犁	wang'li'li	0
王立松	wang'li'song	0
王立宪	wang'li'xian	0
王立野	wang'li'ye	0
王良武	wang'liang'wu	0
王麟坤	wang'lin'kun	0
王龙军	wang'long'jun	0
王龙生	wang'long'sheng	0
王履	wang'lv	0
王满	wang'man	0
王毛子	wang'mao'zi	0
王美芳	wang'mei'fang	0
王梅格	wang'mei'ge	0
王梅子	wang'mei'zi	0
王蒙	wang'meng	0
王梦白	wang'meng'bai	0
王冕	wang'mian	0
王明光	wang'ming'guang	0
王铭杰	wang'ming'jie	0
王明明	wang'ming'ming	0
王嫩	wang'nen	0
王念东	wang'nian'dong	0
王攀元	wang'pan'yuan	0
王佩坤	wang'pei'kun	0
王绮彪	wang'qi'biao	0
王齐翰	wang'qi'han	0
汪启淑	wang'qi'shu	0
王其智	wang'qi'zhi	0
王洽	wang'qia	0
旺亲	wang'qin	0
王晴雷	wang'qing'lei	0
王庆善	wang'qing'shan	0
王庆升	wang'qing'sheng	0
王庆松	wang'qing'song	0
王庆韬	wang'qing'tao	0
王庆裕	wang'qing'yu	0
汪秋涧	wang'qiu'jian	0
王仁华	wang'ren'hua	0
王人及	wang'ren'ji	0
王人平	wang'ren'ping	0
王儒伯	wang'ru'bo	0
王瑞明	wang'rui'ming	0
王若水	wang'ruo'shui	0
王善生	wang'shan'sheng	0
王少浩	wang'shao'hao	0
王少伦	wang'shao'lun	0
王少翔	wang'shao'xiang	0
王少毅	wang'shao'yi	0
汪慎生	wang'shen'sheng	0
王慎艺	wang'shen'yi	0
王申勇	wang'shen'yong	0
汪胜	wang'sheng	0
王圣松	wang'sheng'song	0
王式	wang'shi	0
王石谷	wang'shi'gu	0
汪世民	wang'shi'min	0
王时敏	wang'shi'min	0
王仕明	wang'shi'ming	0
汪世清	wang'shi'qing	0
王师子	wang'shi'zi	0
王守森	wang'shou'sen	0
王书海	wang'shu'hai	0
王叔晖	wang'shu'hui	0
王书朋	wang'shu'peng	0
王双贵	wang'shuang'gui	0
王水河	wang'shui'he	0
王水清	wang'shui'qing	0
王思丁	wang'si'ding	0
王涛	wang'tao	0
王腾影	wang'teng'ying	0
王天胜	wang'tian'sheng	0
王铁城	wang'tie'cheng	0
王铁根	wang'tie'gen	0
王铁牛	wang'tie'niu	0
王庭筠	wang'ting'jun	0
汪廷钰	wang'ting'yu	0
王同行	wang'tong'hang	0
汪土慎	wang'tu'shen	0
王维	wang'wei	0
王维安	wang'wei'an	0
王伟男	wang'wei'nan	0
汪为新	wang'wei'xin	0
王伟宗	wang'wei'zong	0
王文虎	wang'wen'hu	0
王闻声	wang'wen'sheng	0
王武森	wang'wu'sen	0
王吾一	wang'wu'yi	0
王洗	wang'xi	0
王西京	wang'xi'jing	0
王希孟	wang'xi'meng	0
王希奇	wang'xi'qi	0
王西斋	wang'xi'zhai	0
王贤培	wang'xian'pei	0
王先强	wang'xian'qiang	0
王晓	wang'xiao	0
王小奔	wang'xiao'ben	0
王小冈	wang'xiao'gang	0
王小路	wang'xiao'lu	0
王效宓	wang'xiao'mi	0
汪晓曙	wang'xiao'shu	0
王晓赟	wang'xiao'yun	0
王晓征	wang'xiao'zheng	0
王笑阻	wang'xiao'zu	0
王笑祖	wang'xiao'zu	0
王忻	wang'xin	0
王心竟	wang'xin'jing	0
王心悟	wang'xin'wu	0
王星辰	wang'xing'chen	0
王秀章	wang'xiu'zhang	0
王恤珠	wang'xu'zhu	0
王轩也	wang'xuan'ye	0
王雪涛	wang'xue'tao	0
王雪莹	wang'xue'ying	0
汪亚尘	wang'ya'chen	0
王衍成	wang'yan'cheng	0
王延格	wang'yan'ge	0
王衍如	wang'yan'ru	0
汪研山	wang'yan'shan	0
王燕霞	wang'yan'xia	0
王耀伟	wang'yao'wei	0
汪绎辰	wang'yi'chen	0
王伊楚	wang'yi'chu	0
王沂东	wang'yi'dong	0
王易罡	wang'yi'gang	0
王沂光	wang'yi'guang	0
王益论	wang'yi'lun	0
王益鹏	wang'yi'peng	0
王懿荣	wang'yi'rong	0
王奕妍	wang'yi'yan	0
王益章	wang'yi'zhang	0
王印泉	wang'yin'quan	0
王永昌	wang'yong'chang	0
王永国	wang'yong'guo	0
王永海	wang'yong'hai	0
王永建	wang'yong'jian	0
王有嫦	wang'you'chang	0
王友江	wang'you'jiang	0
王佑灵	wang'you'ling	0
王毓安	wang'yu'an	0
王雨超	wang'yu'chao	0
王育程	wang'yu'cheng	0
王玉琦	wang'yu'qi	0
王玉生	wang'yu'sheng	0
王羽天	wang'yu'tian	0
王雨欣	wang'yu'xin	0
王渊	wang'yuan	0
王原祁	wang'yuan'qi	0
王原祈	wang'yuan'qi	0
王元寿	wang'yuan'shou	0
王元友	wang'yuan'you	0
王元珍	wang'yuan'zhen	0
王悦之	wang'yue'zhi	0
王泽焕	wang'ze'huan	0
王占欣	wang'zhan'xin	0
汪肇	wang'zhao	0
王兆辉	wang'zhao'hui	0
王昭旻	wang'zhao'min	0
王兆中	wang'zhao'zhong	0
王震	wang'zhen	0
王振鹏	wang'zhen'peng	0
王振羽	wang'zhen'yu	0
汪振泽	wang'zhen'ze	0
王征骅	wang'zheng'hua	0
王跖	wang'zhi	0
王骘	wang'zhi	0
王之博	wang'zhi'bo	0
王致诚	wang'zhi'cheng	0
王志春	wang'zhi'chun	0
汪志杰	wang'zhi'jie	0
王直翁	wang'zhi'weng	0
王忠弟	wang'zhong'di	0
王中年	wang'zhong'nian	0
王忠齐	wang'zhong'qi	0
王舟其	wang'zhou'qi	0
王子辉	wang'zi'hui	0
王宗楷	wang'zong'kai	0
魏宝丽	wei'bao'li	0
魏本	wei'ben	0
韦博文	wei'bo'wen	0
魏超	wei'chao	0
魏传义	wei'chuan'yi	0
魏大巩	wei'da'gong	0
魏滇	wei'dian	0
韦尔申	wei'er'shen	0
蔚国银	wei'guo'yin	0
魏海	wei'hai	0
韦翰	wei'han	0
卫黄	wei'huang	0
魏惠娟	wei'hui'juan	0
魏慧子	wei'hui'zi	0
魏基宏	wei'ji'hong	0
维加斯金	wei'jia'si'jin	0
魏健翔	wei'jian'xiang	0
魏建翔	wei'jian'xiang	0
韦竞明	wei'jing'ming	0
韦竟明	wei'jing'ming	0
魏景山	wei'jing'shan	0
魏巨山	wei'ju'shan	0
魏恺琪	wei'kai'qi	0
魏奎仲	wei'kui'zhong	0
委拉斯盖兹	wei'la'si'gai'zi	0
未来主义	wei'lai'zhu'yi	0
魏鲁宁	wei'lu'ning	0
伟南	wei'nan	0
威尼斯画派	wei'ni'si'hua'pai	0
韦其美	wei'qi'mei	0
韦启美	wei'qi'mei	0
魏琪敏	wei'qi'min	0
魏启铭	wei'qi'ming	0
魏琼珊	wei'qiong'shan	0
尾上复羽	wei'shang'fu'yu	0
渭升	wei'sheng	0
魏舒菲	wei'shu'fei	0
韦韬	wei'tao	0
韦文苑	wei'wen'yuan	0
卫无天	wei'wu'tian	0
尾下复羽	wei'xia'fu'yu	0
卫贤	wei'xian	0
韦献青	wei'xian'qing	0
魏湘	wei'xiang	0
魏晓安	wei'xiao'an	0
卫协	wei'xie	0
魏新燕	wei'xin'yan	0
魏雄辉	wei'xiong'hui	0
韦宣劳	wei'xuan'lao	0
韦偃	wei'yan	0
魏言	wei'yan	0
维也纳分离派	wei'ye'na'fen'li'pai	0
隗羽	wei'yu	0
魏运成	wei'yun'cheng	0
韦振江	wei'zhen'jiang	0
尾纸	wei'zhi	0
魏智平	wei'zhi'ping	0
魏紫熙	wei'zi'xi	0
卫祖荫	wei'zu'yin	0
温葆	wen'bao	0
文兵	wen'bing	0
文伯仁	wen'bo'ren	0
文成浩	wen'cheng'hao	0
温聪	wen'cong	0
文从简	wen'cong'jian	0
文发科	wen'fa'ke	0
玟瑰红	wen'gui'hong	0
文国璋	wen'guo'zhang	0
文金扬	wen'jin'yang	0
闻立鹏	wen'li'peng	0
温练昌	wen'lian'chang	0
温宁	wen'ning	0
温平	wen'ping	0
温泉沁	wen'quan'qin	0
温人萱	wen'ren'xuan	0
文水北峪口古墓壁画	wen'shui'bei'yu'kou'gu'mu'bi'hua	0
温松宁	wen'song'ning	0
问亭	wen'ting	0
文同	wen'tong	0
文文武	wen'wen'wu	0
温县慈胜寺壁画	wen'xian'ci'sheng'si'bi'hua	0
温小雅	wen'xiao'ya	0
文哲男	wen'zhe'nan	0
文震亨	wen'zhen'heng	0
文征明	wen'zheng'ming	0
温植茸	wen'zhi'rong	0
翁诞宪	weng'dan'xian	0
翁鸿盛	weng'hong'sheng	0
翁建华	weng'jian'hua	0
翁开松	weng'kai'song	0
翁凯旋	weng'kai'xuan	0
翁同稣	weng'tong'su	0
翁逸之	weng'yi'zhi	0
翁越超	weng'yue'chao	0
涡漩主义	wo'xuan'zhu'yi	0
卧游图	wo'you'tu	0
吴霭	wu'ai	0
吴白露	wu'bai'lu	0
吴宝德	wu'bao'de	0
邬宝国	wu'bao'guo	0
吴彬	wu'bin	0
吴炳	wu'bing	0
伍步云	wu'bu'yun	0
吴昌硕	wu'chang'shuo	0
吴澈	wu'che	0
吴晨荣	wu'chen'rong	0
吴承典	wu'cheng'dian	0
吴承夏	wu'cheng'xia	0
吴春林	wu'chun'lin	0
巫大军	wu'da'jun	0
吴大伦	wu'da'lun	0
邬大勇	wu'da'yong	0
吴大羽	wu'da'yu	0
吴大徵	wu'da'zheng	0
吴待秋	wu'dai'qiu	0
五代寺观壁画	wu'dai'si'guan'bi'hua	0
吴道学	wu'dao'xue	0
吴道子	wu'dao'zi	0
吴德彬	wu'de'bin	0
吴德军	wu'de'jun	0
武德祖	wu'de'zu	0
吴迪华	wu'di'hua	0
吴殿军	wu'dian'jun	0
吴定隆	wu'ding'long	0
吴尔纯	wu'er'chun	0
无法而法	wu'fa'er'fa	0
吴富佳	wu'fu'jia	0
吴弗之	wu'fu'zhi	0
吴高钟	wu'gao'zhong	0
吴观岱	wu'guan'dai	0
吴冠中	wu'guan'zhong	0
吴光宇	wu'guang'yu	0
武贵刚	wu'gui'gang	0
吴桂平	wu'gui'ping	0
邬国宝	wu'guo'bao	0
吴国伟	wu'guo'wei	0
吴国炜	wu'guo'wei	0
吴汉东	wu'han'dong	0
吴宏	wu'hong	0
吴红虹	wu'hong'hong	0
吴厚斌	wu'hou'bin	0
吴湖帆	wu'hu'fan	0
邬华敏	wu'hua'min	0
吴华源	wu'hua'yuan	0
吴怀峰	wu'huai'feng	0
雾灰	wu'hui	0
吴惠明	wu'hui'ming	0
吴翦	wu'jian	0
吴兼山	wu'jian'shan	0
吴坚祥	wu'jian'xiang	0
武剑钊	wu'jian'zhao	0
武建政	wu'jian'zheng	0
吴劲潮	wu'jin'chao	0
武静波	wu'jing'bo	0
吴静涵	wu'jing'han	0
吴镜汀	wu'jing'ting	0
吴静雨	wu'jing'yu	0
巫俊	wu'jun	0
巫峻	wu'jun	0
武俊	wu'jun	0
吴俊臣	wu'jun'chen	0
雾蓝	wu'lan	0
伍礼	wu'li	0
吴历	wu'li	0
吴烈勇	wu'lie'yong	0
伍琳	wu'lin	0
屋漏痕	wu'lou'hen	0
邬璐娜	wu'lu'na	0
勿绿	wu'lv	0
吴履	wu'lv	0
吴民本	wu'min'ben	0
武明明	wu'ming'ming	0
乌目山人	wu'mu'shan'ren	0
吴奇志	wu'qi'zhi	0
吴强春	wu'qiang'chun	0
吴琴木	wu'qin'mu	0
吴青山	wu'qing'shan	0
吴青霞	wu'qing'xia	0
吴晴岩	wu'qing'yan	0
吴庆云	wu'qing'yun	0
巫秋基	wu'qiu'ji	0
乌日金	wu'ri'jin	0
五瑞图	wu'rui'tu	0
邬瑞瑶	wu'rui'yao	0
武山水帘洞壁画	wu'shan'shui'lian'dong'bi'hua	0
吴世平	wu'shi'ping	0
吴石仙	wu'shi'xian	0
吴仕响	wu'shi'xiang	0
吴守峰	wu'shou'feng	0
吴树栋	wu'shu'dong	0
吴淑君	wu'shu'jun	0
乌叔养	wu'shu'yang	0
吴霜嵘	wu'shuang'rong	0
吴斯嘉	wu'si'jia	0
五台山佛光寺壁画	wu'tai'shan'fo'guang'si'bi'hua	0
五台山南山寺壁画	wu'tai'shan'nan'shan'si'bi'hua	0
吴天章	wu'tian'zhang	0
吴铁声	wu'tie'sheng	0
吴伟	wu'wei	0
武微波	wu'wei'bo	0
武威雷台东汉墓壁画	wu'wei'lei'tai'dong'han'mu'bi'hua	0
武威五坝山汉墓壁画	wu'wei'wu'ba'shan'han'mu'bi'hua	0
巫维轩	wu'wei'xuan	0
武文建	wu'wen'jian	0
吴文旭	wu'wen'xu	0
吴文野	wu'wen'ye	0
武小锋	wu'xiao'feng	0
武小慧	wu'xiao'hui	0
吴孝文	wu'xiao'wen	0
吴兴亮	wu'xing'liang	0
吴炫三	wu'xuan'san	0
武雪丽	wu'xue'li	0
吴雪妹	wu'xue'mei	0
吴亚卓	wu'ya'zhuo	0
吴彦怀	wu'yan'huai	0
吴燕生	wu'yan'sheng	0
武耀宗	wu'yao'zong	0
午夜蓝	wu'ye'lan	0
吴乙古	wu'yi'gu	0
吴壹华	wu'yi'hua	0
吴义江	wu'yi'jiang	0
吴以强	wu'yi'qiang	0
吴义英	wu'yi'ying	0
吴银杉	wu'yin'shan	0
武英扬	wu'ying'yang	0
吴永建	wu'yong'jian	0
邬永柳	wu'yong'liu	0
武永年	wu'yong'nian	0
吴悠	wu'you	0
吴又和	wu'you'he	0
吴宇芳	wu'yu'fang	0
吴宇方	wu'yu'fang	0
吴玉麟	wu'yu'lin	0
吴玉梅	wu'yu'mei	0
吴宇棠	wu'yu'tang	0
吴玉柱	wu'yu'zhu	0
吴元瑜	wu'yuan'yu	0
武元直	wu'yuan'zhi	0
吴恽	wu'yun	0
武云超	wu'yun'chao	0
吴择姝	wu'ze'shu	0
武增宏	wu'zeng'hong	0
务旃	wu'zhan	0
吴瞻淇	wu'zhan'qi	0
吴瞻泰	wu'zhan'tai	0
吴瞻原	wu'zhan'yuan	0
吴璋	wu'zhang	0
伍章庆	wu'zhang'qing	0
吴镇	wu'zhen	0
吴震伯	wu'zhen'bo	0
吴振明	wu'zhen'ming	0
伍振权	wu'zhen'quan	0
吴徵	wu'zheng	0
吴志猛	wu'zhi'meng	0
吴仲圭	wu'zhong'gui	0
吴中秋	wu'zhong'qiu	0
巫子强	wu'zi'qiang	0
吴子深	wu'zi'shen	0
武宗元	wu'zong'yuan	0
吴祖年	wu'zu'nian	0
西安东岳庙壁画	xi'an'dong'yue'miao'bi'hua	0
西安隋唐墓壁画	xi'an'sui'tang'mu'bi'hua	0
习地	xi'di	0
西瓜红	xi'gua'hong	0
席湖	xi'hu	0
西画东渐	xi'hua'dong'jian	0
席欢	xi'huan	0
淅甲沥粉法	xi'jia'li'fen'fa	0
席凯来	xi'kai'lai	0
锡克沁千佛洞壁画	xi'ke'qin'qian'fo'dong'bi'hua	0
细密画	xi'mi'hua	0
溪南八景图册	xi'nan'ba'jing'tu'ce	0
洗水白	xi'shui'bai	0
西夏号陵壁画	xi'xia'hao'ling'bi'hua	0
西夏石窟壁画	xi'xia'shi'ku'bi'hua	0
西岩藏云图	xi'yan'cang'yun'tu	0
细叶脉	xi'ye'mai	0
细雨虬松图	xi'yu'qiu'song'tu	0
奚忠恕	xi'zhong'shu	0
夏葆元	xia'bao'yuan	0
夏昶	xia'chang	0
夏春辉	xia'chun'hui	0
夏圭	xia'gui	0
夏加尔	xia'jia'er	0
夏坚贞	xia'jian'zhen	0
夏俊娜	xia'jun'na	0
夏理斌	xia'li'bin	0
夏立业	xia'li'ye	0
夏林宽	xia'lin'kuan	0
夏令涛	xia'ling'tao	0
夏淼	xia'miao	0
夏培耀	xia'pei'yao	0
夏日女人茶	xia'ri'nv'ren'cha	0
虾肉色	xia'rou'se	0
夏山图	xia'shan'tu	0
夏喜智	xia'xi'zhi	0
夏晓红	xia'xiao'hong	0
夏兴元	xia'xing'yuan	0
夏禹玉	xia'yu'yu	0
夏祖亮	xia'zu'liang	0
瞎尊者	xia'zun'zhe	0
现成物	xian'cheng'wu	0
现代工笔	xian'dai'gong'bi	0
现代艺术	xian'dai'yi'shu	0
鲜粉红	xian'fen'hong	0
鲜蓝	xian'lan	0
显露隠含	xian'lu'yin'han	0
先铺后染	xian'pu'hou'ran	0
先染后铺	xian'ran'hou'pu	0
仙人峰	xian'ren'feng	0
仙山楼阁图	xian'shan'lou'ge'tu	0
鲜桃红	xian'tao'hong	0
冼小前	xian'xiao'qian	0
鲜锈红	xian'xiu'hong	0
咸阳唐苏君墓壁画	xian'yang'tang'su'jun'mu'bi'hua	0
先茔图	xian'ying'tu	0
鲜紫	xian'zi	0
向标	xiang'biao	0
向伯纯	xiang'bo'chun	0
向步云	xiang'bu'yun	0
香草绿	xiang'cao'lv	0
项诚学	xiang'cheng'xue	0
项而躬	xiang'er'gong	0
香粉红	xiang'fen'hong	0
镶覆	xiang'fu	0
香瓜橙	xiang'gua'cheng	0
乡宁千佛洞壁画	xiang'ning'qian'fo'dong'bi'hua	0
橡皮红	xiang'pi'hong	0
向庆华	xiang'qing'hua	0
象牙黑	xiang'ya'hei	0
象牙黄	xiang'ya'huang	0
象征主义	xiang'zheng'zhu'yi	0
肖宝云	xiao'bao'yun	0
萧伯玉	xiao'bo'yu	0
萧琛	xiao'chen	0
小乘客	xiao'cheng'ke	0
肖成章	xiao'cheng'zhang	0
肖大勇	xiao'da'yong	0
肖栋昆	xiao'dong'kun	0
肖丰	xiao'feng	0
小斧劈	xiao'fu'pi	0
小斧劈皴	xiao'fu'pi'cun	0
肖谷	xiao'gu	0
小华峰	xiao'hua'feng	0
小混点	xiao'hun'dian	0
肖骥波	xiao'ji'bo	0
肖继东	xiao'ji'dong	0
小间大	xiao'jian'da	0
肖景志	xiao'jing'zhi	0
萧俊贤	xiao'jun'xian	0
肖克刚	xiao'ke'gang	0
肖宽	xiao'kuan	0
肖孟江	xiao'meng'jiang	0
萧沛苍	xiao'pei'cang	0
萧鹏	xiao'peng	0
肖芊	xiao'qian	0
肖千	xiao'qian	0
萧谦中	xiao'qian'zhong	0
小山画谱	xiao'shan'hua'pu	0
萧盛福	xiao'sheng'fu	0
肖世扬	xiao'shi'yang	0
萧淑芳	xiao'shu'fang	0
肖涛生	xiao'tao'sheng	0
萧涛生	xiao'tao'sheng	0
萧翁	xiao'weng	0
肖笑言	xiao'xiao'yan	0
萧愻	xiao'xun	0
萧瑶	xiao'yao	0
肖瑶宁	xiao'yao'ning	0
孝义梁家庄元墓壁画	xiao'yi'liang'jia'zhuang'yuan'mu'bi'hua	0
小翼羽	xiao'yi'yu	0
肖永超	xiao'yong'chao	0
萧友法	xiao'you'fa	0
肖玉明	xiao'yu'ming	0
肖悦	xiao'yue	0
萧云从	xiao'yun'cong	0
萧云松	xiao'yun'song	0
萧照	xiao'zhao	0
谢彬	xie'bin	0
谢秉钧	xie'bing'jun	0
谢常勇	xie'chang'yong	0
谢成水	xie'cheng'shui	0
谢楚余	xie'chu'yu	0
谢东明	xie'dong'ming	0
谢逢春	xie'feng'chun	0
谢关键	xie'guan'jian	0
谢赫	xie'he	0
谢恒星	xie'heng'xing	0
谢环	xie'huan	0
谢楫年	xie'ji'nian	0
谢家模	xie'jia'mo	0
谢建德	xie'jian'de	0
谢建中	xie'jian'zhong	0
谢晋璋	xie'jin'zhang	0
谢理常	xie'li'chang	0
谢立俭	xie'li'jian	0
谢麟	xie'lin	0
谢木凡	xie'mu'fan	0
谢南星	xie'nan'xing	0
谢雱	xie'pang	0
谢鹏程	xie'peng'cheng	0
谢润	xie'run	0
谢森	xie'sen	0
写生揣意	xie'sheng'chuai'yi	0
谢述先	xie'shu'xian	0
谢叔宜	xie'shu'yi	0
谢荪	xie'sun	0
谢伟兴	xie'wei'xing	0
谢小健	xie'xiao'jian	0
谢孝珍	xie'xiao'zhen	0
谢兴伟	xie'xing'wei	0
谢耀庭	xie'yao'ting	0
写意花鸟	xie'yi'hua'niao	0
写意翎毛	xie'yi'ling'mao	0
写意人物	xie'yi'ren'wu	0
写意山水	xie'yi'shan'shui	0
谢永	xie'yong	0
谢永熙	xie'yong'xi	0
谢源璜	xie'yuan'huang	0
蟹爪树法	xie'zhao'shu'fa	0
蟹爪枝	xie'zhao'zhi	0
谢珍珠	xie'zhen'zhu	0
谢稚柳	xie'zhi'liu	0
新宝兰	xin'bao'lan	0
新大红	xin'da'hong	0
新粉橙	xin'fen'cheng	0
新粉红	xin'fen'hong	0
新古典主义	xin'gu'dian'zhu'yi	0
新海蓝	xin'hai'lan	0
忻海洲	xin'hai'zhou	0
新和托呼拉洞窟壁画	xin'he'tuo'hu'la'dong'ku'bi'hua	0
新红色	xin'hong'se	0
辛家峰	xin'jia'feng	0
新绛稷益庙壁画	xin'jiang'ji'yi'miao'bi'hua	0
新绛南范庄金墓壁画	xin'jiang'nan'fan'zhuang'jin'mu'bi'hua	0
新绛吴岭庄元墓壁画	xin'jiang'wu'ling'zhuang'yuan'mu'bi'hua	0
新津观音寺壁画	xin'jin'guan'yin'si'bi'hua	0
新军绿	xin'jun'lv	0
辛莽	xin'mang	0
新米白	xin'mi'bai	0
新嫩黄	xin'nen'huang	0
新天蓝	xin'tian'lan	0
新文人画	xin'wen'ren'hua	0
新艳绿	xin'yan'lv	0
欣一	xin'yi	0
新印象画派	xin'yin'xiang'hua'pai	0
新印象派	xin'yin'xiang'pai	0
新造型主义	xin'zao'xing'zhu'yi	0
邢波	xing'bo	0
幸代远	xing'dai'yuan	0
杏甫	xing'fu	0
杏复黑	xing'fu'hei	0
杏复紫	xing'fu'zi	0
邢会民	xing'hui'min	0
刑健健	xing'jian'jian	0
刑俊勤	xing'jun'qin	0
杏克色	xing'ke'se	0
星空蓝	xing'kong'lan	0
醒勒	xing'le	0
邢琏	xing'lian	0
醒染	xing'ran	0
邢若明	xing'ruo'ming	0
邢山山	xing'shan'shan	0
行书七言联	xing'shu'qi'yan'lian	0
杏驼	xing'tuo	0
杏王	xing'wang	0
性性黑	xing'xing'hei	0
邢亚梅	xing'ya'mei	0
邢仪	xing'yi	0
邢义君	xing'yi'jun	0
杏园东汉墓壁画	xing'yuan'dong'han'mu'bi'hua	0
行云流水描	xing'yun'liu'shui'miao	0
熊伯齐	xiong'bo'qi	0
熊长虹	xiong'chang'hong	0
熊德琴	xiong'de'qin	0
熊继雨	xiong'ji'yu	0
熊开元	xiong'kai'yuan	0
熊莉钧	xiong'li'jun	0
熊宇	xiong'yu	0
熊兆瑞	xiong'zhao'rui	0
胸中逸气	xiong'zhong'yi'qi	0
锈橙	xiu'cheng	0
锈红	xiu'hong	0
修拉	xiu'la	0
秀石疏林图	xiu'shi'shu'lin'tu	0
徐阿森	xu'a'sen	0
徐爱侠	xu'ai'xia	0
徐跋骋	xu'ba'cheng	0
许宝中	xu'bao'zhong	0
徐悲鸿	xu'bei'hong	0
徐丙旭	xu'bing'xu	0
徐浡君	xu'bo'jun	0
徐操	xu'cao	0
徐崇嗣	xu'chong'si	0
徐川青	xu'chuan'qing	0
徐大为	xu'da'wei	0
许道宁	xu'dao'ning	0
徐东林	xu'dong'lin	0
虚而灵	xu'er'ling	0
许奋	xu'fen	0
徐甫生	xu'fu'sheng	0
徐改之	xu'gai'zhi	0
徐公度	xu'gong'du	0
虚谷	xu'gu	0
徐光弟	xu'guang'di	0
徐光第	xu'guang'di	0
徐光培	xu'guang'pei	0
许广专	xu'guang'zhuan	0
徐贵忠	xu'gui'zhong	0
许国钰	xu'guo'yu	0
许翰政	xu'han'zheng	0
续鹤贤	xu'he'xian	0
徐泓滨	xu'hong'bin	0
许洪涛	xu'hong'tao	0
续画品	xu'hua'pin	0
许华秀	xu'hua'xiu	0
徐怀芳	xu'huai'fang	0
徐黄异体	xu'huang'yi'ti	0
徐加昌	xu'jia'chang	0
许家德	xu'jia'de	0
徐珈惠	xu'jia'hui	0
徐加茂	xu'jia'mao	0
徐坚白	xu'jian'bai	0
许金国	xu'jin'guo	0
徐敬鹏	xu'jing'peng	0
徐觉伟	xu'jue'wei	0
许钧棒	xu'jun'bang	0
徐俊东	xu'jun'dong	0
徐俊卿	xu'jun'qing	0
胥可	xu'ke	0
徐乐乐	xu'le'le	0
徐里	xu'li	0
徐立中	xu'li'zhong	0
许林涛	xu'lin'tao	0
徐毛毛	xu'mao'mao	0
徐茂平	xu'mao'ping	0
许敏雄	xu'min'xiong	0
徐明华	xu'ming'hua	0
徐牧原	xu'mu'yuan	0
许琦	xu'qi	0
许乔昌	xu'qiao'chang	0
徐乔建	xu'qiao'jian	0
徐勤学	xu'qin'xue	0
徐青峰	xu'qing'feng	0
许荣初	xu'rong'chu	0
徐尚馨	xu'shang'xin	0
许世辉	xu'shi'hui	0
徐石雪	xu'shi'xue	0
许守镇	xu'shou'zhen	0
许硕	xu'shuo	0
徐苏平	xu'su'ping	0
徐祟嗣	xu'sui'si	0
徐天离	xu'tian'li	0
徐渭	xu'wei	0
徐伟德	xu'wei'de	0
徐伟利	xu'wei'li	0
徐微强	xu'wei'qiang	0
徐唯辛	xu'wei'xin	0
徐唯新	xu'wei'xin	0
徐维辛	xu'wei'xin	0
徐文光	xu'wen'guang	0
徐熙	xu'xi	0
徐夏林	xu'xia'lin	0
徐小昆	xu'xiao'kun	0
许晓鹏	xu'xiao'peng	0
许孝诗	xu'xiao'shi	0
许辛	xu'xin	0
徐新奇	xu'xin'qi	0
徐新武	xu'xin'wu	0
胥幸福	xu'xing'fu	0
徐修凯	xu'xiu'kai	0
徐延平	xu'yan'ping	0
徐燕孙	xu'yan'sun	0
徐嬿婷	xu'yan'ting	0
徐衍伟	xu'yan'wei	0
徐彦洲	xu'yan'zhou	0
徐垚	xu'yao	0
徐一斓	xu'yi'lan	0
许英辉	xu'ying'hui	0
许英来	xu'ying'lai	0
徐应泉	xu'ying'quan	0
许英特	xu'ying'te	0
许永康	xu'yong'kang	0
徐友富	xu'you'fu	0
许雨仁	xu'yu'ren	0
徐远生	xu'yuan'sheng	0
胥远香	xu'yuan'xiang	0
虚斋名画录	xu'zhai'ming'hua'lu	0
徐璋	xu'zhang	0
徐章明	xu'zhang'ming	0
徐兆前	xu'zhao'qian	0
徐桢	xu'zhen	0
徐志伟	xu'zhi'wei	0
徐志远	xu'zhi'yuan	0
徐忠波	xu'zhong'bo	0
许忠华	xu'zhong'hua	0
徐梓峻	xu'zi'jun	0
徐子桥	xu'zi'qiao	0
宣和画谱	xuan'he'hua'pu	0
宣和装	xuan'he'zhuang	0
宣化辽墓壁画	xuan'hua'liao'mu'bi'hua	0
宣坚强	xuan'jian'qiang	0
宣新民	xuan'xin'min	0
宣新明	xuan'xin'ming	0
悬针	xuan'zhen	0
薛保瑕	xue'bao'xia	0
薛昌河	xue'chang'he	0
薛国平	xue'guo'ping	0
薛国强	xue'guo'qiang	0
薛海	xue'hai	0
薛昊	xue'hao	0
雪红	xue'hong	0
薛稷	xue'ji	0
薛墨	xue'mo	0
雪葩	xue'pa	0
雪坪子	xue'ping'zi	0
薛仁	xue'ren	0
薛亚军	xue'ya'jun	0
薛雁群	xue'yan'qun	0
薛耀军	xue'yao'jun	0
薛幼春	xue'you'chun	0
雪渔	xue'yu	0
薛智国	xue'zhi'guo	0
雪竹图	xue'zhu'tu	0
熏翠轩	xun'cui'xuan	0
薰衣草紫	xun'yi'cao'zi	0
雅典蓝	ya'dian'lan	0
雅典绿	ya'dian'lv	0
砑画	ya'hua	0
压角章	ya'jiao'zhang	0
鸭蓝	ya'lan	0
亚丽	ya'li	0
芽绿	ya'lv	0
亚明	ya'ming	0
砑装	ya'zhuang	0
烟白	yan'bai	0
闫博	yan'bo	0
阎博	yan'bo	0
颜伯龙	yan'bo'long	0
阏伯台壁画	yan'bo'tai'bi'hua	0
岩彩	yan'cai	0
岩彩画	yan'cai'hua	0
颜成彪	yan'cheng'biao	0
艳橙红	yan'cheng'hong	0
燕春晓	yan'chun'xiao	0
阎次平	yan'ci'ping	0
阎次于	yan'ci'yu	0
颜地	yan'di	0
烟断匡庐图扇	yan'duan'kuang'lu'tu'shan	0
阎飞	yan'fei	0
燕飞翔	yan'fei'xiang	0
阎凤成	yan'feng'cheng	0
岩夫	yan'fu	0
晏国波	yan'guo'bo	0
鄢和曦	yan'he'xi	0
闫珩	yan'heng	0
闫虎	yan'hu	0
艳黄	yan'huang	0
颜辉	yan'hui	0
严家宽	yan'jia'kuan	0
闫江	yan'jiang	0
燕杰	yan'jie	0
闫金金	yan'jin'jin	0
闫金山	yan'jin'shan	0
艳蓝	yan'lan	0
严力	yan'li	0
阎立本	yan'li'ben	0
阎立德	yan'li'de	0
严林芳	yan'lin'fang	0
阎玲	yan'ling	0
严梅	yan'mei	0
燕美侬	yan'mei'nong	0
严培明	yan'pei'ming	0
阎毗	yan'pi	0
闫萍	yan'ping	0
闫平	yan'ping	0
阎萍	yan'ping	0
严荣滨	yan'rong'bin	0
烟润	yan'run	0
阎世宏	yan'shi'hong	0
言师仲	yan'shi'zhong	0
颜铁铮	yan'tie'zheng	0
闫同林	yan'tong'lin	0
燕文贵	yan'wen'gui	0
颜文梁	yan'wen'liang	0
阎文喜	yan'wen'xi	0
阎向东	yan'xiang'dong	0
闫祥田	yan'xiang'tian	0
阎晓庆	yan'xiao'qing	0
严雄梅	yan'xiong'mei	0
燕娅娅	yan'ya'ya	0
颜勇金	yan'yong'jin	0
颜苑馨	yan'yuan'xin	0
严湛	yan'zhan	0
阎振铎	yan'zhen'duo	0
严智龙	yan'zhi'long	0
阎仲	yan'zhong	0
淹渍	yan'zi	0
杨伯润	yang'bo'run	0
杨参军	yang'can'jun	0
杨成国	yang'cheng'guo	0
杨成寅	yang'cheng'yin	0
杨成愿	yang'cheng'yuan	0
杨冲霄	yang'chong'xiao	0
杨大鹏	yang'da'peng	0
杨大全	yang'da'quan	0
杨得聆	yang'de'ling	0
杨得清	yang'de'qing	0
杨登雄	yang'deng'xiong	0
杨涤江	yang'di'jiang	0
杨尔驹	yang'er'ju	0
杨法	yang'fa	0
杨福徐	yang'fu'xu	0
杨钢	yang'gang	0
阳高云林寺壁画	yang'gao'yun'lin'si'bi'hua	0
杨戈	yang'ge	0
杨光素	yang'guang'su	0
杨国辛	yang'guo'xin	0
杨国新	yang'guo'xin	0
杨寒梅	yang'han'mei	0
杨寒松	yang'han'song	0
杨浩平	yang'hao'ping	0
杨浩石	yang'hao'shi	0
洋红	yang'hong	0
杨红太	yang'hong'tai	0
杨骅	yang'hua	0
氧化铬绿	yang'hua'ge'lv	0
杨惠珺	yang'hui'jun	0
杨惠民	yang'hui'min	0
杨继德	yang'ji'de	0
杨佳樱	yang'jia'ying	0
杨家勇	yang'jia'yong	0
阳建德	yang'jian'de	0
杨建功	yang'jian'gong	0
杨健健	yang'jian'jian	0
杨建京	yang'jian'jing	0
杨建明	yang'jian'ming	0
杨健男	yang'jian'nan	0
杨兼正	yang'jian'zheng	0
仰角透视法	yang'jiao'tou'shi'fa	0
杨晋	yang'jin	0
杨金生	yang'jin'sheng	0
杨金宇	yang'jin'yu	0
杨竟成	yang'jing'cheng	0
杨景芝	yang'jing'zhi	0
杨九根	yang'jiu'gen	0
杨九云	yang'jiu'yun	0
杨克山	yang'ke'shan	0
杨娌娅	yang'li'ya	0
羊烈	yang'lie	0
杨柳青画社	yang'liu'qing'hua'she	0
杨柳浴禽图	yang'liu'yu'qin'tu	0
杨卯	yang'mao	0
羊毛白	yang'mao'bai	0
杨茂源	yang'mao'yuan	0
杨美艳	yang'mei'yan	0
杨墨音	yang'mo'yin	0
杨乃美	yang'nai'mei	0
杨念一	yang'nian'yi	0
杨欧	yang'ou	0
杨培钊	yang'pei'zhao	0
扬茜	yang'qian	0
杨乾钊	yang'qian'zhao	0
杨庆义	yang'qing'yi	0
阳泉关帝庙壁画	yang'quan'guan'di'miao'bi'hua	0
杨善深	yang'shan'shen	0
杨绍军	yang'shao'jun	0
杨绍路	yang'shao'lu	0
杨少彤	yang'shao'tong	0
杨升	yang'sheng	0
杨生丁	yang'sheng'ding	0
杨识宏	yang'shi'hong	0
杨世梁	yang'shi'liang	0
杨士贤	yang'shi'xian	0
杨世艳	yang'shi'yan	0
杨受安	yang'shou'an	0
杨述	yang'shu	0
杨双庆	yang'shuang'qing	0
杨顺泰	yang'shun'tai	0
杨思陶	yang'si'tao	0
杨松寿	yang'song'shou	0
杨素明	yang'su'ming	0
杨弢	yang'tao	0
杨天问	yang'tian'wen	0
杨庭光	yang'ting'guang	0
杨万忠	yang'wan'zhong	0
杨为	yang'wei	0
杨卫平	yang'wei'ping	0
杨文斌	yang'wen'bin	0
杨文萍	yang'wen'ping	0
杨文胜	yang'wen'sheng	0
扬无咎	yang'wu'jiu	0
杨熙志	yang'xi'zhi	0
杨贤飞	yang'xian'fei	0
洋县良马寺壁画	yang'xian'liang'ma'si'bi'hua	0
杨先平	yang'xian'ping	0
杨贤艺	yang'xian'yi	0
杨小兵	yang'xiao'bing	0
杨晓鲁	yang'xiao'lu	0
杨潇湘	yang'xiao'xiang	0
杨小彦	yang'xiao'yan	0
杨晓艺	yang'xiao'yi	0
杨新伟	yang'xin'wei	0
杨兴生	yang'xing'sheng	0
杨雄伟	yang'xiong'wei	0
杨学光	yang'xue'guang	0
杨勋	yang'xun	0
杨勋硕	yang'xun'shuo	0
杨艳芳	yang'yan'fang	0
杨严囊	yang'yan'nang	0
杨彦懿	yang'yan'yi	0
杨尧	yang'yao	0
杨怡凡	yang'yi'fan	0
杨一江	yang'yi'jiang	0
杨永家	yang'yong'jia	0
杨永仁	yang'yong'ren	0
杨毓进	yang'yu'jin	0
杨玉泉	yang'yu'quan	0
杨月强	yang'yue'qiang	0
杨云辉	yang'yun'hui	0
杨芷	yang'zhi	0
杨志高	yang'zhi'gao	0
杨之光	yang'zhi'guang	0
扬州博物馆	yang'zhou'bo'wu'guan	0
扬州胡场汉墓壁画	yang'zhou'hu'chang'han'mu'bi'hua	0
扬州画苑录	yang'zhou'hua'yuan'lu	0
杨宗军	yang'zong'jun	0
杨祖述	yang'zu'shu	0
杨作霖	yang'zuo'lin	0
姚重庆	yao'chong'qing	0
姚尔畅	yao'er'chang	0
姚建军	yao'jian'jun	0
姚锦发	yao'jin'fa	0
姚金凌	yao'jin'ling	0
姚俊中	yao'jun'zhong	0
姚铭	yao'ming	0
姚巧云	yao'qiao'yun	0
姚秦	yao'qin	0
姚榕华	yao'rong'hua	0
姚绍民	yao'shao'min	0
姚胜荣	yao'sheng'rong	0
姚世璧	yao'shi'bi	0
姚舜熙	yao'shun'xi	0
幺天泰	yao'tian'tai	0
姚廷美	yao'ting'mei	0
姚夏宁	yao'xia'ning	0
姚晓玫	yao'xiao'mei	0
姚学兵	yao'xue'bing	0
姚有多	yao'you'duo	0
姚振学	yao'zhen'xue	0
姚志伟	yao'zhi'wei	0
姚宗浩	yao'zong'hao	0
幺祖懿	yao'zu'yi	0
叶爱民	ye'ai'min	0
叶滨	ye'bin	0
叶城棋盘千佛洞壁画	ye'cheng'qi'pan'qian'fo'dong'bi'hua	0
叶恒贵	ye'heng'gui	0
叶剑青	ye'jian'qing	0
叶筋	ye'jin	0
叶经新	ye'jing'xin	0
夜兰	ye'lan	0
叶立夫	ye'li'fu	0
叶力萌	ye'li'meng	0
耶律倍	ye'lv'bei	0
叶苗田	ye'miao'tian	0
叶培基	ye'pei'ji	0
叶丕祥	ye'pi'xiang	0
叶琪	ye'qi	0
叶其璋	ye'qi'zhang	0
叶浅予	ye'qian'yu	0
叶强	ye'qiang	0
叶若海	ye'ruo'hai	0
夜色蓝	ye'se'lan	0
叶圣琴	ye'sheng'qin	0
野兽派	ye'shou'pai	0
叶松青	ye'song'qing	0
叶伟夫	ye'wei'fu	0
叶武林	ye'wu'lin	0
叶锡祚	ye'xi'zuo	0
叶献民	ye'xian'min	0
叶肖岩	ye'xiao'yan	0
叶欣	ye'xin	0
野逸派	ye'yi'pai	0
叶鹰宇	ye'ying'yu	0
叶勇	ye'yong	0
叶正昌	ye'zheng'chang	0
叶之琦	ye'zhi'qi	0
叶竹盛	ye'zhu'sheng	0
野紫色	ye'zi'se	0
叶左韬	ye'zuo'tao	0
夷白堂	yi'bai'tang	0
意大利蓝	yi'da'li'lan	0
伊德尔	yi'de'er	0
颐公	yi'gong	0
仪顾堂序跋	yi'gu'tang'xu'ba	0
一壑泉声图	yi'he'quan'sheng'tu	0
一画了矣	yi'hua'le'yi	0
一画明	yi'hua'ming	0
一画章	yi'hua'zhang	0
一画者	yi'hua'zhe	0
一画之法	yi'hua'zhi'fa	0
伊慧	yi'hui	0
一杰	yi'jie	0
易晶	yi'jing	0
意蓝	yi'lan	0
意临	yi'lin	0
伊林春	yi'lin'chun	0
伊灵	yi'ling	0
蚁美楷	yi'mei'kai	0
意明笔透	yi'ming'bi'tou	0
以墨代色	yi'mo'dai'se	0
伊茹罕	yi'ru'han	0
一色式装裱	yi'se'shi'zhuang'biao	0
易雯	yi'wen	0
伊贤彬	yi'xian'bin	0
义县奉国寺壁画	yi'xian'feng'guo'si'bi'hua	0
伊玄	yi'xuan	0
乙妍	yi'yan	0
易艺源	yi'yi'yuan	0
易英	yi'ying	0
易鹰	yi'ying	0
易永辉	yi'yong'hui	0
易元吉	yi'yuan'ji	0
一枝阁	yi'zhi'ge	0
益州名画录	yi'zhou'ming'hua'lu	0
尹呈忠	yin'cheng'zhong	0
尹大河	yin'da'he	0
殷代奎	yin'dai'kui	0
印第安红	yin'di'an'hong	0
印定才	yin'ding'cai	0
印度黄	yin'du'huang	0
尹国光	yin'guo'guang	0
尹国良	yin'guo'liang	0
尹洪	yin'hong	0
殷洪	yin'hong	0
银灰绿	yin'hui'lv	0
隐款	yin'kuan	0
音茗	yin'ming	0
尹佩	yin'pei	0
尹鹏飞	yin'peng'fei	0
尹齐	yin'qi	0
阴晴各异	yin'qing'ge'yi	0
尹戎生	yin'rong'sheng	0
殷锐松	yin'rui'song	0
引首	yin'shou	0
尹瘦石	yin'shou'shi	0
尹向东	yin'xiang'dong	0
印象画派	yin'xiang'hua'pai	0
尹小斌	yin'xiao'bin	0
阴晓雪	yin'xiao'xue	0
尹欣	yin'xin	0
印宣	yin'xuan	0
尹雁华	yin'yan'hua	0
殷燕祥	yin'yan'xiang	0
尹扬华	yin'yang'hua	0
阴阳向背	yin'yang'xiang'bei	0
尹宇宁	yin'yu'ning	0
尹朝阳	yin'zhao'yang	0
殷智群	yin'zhi'qun	0
殷仲咨	yin'zhong'zi	0
殷梓湘	yin'zi'xiang	0
印宗秦汉	yin'zong'qin'han	0
尹佐民	yin'zuo'min	0
硬边艺术	ying'bian'yi'shu	0
营城子汉墓壁画	ying'cheng'zi'han'mu'bi'hua	0
映光壁画	ying'guang'bi'hua	0
荧光橙	ying'guang'cheng	0
莹光橙	ying'guang'cheng	0
荧光绿	ying'guang'lv	0
莹光绿	ying'guang'lv	0
荧光色	ying'guang'se	0
英国红	ying'guo'hong	0
荧黄	ying'huang	0
茔绿	ying'lv	0
荧绿	ying'lv	0
莹绿	ying'lv	0
瘿瓢	ying'piao	0
应歧	ying'qi	0
应世明	ying'shi'ming	0
应县净土寺壁画	ying'xian'jing'tu'si'bi'hua	0
应小杰	ying'xiao'jie	0
应野平	ying'ye'ping	0
永春纸织画	yong'chun'zhi'zhi'hua	0
永靖炳灵寺石窟壁画	yong'jing'bing'ling'si'shi'ku'bi'hua	0
永乐宫壁画	yong'le'gong'bi'hua	0
雍林	yong'lin	0
永宁寺佛塔塔基壁画	yong'ning'si'fo'ta'ta'ji'bi'hua	0
有剥落	you'bo'luo	0
有冲霄	you'chong'xiao	0
有嵯峨	you'cuo'e	0
游东醌	you'dong'kun	0
有丰致	you'feng'zhi	0
幽谷蓝	you'gu'lan	0
游海明	you'hai'ming	0
游华阳山图	you'hua'yang'shan'tu	0
游健	you'jian	0
尤开民	you'kai'min	0
有漓岏	you'li'wan	0
尤美玲	you'mei'ling	0
游敏	you'min	0
有磅礴	you'pang'bo	0
有飘缈	you'piao'miao	0
有奇峭	you'qi'qiao	0
有潜伏	you'qian'fu	0
游守中	you'shou'zhong	0
游丝描	you'si'miao	0
幽溪垂钓图	you'xi'chui'diao'tu	0
有险峻	you'xian'jun	0
右玉宝宁寺壁画	you'yu'bao'ning'si'bi'hua	0
有崱屴	you'ze'li	0
游正烽	you'zheng'feng	0
邮政绿	you'zheng'lv	0
于阿军	yu'a'jun	0
于艾君	yu'ai'jun	0
于安东	yu'an'dong	0
余超	yu'chao	0
余陈	yu'chen	0
俞成浩	yu'cheng'hao	0
俞成辉	yu'cheng'hui	0
于成松	yu'cheng'song	0
余承志	yu'cheng'zhi	0
榆次明墓壁画	yu'ci'ming'mu'bi'hua	0
于达	yu'da	0
喻丹诺	yu'dan'nuo	0
俞涤凡	yu'di'fan	0
雨点皴	yu'dian'cun	0
余都	yu'dou	0
羽豆紫	yu'dou'zi	0
于方浦	yu'fang'pu	0
于非闇	yu'fei'an	0
于非厂	yu'fei'chang	0
瘀粉红	yu'fen'hong	0
于福庚	yu'fu'geng	0
渔夫图	yu'fu'tu	0
渔父图	yu'fu'tu	0
于桂元	yu'gui'yuan	0
余含兮	yu'han'xi	0
余杭看山图卷	yu'hang'kan'shan'tu'juan	0
瘀红	yu'hong	0
鬻画	yu'hua	0
余华珍	yu'hua'zhen	0
喻慧	yu'hui	0
喻继高	yu'ji'gao	0
余继平	yu'ji'ping	0
俞剑华	yu'jian'hua	0
俞可	yu'ke	0
于克敏	yu'ke'min	0
俞乐孙	yu'le'sun	0
俞乐逊	yu'le'xun	0
余力茵	yu'li'yin	0
榆林窟壁画	yu'lin'ku'bi'hua	0
玉绿	yu'lv	0
于美玲	yu'mei'ling	0
玉门昌马石窟壁画	yu'men'chang'ma'shi'ku'bi'hua	0
玉米黄	yu'mi'huang	0
于明雷	yu'ming'lei	0
于彭	yu'peng	0
于普洁	yu'pu'jie	0
于荣国	yu'rong'guo	0
语山和尚	yu'shan'he'shang	0
余尚泓	yu'shang'hong	0
余绍宋	yu'shao'song	0
余省	yu'sheng	0
于生文	yu'sheng'wen	0
于省吾	yu'sheng'wu	0
玉石白	yu'shi'bai	0
余世芳	yu'shi'fang	0
玉树文成公主庙壁画	yu'shu'wen'cheng'gong'zhu'miao'bi'hua	0
余素政	yu'su'zheng	0
余统章	yu'tong'zhang	0
於薇	yu'wei	0
欲下先上	yu'xia'xian'shang	0
余湘治	yu'xiang'zhi	0
于小东	yu'xiao'dong	0
玉屑皴	yu'xie'cun	0
毓鑫	yu'xin	0
余旭鸿	yu'xu'hong	0
于学志	yu'xue'zhi	0
于瀛洲	yu'ying'zhou	0
于泳华	yu'yong'hua	0
于永强	yu'yong'qiang	0
欲右先左	yu'you'xian'zuo	0
于远廷	yu'yuan'ting	0
俞云阶	yu'yun'jie	0
喻振海	yu'zhen'hai	0
于振立	yu'zhen'li	0
羽枝	yu'zhi	0
禹之鼎	yu'zhi'ding	0
余之钦	yu'zhi'qin	0
余致贞	yu'zhi'zhen	0
俞致贞	yu'zhi'zhen	0
俞中保	yu'zhong'bao	0
羽轴	yu'zhou	0
于祖培	yu'zu'pei	0
原白	yuan'bai	0
元代山水	yuan'dai'shan'shui	0
员炖	yuan'dun	0
元冯道真墓壁画	yuan'feng'dao'zhen'mu'bi'hua	0
原夫	yuan'fu	0
袁广	yuan'guang	0
苑广华	yuan'guang'hua	0
袁国浩	yuan'guo'hao	0
远航白	yuan'hang'bai	0
袁慧铭	yuan'hui'ming	0
袁吉中	yuan'ji'zhong	0
袁佳	yuan'jia	0
袁江	yuan'jiang	0
袁俐	yuan'li	0
袁黎鸣	yuan'li'ming	0
袁培基	yuan'pei'ji	0
元圃方壶	yuan'pu'fang'hu	0
袁勤华	yuan'qin'hua	0
袁荣明	yuan'rong'ming	0
远山法	yuan'shan'fa	0
原绍温	yuan'shao'wen	0
元四家	yuan'si'jia	0
院体画风	yuan'ti'hua'feng	0
鸢尾蓝	yuan'wei'lan	0
袁文彬	yuan'wen'bin	0
原武温穆王墓壁画	yuan'wu'wen'mu'wang'mu'bi'hua	0
袁晓舫	yuan'xiao'fang	0
袁耀	yuan'yao	0
袁耀锷	yuan'yao'e	0
袁跃敏	yuan'yue'min	0
袁运生	yuan'yun'sheng	0
袁正阳	yuan'zheng'yang	0
元朱文	yuan'zhu'wen	0
月光蓝	yue'guang'lan	0
岳归堂	yue'gui'tang	0
岳凯	yue'kai	0
岳敏君	yue'min'jun	0
粤山人	yue'shan'ren	0
岳首群	yue'shou'qun	0
月仪帖	yue'yi'tie	0
岳婴	yue'ying	0
运笔运腕	yun'bi'yun'wan	0
恽格	yun'ge	0
云流水描	yun'liu'shui'miao	0
恽圻苍	yun'qi'cang	0
运情摹景	yun'qing'mo'jing	0
晕染	yun'ran	0
晕染法	yun'ran'fa	0
恽寿平	yun'shou'ping	0
云台峰	yun'tai'feng	0
云头皴	yun'tou'cun	0
运腕章	yun'wan'zhang	0
云维英	yun'wei'ying	0
杂朗敏珠林寺壁画	za'lang'min'zhu'lin'si'bi'hua	0
再廷	zai'ting	0
再育	zai'yu	0
臧尔康	zang'er'kang	0
臧林川	zang'lin'chuan	0
臧永杰	zang'yong'jie	0
枣核描	zao'he'miao	0
曾庆明	zeng'qing'ming	0
扎朗桑鸢寺主殿壁画	zha'lang'sang'yuan'si'zhu'dian'bi'hua	0
翟爽	zhai'shuang	0
翟欣建	zhai'xin'jian	0
翟一	zhai'yi	0
詹保国	zhan'bao'guo	0
战笔	zhan'bi	0
战笔水纹描	zhan'bi'shui'wen'miao	0
詹鸿昌	zhan'hong'chang	0
詹建俊	zhan'jian'jun	0
詹锦川	zhan'jin'chuan	0
詹金水	zhan'jin'shui	0
詹维克	zhan'wei'ke	0
詹学富	zhan'xue'fu	0
詹学军	zhan'xue'jun	0
展子虔	zhan'zi'qian	0
张爱平	zhang'ai'ping	0
张爱思	zhang'ai'si	0
张霭维	zhang'ai'wei	0
张安君	zhang'an'jun	0
张八股	zhang'ba'gu	0
章犇	zhang'ben	0
张笨山	zhang'ben'shan	0
张濒	zhang'bin	0
张炳堂	zhang'bing'tang	0
张昌富	zhang'chang'fu	0
张昌贵	zhang'chang'gui	0
张晨初	zhang'chen'chu	0
张成久	zhang'cheng'jiu	0
张崇林	zhang'chong'lin	0
张重庆	zhang'chong'qing	0
张崇政	zhang'chong'zheng	0
张春继	zhang'chun'ji	0
张春亮	zhang'chun'liang	0
张纯强	zhang'chun'qiang	0
张春迎	zhang'chun'ying	0
张存良	zhang'cun'liang	0
张大刚	zhang'da'gang	0
张大力	zhang'da'li	0
张达伦	zhang'da'lun	0
张大千	zhang'da'qian	0
张大畏	zhang'da'wei	0
张聃	zhang'dan	0
章德甫	zhang'de'fu	0
张德宏	zhang'de'hong	0
张德禄	zhang'de'lu	0
章德平	zhang'de'ping	0
张德瑞	zhang'de'rui	0
张定钊	zhang'ding'zhao	0
张东发	zhang'dong'fa	0
张恩卫	zhang'en'wei	0
张二虎	zhang'er'hu	0
张耳立	zhang'er'li	0
张尔立	zhang'er'li	0
张法根	zhang'fa'gen	0
张发志	zhang'fa'zhi	0
张方白	zhang'fang'bai	0
张方震	zhang'fang'zhen	0
张飞宇	zhang'fei'yu	0
张复乘	zhang'fu'cheng	0
张复利	zhang'fu'li	0
章涪陵	zhang'fu'ling	0
张福权	zhang'fu'quan	0
张功悫	zhang'gong'que	0
张弓正	zhang'gong'zheng	0
张贯一	zhang'guan'yi	0
张国兵	zhang'guo'bing	0
张国丰	zhang'guo'feng	0
张国刚	zhang'guo'gang	0
张国龙	zhang'guo'long	0
张海鹰	zhang'hai'ying	0
张瀚尹	zhang'han'yin	0
张鹤野	zhang'he'ye	0
张宏	zhang'hong	0
张鸿斌	zhang'hong'bin	0
张红年	zhang'hong'nian	0
张鸿伟	zhang'hong'wei	0
张宏翔	zhang'hong'xiang	0
张洪赞	zhang'hong'zan	0
张洪忠	zhang'hong'zhong	0
张厚存	zhang'hou'cun	0
张骅骝	zhang'hua'liu	0
张化彦	zhang'hua'yan	0
张淮军	zhang'huai'jun	0
张怀信	zhang'huai'xin	0
张徽军	zhang'hui'jun	0
张慧可	zhang'hui'ke	0
张继生	zhang'ji'sheng	0
张浃	zhang'jia	0
张加良	zhang'jia'liang	0
张家麟	zhang'jia'lin	0
张加言	zhang'jia'yan	0
张嘉应	zhang'jia'ying	0
张建岗	zhang'jian'gang	0
张健国	zhang'jian'guo	0
张建俊	zhang'jian'jun	0
张建晓	zhang'jian'xiao	0
张建云	zhang'jian'yun	0
张晋江	zhang'jin'jiang	0
章晋荔	zhang'jin'li	0
张景苍	zhang'jing'cang	0
张经国	zhang'jing'guo	0
张珺	zhang'jun	0
张开宇	zhang'kai'yu	0
张坤仪	zhang'kun'yi	0
丈蓝	zhang'lan	0
张利昌	zhang'li'chang	0
张力绘	zhang'li'hui	0
张利敏	zhang'li'min	0
张立农	zhang'li'nong	0
张立平	zhang'li'ping	0
张立宪	zhang'li'xian	0
张连方	zhang'lian'fang	0
张莲英	zhang'lian'ying	0
张玲娣	zhang'ling'di	0
张流芳	zhang'liu'fang	0
张路	zhang'lu	0
张路江	zhang'lu'jiang	0
张绿江	zhang'lv'jiang	0
张茂东	zhang'mao'dong	0
张明燕	zhang'ming'yan	0
张墨	zhang'mo	0
张乃贵	zhang'nai'gui	0
张乃涵	zhang'nai'han	0
张南本	zhang'nan'ben	0
张南村	zhang'nan'cun	0
张攀峰	zhang'pan'feng	0
张培松	zhang'pei'song	0
张丕余	zhang'pi'yu	0
张平杰	zhang'ping'jie	0
张浦山	zhang'pu'shan	0
张奇开	zhang'qi'kai	0
张钦若	zhang'qin'ruo	0
丈青	zhang'qing	0
张清宏	zhang'qing'hong	0
丈青灰	zhang'qing'hui	0
丈青蓝	zhang'qing'lan	0
丈青色	zhang'qing'se	0
张琼飞	zhang'qiong'fei	0
张秋海	zhang'qiu'hai	0
张铨	zhang'quan	0
张全普	zhang'quan'pu	0
张群鸿	zhang'qun'hong	0
张仁强	zhang'ren'qiang	0
章仁缘	zhang'ren'yuan	0
张荣昌	zhang'rong'chang	0
张汝作	zhang'ru'zuo	0
张瑞图	zhang'rui'tu	0
张润世	zhang'run'shi	0
张若澄	zhang'ruo'cheng	0
张僧繇	zhang'seng'yao	0
张善孖	zhang'shan'ma	0
张绍杰	zhang'shao'jie	0
张少龙	zhang'shao'long	0
张胜文	zhang'sheng'wen	0
张胜赞	zhang'sheng'zan	0
张世范	zhang'shi'fan	0
张世建	zhang'shi'jian	0
张世简	zhang'shi'jian	0
张世君	zhang'shi'jun	0
张世申	zhang'shi'shen	0
张师图	zhang'shi'tu	0
张士英	zhang'shi'ying	0
张世忠	zhang'shi'zhong	0
张守武	zhang'shou'wu	0
张树功	zhang'shu'gong	0
张书旗	zhang'shu'qi	0
张述盛	zhang'shu'sheng	0
张书声	zhang'shu'sheng	0
章姝贤	zhang'shu'xian	0
张顺成	zhang'shun'cheng	0
张顺川	zhang'shun'chuan	0
张舜咨	zhang'shun'zi	0
张思恭	zhang'si'gong	0
张四民	zhang'si'min	0
张颂东	zhang'song'dong	0
张颂南	zhang'song'nan	0
张台生	zhang'tai'sheng	0
张田力	zhang'tian'li	0
张庭群	zhang'ting'qun	0
张彤云	zhang'tong'yun	0
张鮀生	zhang'tuo'sheng	0
张万传	zhang'wan'chuan	0
张万凌	zhang'wan'ling	0
张宛玲	zhang'wan'ling	0
张巍峥	zhang'wei'zheng	0
张文彬	zhang'wen'bin	0
章文果	zhang'wen'guo	0
张文惠	zhang'wen'hui	0
章文明	zhang'wen'ming	0
章文熙	zhang'wen'xi	0
张文源	zhang'wen'yuan	0
张翁	zhang'weng	0
张渥	zhang'wo	0
障无法	zhang'wu'fa	0
张悟真	zhang'wu'zhen	0
张希华	zhang'xi'hua	0
张喜忠	zhang'xi'zhong	0
张显都	zhang'xian'dou	0
张宪梁	zhang'xian'liang	0
张项军	zhang'xiang'jun	0
章晓明	zhang'xiao'ming	0
张笑蕊	zhang'xiao'rui	0
张孝师	zhang'xiao'shi	0
张小溪	zhang'xiao'xi	0
张谢雄	zhang'xie'xiong	0
张辛稼	zhang'xin'jia	0
张新权	zhang'xin'quan	0
张兴刚	zhang'xing'gang	0
张幸亏	zhang'xing'kui	0
张兴元	zhang'xing'yuan	0
张秀清	zhang'xiu'qing	0
张秀兴	zhang'xiu'xing	0
张萱	zhang'xuan	0
张学海	zhang'xue'hai	0
张学颜	zhang'xue'yan	0
张训礼	zhang'xun'li	0
张亚宝	zhang'ya'bao	0
张亚君	zhang'ya'jun	0
张亚晓	zhang'ya'xiao	0
张衍海	zhang'yan'hai	0
张艳萍	zhang'yan'ping	0
张雁雁	zhang'yan'yan	0
章耀达	zhang'yao'da	0
张耀煌	zhang'yao'huang	0
张耀宁	zhang'yao'ning	0
张瑶星	zhang'yao'xing	0
张掖大佛寺壁画	zhang'ye'da'fo'si'bi'hua	0
张掖马蹄寺石窟壁画	zhang'ye'ma'ti'si'shi'ku'bi'hua	0
张翊	zhang'yi	0
章毅	zhang'yi	0
章益	zhang'yi	0
张一波	zhang'yi'bo	0
张义春	zhang'yi'chun	0
张抑高	zhang'yi'gao	0
张一弓	zhang'yi'gong	0
张忆辉	zhang'yi'hui	0
张艺群	zhang'yi'qun	0
张义勇	zhang'yi'yong	0
张忆周	zhang'yi'zhou	0
张印宣	zhang'yin'xuan	0
张英彬	zhang'ying'bin	0
张迎成	zhang'ying'cheng	0
张应华	zhang'ying'hua	0
张永村	zhang'yong'cun	0
张永德	zhang'yong'de	0
张永来	zhang'yong'lai	0
张永年	zhang'yong'nian	0
张永培	zhang'yong'pei	0
张永齐	zhang'yong'qi	0
张永生	zhang'yong'sheng	0
张永旭	zhang'yong'xu	0
张永正	zhang'yong'zheng	0
张雨	zhang'yu	0
张瑀	zhang'yu	0
张郁葱	zhang'yu'cong	0
张玉刚	zhang'yu'gang	0
张玉剑	zhang'yu'jian	0
张玉泉	zhang'yu'quan	0
张玉水	zhang'yu'shui	0
张羽忠	zhang'yu'zhong	0
张雨舟	zhang'yu'zhou	0
张玉竹	zhang'yu'zhu	0
张远达	zhang'yuan'da	0
漳元明墓壁画	zhang'yuan'ming'mu'bi'hua	0
张云海	zhang'yun'hai	0
张韫韬	zhang'yun'tao	0
张璪	zhang'zao	0
张择端	zhang'ze'duan	0
张占山	zhang'zhan'shan	0
张照云	zhang'zhao'yun	0
张振江	zhang'zhen'jiang	0
张振仕	zhang'zhen'shi	0
张正刚	zhang'zheng'gang	0
章政民	zhang'zheng'min	0
张志成	zhang'zhi'cheng	0
张志琪	zhang'zhi'qi	0
张中亮	zhang'zhong'liang	0
张周	zhang'zhou	0
张准立	zhang'zhun'li	0
障自画退	zhang'zi'hua'tui	0
张籽蕾	zhang'zi'lei	0
张自薿	zhang'zi'ni	0
张子奇	zhang'zi'qi	0
张子威	zhang'zi'wei	0
张自嶷	zhang'zi'yi	0
张自正	zhang'zi'zheng	0
张宗苍	zhang'zong'cang	0
张祖翼	zhang'zu'yi	0
赵哀	zhao'ai	0
赵蓓欣	zhao'bei'xin	0
赵碧琴	zhao'bi'qin	0
赵伯驹	zhao'bo'ju	0
赵伯肃	zhao'bo'su	0
赵昌	zhao'chang	0
赵城璞	zhao'cheng'pu	0
赵崇衍	zhao'chong'yan	0
赵春富	zhao'chun'fu	0
赵春翔	zhao'chun'xiang	0
赵大陆	zhao'da'lu	0
赵丹琪	zhao'dan'qi	0
赵德伟	zhao'de'wei	0
赵盾	zhao'dun	0
赵风	zhao'feng	0
赵罡	zhao'gang	0
赵公佑	zhao'gong'you	0
赵光辅	zhao'guang'fu	0
赵光涛	zhao'guang'tao	0
赵贵男	zhao'gui'nan	0
赵国经	zhao'guo'jing	0
赵蘅	zhao'heng	0
赵宏斌	zhao'hong'bin	0
赵红斌	zhao'hong'bin	0
赵弘君	zhao'hong'jun	0
赵宏利	zhao'hong'li	0
赵洪贤	zhao'hong'xian	0
赵佶	zhao'ji	0
赵家亮	zhao'jia'liang	0
赵金鹤	zhao'jin'he	0
赵净	zhao'jing	0
赵九杰	zhao'jiu'jie	0
赵俊荣	zhao'jun'rong	0
赵开坤	zhao'kai'kun	0
赵阆仙	zhao'lang'xian	0
赵利民	zhao'li'min	0
赵力中	zhao'li'zhong	0
赵良恒	zhao'liang'heng	0
赵麟	zhao'lin	0
赵令穰	zhao'ling'rang	0
赵路娟	zhao'lu'juan	0
赵仑	zhao'lun	0
赵履中	zhao'lv'zhong	0
赵孟頫	zhao'meng'fu	0
赵孟坚	zhao'meng'jian	0
赵弥	zhao'mi	0
赵能智	zhao'neng'zhi	0
赵培智	zhao'pei'zhi	0
赵麒麟	zhao'qi'lin	0
赵柒棋	zhao'qi'qi	0
赵千红	zhao'qian'hong	0
赵芹	zhao'qin	0
赵琴原	zhao'qin'yuan	0
罩染	zhao'ran	0
赵山甫	zhao'shan'fu	0
赵少昂	zhao'shao'ang	0
赵胜凯	zhao'sheng'kai	0
赵时冈	zhao'shi'gang	0
赵世君	zhao'shi'jun	0
赵淑钦	zhao'shu'qin	0
赵嗣发	zhao'si'fa	0
赵思亮	zhao'si'liang	0
赵嵩青	zhao'song'qing	0
赵拓	zhao'tuo	0
赵万济	zhao'wan'ji	0
赵望明	zhao'wang'ming	0
赵望云	zhao'wang'yun	0
赵维华	zhao'wei'hua	0
赵渭凉	zhao'wei'liang	0
赵维奇	zhao'wei'qi	0
赵文霞	zhao'wen'xia	0
赵希玮	zhao'xi'wei	0
赵县柏林寺壁画	zhao'xian'bo'lin'si'bi'hua	0
赵宪辛	zhao'xian'xin	0
赵宪忠	zhao'xian'zhong	0
照相蚀刻法	zhao'xiang'shi'ke'fa	0
赵相云	zhao'xiang'yun	0
赵晓佳	zhao'xiao'jia	0
赵小熙	zhao'xiao'xi	0
赵新平	zhao'xin'ping	0
赵雪峰	zhao'xue'feng	0
赵雪枫	zhao'xue'feng	0
赵亚南	zhao'ya'nan	0
朝阳金墓壁画	zhao'yang'jin'mu'bi'hua	0
赵奕	zhao'yi	0
赵一恒	zhao'yi'heng	0
赵以雄	zhao'yi'xiong	0
赵彝斋	zhao'yi'zhai	0
赵银鸥	zhao'yin'ou	0
赵映岚	zhao'ying'lan	0
赵雍	zhao'yong	0
赵永勃	zhao'yong'bo	0
赵永军	zhao'yong'jun	0
赵永康	zhao'yong'kang	0
赵友萍	zhao'you'ping	0
赵域	zhao'yu	0
赵玉琢	zhao'yu'zhuo	0
赵原	zhao'yuan	0
赵月儿	zhao'yue'er	0
赵允安	zhao'yun'an	0
赵云壑	zhao'yun'he	0
赵昭宝	zhao'zhao'bao	0
赵振岩	zhao'zhen'yan	0
赵之琛	zhao'zhi'chen	0
赵之公	zhao'zhi'gong	0
赵舟进	zhao'zhou'jin	0
赵子泌	zhao'zi'mi	0
赵子谦	zhao'zi'qian	0
赵子泗	zhao'zi'si	0
赵子忠	zhao'zi'zhong	0
赵宗宝	zhao'zong'bao	0
赵左	zhao'zuo	0
赵佐权	zhao'zuo'quan	0
赵作咏	zhao'zuo'yong	0
折带皴	zhe'dai'cun	0
折股钗	zhe'gu'chai	0
赭灰	zhe'hui	0
折技	zhe'ji	0
折芦描	zhe'lu'miao	0
赭绿色	zhe'lv'se	0
折扇面	zhe'shan'mian	0
珍果黄	zhen'guo'huang	0
甄莲	zhen'lian	0
甄玮	zhen'wei	0
甄兆良	zhen'zhao'liang	0
阵正帅	zhen'zheng'shuai	0
珍珠灰	zhen'zhu'hui	0
珍珠蓝	zhen'zhu'lan	0
郑柏楠	zheng'bai'nan	0
正瓣	zheng'ban	0
郑昌中	zheng'chang'zhong	0
郑朝尧	zheng'chao'yao	0
郑驰	zheng'chi	0
郑春龙	zheng'chun'long	0
正定隆兴寺壁画	zheng'ding'long'xing'si'bi'hua	0
郑法士	zheng'fa'shi	0
郑方伟	zheng'fang'wei	0
郑国谷	zheng'guo'gu	0
郑海峰	zheng'hai'feng	0
郑红建	zheng'hong'jian	0
郑洪流	zheng'hong'liu	0
郑红强	zheng'hong'qiang	0
郑宏章	zheng'hong'zhang	0
郑瑚山	zheng'hu'shan	0
郑捷克	zheng'jie'ke	0
郑锦波	zheng'jin'bo	0
郑锦源	zheng'jin'yuan	0
郑炯灶	zheng'jiong'zao	0
郑君山	zheng'jun'shan	0
郑康乐	zheng'kang'le	0
郑克英	zheng'ke'ying	0
郑坤卫	zheng'kun'wei	0
郑力	zheng'li	0
郑莉娟	zheng'li'juan	0
郑黎生	zheng'li'sheng	0
郑丽云	zheng'li'yun	0
郑录高	zheng'lu'gao	0
郑路迅	zheng'lu'xun	0
郑慕康	zheng'mu'kang	0
郑彭寿	zheng'peng'shou	0
郑琪	zheng'qi	0
郑琪棻	zheng'qi'fen	0
郑虔	zheng'qian	0
郑荣儒	zheng'rong'ru	0
郑胜天	zheng'sheng'tian	0
郑思肖	zheng'si'xiao	0
郑天君	zheng'tian'jun	0
郑万林	zheng'wan'lin	0
郑为	zheng'wei	0
郑文雄	zheng'wen'xiong	0
郑午昌	zheng'wu'chang	0
郑西野	zheng'xi'ye	0
郑贤科	zheng'xian'ke	0
郑晓锋	zheng'xiao'feng	0
郑小河	zheng'xiao'he	0
郑晓红	zheng'xiao'hong	0
郑燮	zheng'xie	0
郑星光	zheng'xing'guang	0
郑修钤	zheng'xiu'qian	0
郑雅风	zheng'ya'feng	0
正叶	zheng'ye	0
郑艺	zheng'yi	0
郑毅强	zheng'yi'qiang	0
郑莺玉	zheng'ying'yu	0
郑佑	zheng'you	0
郑云海	zheng'yun'hai	0
郑在东	zheng'zai'dong	0
郑载飏	zheng'zai'yang	0
郑泽新	zheng'ze'xin	0
郑兆贵	zheng'zhao'gui	0
郑征泉	zheng'zheng'quan	0
郑中凯	zheng'zhong'kai	0
郑拙庐	zheng'zhuo'lu	0
郑子钢	zheng'zi'gang	0
知白当黑	zhi'bai'dang'hei	0
纸本水墨	zhi'ben'shui'mo	0
芝光林	zhi'guang'lin	0
汁绿	zhi'lv	0
芝麻皴	zhi'ma'cun	0
至上主义	zhi'shang'zhu'yi	0
直托	zhi'tuo	0
纸镶绫边	zhi'xiang'ling'bian	0
中宝蓝	zhong'bao'lan	0
钟飙	zhong'biao	0
钟飚	zhong'biao	0
重彩画	zhong'cai'hua	0
重彩人物法	zhong'cai'ren'wu'fa	0
钟灿文	zhong'can'wen	0
钟长春	zhong'chang'chun	0
中橙	zhong'cheng	0
钟楚田	zhong'chu'tian	0
钟春琛	zhong'chun'chen	0
中等蓝	zhong'deng'lan	0
钟定强	zhong'ding'qiang	0
中啡	zhong'fei	0
中粉	zhong'fen	0
中粉红	zhong'fen'hong	0
中锋行笔	zhong'feng'xing'bi	0
钟纲	zhong'gang	0
钟耕略	zhong'geng'lve	0
中宫收缩	zhong'gong'shou'suo	0
钟光武	zhong'guang'wu	0
中国工笔画	zhong'guo'gong'bi'hua	0
中国画论辑要	zhong'guo'hua'lun'ji'yao	0
钟国良	zhong'guo'liang	0
钟国友	zhong'guo'you	0
中湖蓝	zhong'hu'lan	0
中花灰	zhong'hua'hui	0
钟华友	zhong'hua'you	0
中黄	zhong'huang	0
中灰	zhong'hui	0
中兰	zhong'lan	0
中蓝紫	zhong'lan'zi	0
中绿	zhong'lv	0
重屏会棋图	zhong'ping'hui'qi'tu	0
钟瑞芬	zhong'rui'fen	0
中世纪蓝	zhong'shi'ji'lan	0
中世纪美术	zhong'shi'ji'mei'shu	0
钟世家	zhong'shi'jia	0
种松图小像	zhong'song'tu'xiao'xiang	0
中堂	zhong'tang	0
中桃红	zhong'tao'hong	0
钟天兵	zhong'tian'bing	0
中杏色	zhong'xing'se	0
钟兴旺	zhong'xing'wang	0
钟兴吾	zhong'xing'wu	0
钟彦畲	zhong'yan'she	0
钟以勤	zhong'yi'qin	0
钟英明	zhong'ying'ming	0
钟勇强	zhong'yong'qiang	0
中有实	zhong'you'shi	0
钟玉行	zhong'yu'xing	0
钟跃	zhong'yue	0
中仔兰	zhong'zai'lan	0
钟照	zhong'zhao	0
仲兆麟	zhong'zhao'lin	0
中紫	zhong'zi	0
周安琪	zhou'an'qi	0
周百玲	zhou'bai'ling	0
周本义	zhou'ben'yi	0
周碧初	zhou'bi'chu	0
周补田	zhou'bu'tian	0
周才生	zhou'cai'sheng	0
周昌谷	zhou'chang'gu	0
周昌泉	zhou'chang'quan	0
周昌新	zhou'chang'xin	0
周臣	zhou'chen	0
周晨曦	zhou'chen'xi	0
周崇涨	zhou'chong'zhang	0
周春芽	zhou'chun'ya	0
周琮凯	zhou'cong'kai	0
周大集	zhou'da'ji	0
周大正	zhou'da'zheng	0
周鼎	zhou'ding	0
周度其	zhou'du'qi	0
周发武	zhou'fa'wu	0
周昉	zhou'fang	0
周风海	zhou'feng'hai	0
周逢俊	zhou'feng'jun	0
周富有	zhou'fu'you	0
周光玠	zhou'guang'jie	0
周国富	zhou'guo'fu	0
周海峰	zhou'hai'feng	0
周寒	zhou'han	0
周华如	zhou'hua'ru	0
周积寅	zhou'ji'yin	0
周柬	zhou'jian	0
周建德	zhou'jian'de	0
周皎	zhou'jiao	0
周君华	zhou'jun'hua	0
周连德	zhou'lian'de	0
周临溪	zhou'lin'xi	0
周路石	zhou'lu'shi	0
周铭举	zhou'ming'ju	0
周鸣祥	zhou'ming'xiang	0
周慕然	zhou'mu'ran	0
周鹏程	zhou'peng'cheng	0
周苹	zhou'ping	0
周榕清	zhou'rong'qing	0
周瑞文	zhou'rui'wen	0
周少立	zhou'shao'li	0
周仕超	zhou'shi'chao	0
周诗成	zhou'shi'cheng	0
周是一	zhou'shi'yi	0
周思聪	zhou'si'cong	0
周添渊	zhou'tian'yuan	0
周铁利	zhou'tie'li	0
周廷旭	zhou'ting'xu	0
周晚菘	zhou'wan'song	0
周伟华	zhou'wei'hua	0
周文辉	zhou'wen'hui	0
周文中	zhou'wen'zhong	0
周先英	zhou'xian'ying	0
周向林	zhou'xiang'lin	0
周向一	zhou'xiang'yi	0
周晓波	zhou'xiao'bo	0
周小松	zhou'xiao'song	0
周小愚	zhou'xiao'yu	0
周信雄	zhou'xin'xiong	0
周彦生	zhou'yan'sheng	0
周洋明	zhou'yang'ming	0
周泳	zhou'yong	0
周有武	zhou'you'wu	0
周煜嵋	zhou'yu'mei	0
周志杰	zhou'zhi'jie	0
周中耀	zhou'zhong'yao	0
周子曦	zhou'zi'xi	0
周祖泰	zhou'zu'tai	0
朱膘	zhu'biao	0
朱磦	zhu'biao	0
竹禅	zhu'chan	0
祝昌	zhu'chang	0
朱偁	zhu'chen	0
朱春林	zhu'chun'lin	0
朱大海	zhu'da'hai	0
朱道平	zhu'dao'ping	0
朱德义	zhu'de'yi	0
朱奠壏	zhu'dian'lan	0
朱端	zhu'duan	0
朱法	zhu'fa	0
祝福新	zhu'fu'xin	0
朱肝	zhu'gan	0
朱古愚	zhu'gu'yu	0
朱广宇	zhu'guang'yu	0
朱海琦	zhu'hai'qi	0
朱亨嘉	zhu'heng'jia	0
朱红	zhu'hong	0
朱红玉	zhu'hong'yu	0
朱华君	zhu'hua'jun	0
朱怀瑾	zhu'huai'jin	0
朱季海	zhu'ji'hai	0
朱金楼	zhu'jin'lou	0
朱景春	zhu'jing'chun	0
朱景仁	zhu'jing'ren	0
朱景玄	zhu'jing'xuan	0
祝昆	zhu'kun	0
诸乐三	zhu'le'san	0
朱立波	zhu'li'bo	0
朱良川	zhu'liang'chuan	0
朱良志	zhu'liang'zhi	0
朱罗胜	zhu'luo'sheng	0
竹绿	zhu'lv	0
朱梅邨	zhu'mei'cun	0
朱淼	zhu'miao	0
朱明建	zhu'ming'jian	0
朱明弢	zhu'ming'tao	0
煮漂	zhu'piao	0
朱屺瞻	zhu'qi'zhan	0
朱仁新	zhu'ren'xin	0
朱锐	zhu'rui	0
朱沙	zhu'sha	0
朱砂	zhu'sha	0
朱神光	zhu'shen'guang	0
诸昇	zhu'sheng	0
朱生	zhu'sheng	0
朱士杰	zhu'shi'jie	0
竹石梅兰图	zhu'shi'mei'lan'tu	0
朱世伟	zhu'shi'wei	0
朱守谦	zhu'shou'qian	0
朱双大	zhu'shuang'da	0
朱松青	zhu'song'qing	0
祝天祺	zhu'tian'qi	0
朱维民	zhu'wei'min	0
竹屋松岩图	zhu'wu'song'yan'tu	0
朱欣一	zhu'xin'yi	0
朱秀东	zhu'xiu'dong	0
朱旭红	zhu'xu'hong	0
朱雁光	zhu'yan'guang	0
朱晔	zhu'ye	0
竹叶描	zhu'ye'miao	0
竹叶亭主	zhu'ye'ting'zhu	0
朱毅勇	zhu'yi'yong	0
朱勇毅	zhu'yong'yi	0
诸有韬	zhu'you'tao	0
朱冤	zhu'yuan	0
朱沅芷	zhu'yuan'zhi	0
朱赞仪	zhu'zan'yi	0
朱者赤	zhu'zhe'chi	0
朱振庚	zhu'zhen'geng	0
朱志奋	zhu'zhi'fen	0
朱植人	zhu'zhi'ren	0
朱忠卿	zhu'zhong'qing	0
砖橙	zhuan'cheng	0
砖红	zhuan'hong	0
庄保林	zhuang'bao'lin	0
装背	zhuang'bei	0
装背匠	zhuang'bei'jiang	0
撞边	zhuang'bian	0
装裱	zhuang'biao	0
装褾	zhuang'biao	0
庄长达	zhuang'chang'da	0
装褫	zhuang'chi	0
装池	zhuang'chi	0
庄洪生	zhuang'hong'sheng	0
装磺	zhuang'huang	0
装潢手	zhuang'huang'shou	0
庄吉吉	zhuang'ji'ji	0
庄佳村	zhuang'jia'cun	0
庄明中	zhuang'ming'zhong	0
庄天明	zhuang'tian'ming	0
庄威	zhuang'wei	0
庄午	zhuang'wu	0
庄心贤	zhuang'xin'xian	0
装治	zhuang'zhi	0
装置艺术	zhuang'zhi'yi'shu	0
装轴	zhuang'zhou	0
卓儿	zhuo'er	0
卓然庐图	zhuo'ran'lu'tu	0
卓然木	zhuo'ran'mu	0
卓歇图	zhuo'xie'tu	0
卓有瑞	zhuo'you'rui	0
紫宝兰	zi'bao'lan	0
紫啡	zi'fei	0
自缚也	zi'fu'ye	0
秭归屈原祠壁画	zi'gui'qu'yuan'ci'bi'hua	0
字画者	zi'hua'zhe	0
紫灰	zi'hui	0
紫罗蓝	zi'luo'lan	0
紫玫红	zi'mei'hong	0
子琪	zi'qi	0
自然绿	zi'ran'lv	0
自然主义	zi'ran'zhu'yi	0
紫水晶色	zi'shui'jing'se	0
紫玟红	zi'wen'hong	0
字与画者	zi'yu'hua'zhe	0
紫丈青	zi'zhang'qing	0
棕啡	zong'fei	0
棕绿	zong'lv	0
宗其香	zong'qi'xiang	0
棕桐绿	zong'tong'lv	0
宗奕	zong'yi	0
宗子发	zong'zi'fa	0
邹操	zou'cao	0
邹传安	zou'chuan'an	0
邹复雷	zou'fu'lei	0
邹光辉	zou'guang'hui	0
邹鸿	zou'hong	0
邹晖	zou'hui	0
邹立文	zou'li'wen	0
邹士敏	zou'shi'min	0
邹卫	zou'wei	0
邹亚杰	zou'ya'jie	0
邹一桂	zou'yi'gui	0
邹永才	zou'yong'cai	0
邹永东	zou'yong'dong	0
邹永治	zou'yong'zhi	0
邹瑜	zou'yu	0
邹育龙	zou'yu'long	0
邹喆	zou'zhe	0
祖琳	zu'lin	0
钻石蓝	zuan'shi'lan	0
嘴锋	zui'feng	0
嘴中线	zui'zhong'xian	0
尊受章	zun'shou'zhang	0
做旧	zuo'jiu	0
左俊阳	zuo'jun'yang	0
左图右文	zuo'tu'you'wen	0
左右均衡	zuo'you'jun'heng	0
左右均齐	zuo'you'jun'qi	0
