半月裂	ban'yue'lie	0
鼻出血	bi'chu'xue	0
鼻骨嵴	bi'gu'ji	0
鼻内镜	bi'nei'jing	0
鼻粘膜	bi'nian'mo	0
鼻腔	bi'qiang	0
鼻腔底	bi'qiang'di	0
鼻腔顶后段	bi'qiang'ding'hou'duan	0
鼻腔外侧壁	bi'qiang'wai'ce'bi	0
鼻息肉	bi'xi'rou	0
鼻息肉样变	bi'xi'rou'yang'bian	0
鼻囟门	bi'xin'men	0
鼻咽	bi'yan	0
鼻咽顶	bi'yan'ding	0
鼻中隔	bi'zhong'ge	0
鼻中隔穿孔	bi'zhong'ge'chuan'kong	0
鼻中隔偏曲	bi'zhong'ge'pian'qu	0
鼻中隔软骨	bi'zhong'ge'ruan'gu	0
扁桃体肥大	bian'tao'ti'fei'da	0
促红细胞生成素	cu'hong'xi'bao'sheng'cheng'su	0
打鼾	da'han	0
大翼软骨内侧脚	da'yi'ruan'gu'nei'ce'jiao	0
单纯型慢性鼻炎	dan'chun'xing'man'xing'bi'yan	0
单发鼻窦炎	dan'fa'bi'dou'yan	0
单发鼻窦炎伴单发性鼻息肉	dan'fa'bi'dou'yan'ban'dan'fa'xing'bi'xi'rou	0
蝶鞍	die'an	0
蝶窦	die'dou	0
蝶窦自然口	die'dou'zi'ran'kou	0
蝶骨翼突结构	die'gu'yi'tu'jie'gou	0
蝶筛板	die'shai'ban	0
蝶嘴和蝶嵴	die'zui'he'die'ji	0
窦内积脓	dou'nei'ji'nong	0
多发鼻窦炎	duo'fa'bi'dou'yan	0
多发鼻窦炎伴多发性鼻息肉	duo'fa'bi'dou'yan'ban'duo'fa'xing'bi'xi'rou	0
多发性鼻窦炎或全组鼻窦炎伴多发性鼻息肉和或筛窦骨质增生	duo'fa'xing'bi'dou'yan'huo'quan'zu'bi'dou'yan'ban'duo'fa'xing'bi'xi'rou'he'huo'shai'dou'gu'zhi'zeng'sheng	0
额窦	e'dou	0
腭骨鼻嵴	e'gu'bi'ji	0
额骨鼻棘	e'gu'bi'ji	0
颚骨垂直板	e'gu'chui'zhi'ban	0
额骨内骨板	e'gu'nei'gu'ban	0
额骨外骨板	e'gu'wai'gu'ban	0
额隐窝	e'yin'wo	0
儿茶酚胺	er'cha'fen'an	0
儿童腺样体增生	er'tong'xian'yang'ti'zeng'sheng	0
反流性食管炎	fan'liu'xing'shi'guan'yan	0
钩突	gou'tu	0
冠心病	guan'xin'bing	0
海绵窦	hai'mian'dou	0
喉腔	hou'qiang	0
喉咽	hou'yan	0
后组筛窦	hou'zu'shai'dou	0
即利特尔动脉	ji'li'te'er'dong'mai	0
极期	ji'qi	0
急性鼻窦炎	ji'xing'bi'dou'yan	0
急性鼻炎	ji'xing'bi'yan	0
尖牙窝	jian'ya'wo	0
颈内动脉	jing'nei'dong'mai	0
颈围	jing'wei	0
卡他	ka'ta	0
克氏静脉丛	ke'shi'jing'mai'cong	0
眶顶顶壁	kuang'ding'ding'bi	0
眶顶延	kuang'ding'yan	0
眶下孔	kuang'xia'kong	0
眶下血管神经	kuang'xia'xue'guan'shen'jing	0
泪骨	lei'gu	0
犁骨	li'gu	0
颅前窝	lu'qian'wo	0
颅中窝	lu'zhong'wo	0
慢性鼻窦炎	man'xing'bi'dou'yan	0
慢性鼻窦炎伴鼻息肉	man'xing'bi'dou'yan'ban'bi'xi'rou	0
脑血栓	nao'xue'shuan	0
粘膜水肿	nian'mo'shui'zhong	0
颞下窝	nie'xia'wo	0
排尿反射弧	pai'niao'fan'she'hu	0
气流强度	qi'liu'qiang'du	0
前组筛窦	qian'zu'shai'dou	0
全组鼻窦炎	quan'zu'bi'dou'yan	0
全组鼻窦炎伴多发性鼻息肉	quan'zu'bi'dou'yan'ban'duo'fa'xing'bi'xi'rou	0
容垂体	rong'chui'ti	0
软腭组织	ruan'e'zu'zhi	0
筛窦后壁	shai'dou'hou'bi	0
筛骨迷路	shai'gu'mi'lu	0
筛骨筛切迹	shai'gu'shai'qie'ji	0
筛骨水平板	shai'gu'shui'ping'ban	0
筛骨正中板	shai'gu'zheng'zhong'ban	0
筛漏斗	shai'lou'dou	0
筛泡	shai'pao	0
上鼻道	shang'bi'dao	0
上鼻甲	shang'bi'jia	0
上颌窦	shang'he'dou	0
上颌窦口	shang'he'dou'kou	0
上颌窦自然孔	shang'he'dou'zi'ran'kong	0
上颌骨	shang'he'gu	0
上颌骨鼻嵴	shang'he'gu'bi'ji	0
上颌骨额突	shang'he'gu'e'tu	0
上气道	shang'qi'dao	0
上下颌骨发育障碍	shang'xia'he'gu'fa'yu'zhang'ai	0
舌扁桃体肥大	she'bian'tao'ti'fei'da	0
舌根肥厚	she'gen'fei'hou	0
肾小球率过量	shen'xiao'qiu'lv'guo'liang	0
生长激素	sheng'zhang'ji'su	0
视神经	shi'shen'jing	0
下鼻道	xia'bi'dao	0
下鼻甲	xia'bi'jia	0
下鼻甲骨	xia'bi'jia'gu	0
腺样体肥大	xian'yang'ti'fei'da	0
小下颏畸形	xiao'xia'ke'ji'xing	0
心脏功能	xin'zang'gong'neng	0
胸廓畸形	xiong'kuo'ji'xing	0
胸腔负压值	xiong'qiang'fu'ya'zhi	0
悬雍垂	xuan'yong'chui	0
血氧饱和度	xue'yang'bao'he'du	0
牙槽突	ya'cao'tu	0
眼眶底壁	yan'kuang'di'bi	0
眼眶内侧壁	yan'kuang'nei'ce'bi	0
咽腔负压值	yan'qiang'fu'ya'zhi	0
夜间心绞疼	ye'jian'xin'jiao'teng	0
夜尿	ye'niao	0
翼腭窝	yi'e'wo	0
遗尿	yi'niao	0
枕骨斜坡	zhen'gu'xie'po	0
中鼻道	zhong'bi'dao	0
中鼻道变窄	zhong'bi'dao'bian'zhai	0
中鼻甲	zhong'bi'jia	0
