草本植物	cao'ben'zhi'wu	0
环保	huan'bao	0
简单却不简约	jian'dan'que'bu'jian'yue	0
健康	jian'kang	0
简约健康	jian'yue'jian'kang	0
精油	jing'you	0
玫瑰精油	mei'gui'jing'you	0
女性私处	nv'xing'si'chu	0
品牌形象	pin'pai'xing'xiang	0
清新淡雅	qing'xin'dan'ya	0
私处护理	si'chu'hu'li	0
温和	wen'he	0
消炎	xiao'yan	0
消肿止痒	xiao'zhong'zhi'yang	0
抑菌	yi'jun	0
源自天成	yuan'zi'tian'cheng	0
蕴妍坊	yun'yan'fang	0
蕴妍坊产品	yun'yan'fang'chan'pin	0
蕴妍坊护理	yun'yan'fang'hu'li	0
蕴妍坊加盟	yun'yan'fang'jia'meng	0
蕴妍坊简约贴心精油	yun'yan'fang'jian'yue'tie'xin'jing'you	0
蕴妍坊精油	yun'yan'fang'jing'you	0
蕴妍坊理念	yun'yan'fang'li'nian	0
蕴妍坊玫瑰花露水	yun'yan'fang'mei'gui'hua'lu'shui	0
蕴妍坊慕斯抑菌液	yun'yan'fang'mu'si'yi'jun'ye	0
蕴妍坊怎么样	yun'yan'fang'zen'me'yang	0
蕴妍坊质量	yun'yan'fang'zhi'liang	0
蒸汽蒸馏	zheng'qi'zheng'liu	0
植物精华	zhi'wu'jing'hua	0
植物精油	zhi'wu'jing'you	0
