阿特拉斯肩甲	a'te'la'si'jian'jia	0
哀伤之剑	ai'shang'zhi'jian	0
哀伤之剑格雷	ai'shang'zhi'jian'ge'lei	0
暗黑漂流	an'hei'piao'liu	0
暗夜鬼影塔卡	an'ye'gui'ying'ta'ka	0
暗夜迷行奥达基	an'ye'mi'xing'ao'da'ji	0
奥术烈焰	ao'shu'lie'yan	0
奥术通道	ao'shu'tong'dao	0
奥术再生	ao'shu'zai'sheng	0
八段神乎其技	ba'duan'shen'hu'qi'ji	0
百变火龙史卡夫	bai'bian'huo'long'shi'ka'fu	0
百步穿杨	bai'bu'chuan'yang	0
白卡	bai'ka	0
白色秘影塔卡	bai'se'mi'ying'ta'ka	0
白雪迷踪朱尔	bai'xue'mi'zong'zhu'er	0
爆弹火枪	bao'dan'huo'qiang	0
爆发爆炸	bao'fa'bao'zha	0
暴君的单片眼睛	bao'jun'de'dan'pian'yan'jing	0
爆炸轰杀	bao'zha'hong'sha	0
爆震光波	bao'zhen'guang'bo	0
暴走兔罗娜	bao'zou'tu'luo'na	0
被动技能	bei'dong'ji'neng	0
北方莱姆	bei'fang'lai'mu	0
备用按钮	bei'yong'an'niu	0
本源奥秘	ben'yuan'ao'mi	0
蹦蹦床	beng'beng'chuang	0
庇护	bi'hu	0
必杀利箭	bi'sha'li'jian	0
碧焰史卡夫	bi'yan'shi'ka'fu	0
冰法莱姆	bing'fa'lai'mu	0
兵矿	bing'kuang	0
冰霜护铠	bing'shuang'hu'kai	0
兵线	bing'xian	0
不死法师莱姆	bu'si'fa'shi'lai'mu	0
草丛	cao'cong	0
侧翼突击	ce'yi'tu'ji	0
拆水晶	chai'shui'jing	0
拆塔	chai'ta	0
颤栗爆裂	chan'li'bao'lie	0
常胜剑客黑羽	chang'sheng'jian'ke'hei'yu	0
超级士兵朱尔	chao'ji'shi'bing'zhu'er	0
超音速丝凯伊	chao'yin'su'si'kai'yi	0
沉默	chen'mo	0
沉默神铠	chen'mo'shen'kai	0
城邦守护	cheng'bang'shou'hu	0
吃兵	chi'bing	0
赤怒旋风	chi'nu'xuan'feng	0
炽焰齐射	chi'yan'qi'she	0
赤焰史卡夫	chi'yan'shi'ka'fu	0
冲刺切割	chong'ci'qie'ge	0
冲刺之靴	chong'ci'zhi'xue	0
冲锋陷阵	chong'feng'xian'zhen	0
重构复原	chong'gou'fu'yuan	0
虫后花妖佩兔	chong'hou'hua'yao'pei'tu	0
冲击波	chong'ji'bo	0
冲杀裂地	chong'sha'lie'di	0
仇恨之力	chou'hen'zhi'li	0
初出茅庐	chu'chu'mao'lu	0
穿刺之矛	chuan'ci'zhi'mao	0
传说宝箱	chuan'shuo'bao'xiang	0
传说皮肤	chuan'shuo'pi'fu	0
穿云裂石	chuan'yun'lie'shi	0
刺客	ci'ke	0
刺客秘诀	ci'ke'mi'jue	0
刺裂寒风	ci'lie'han'feng	0
大暴走	da'bao'zou	0
大甲	da'jia	0
大乱斗	da'luan'dou	0
大水晶	da'shui'jing	0
打野	da'ye	0
大嘴格兰卓	da'zui'ge'lan'zhuo	0
呆萌南瓜佩兔	dai'meng'nan'gua'pei'tu	0
带线	dai'xian	0
弹幕穿透	dan'mu'chuan'tou	0
单挑	dan'tiao	0
悼词之书	dao'ci'zhi'shu	0
导弹阵雨	dao'dan'zhen'yu	0
刀锋突袭	dao'feng'tu'xi	0
登峰造极	deng'feng'zao'ji	0
地雷	di'lei	0
帝王符文	di'wang'fu'wen	0
地狱火焰	di'yu'huo'yan	0
地狱引爆	di'yu'yin'bao	0
低语者	di'yu'zhe	0
地狱之狼福彻斯	di'yu'zhi'lang'fu'che'si	0
地狱之怒	di'yu'zhi'nu	0
地狱之刃	di'yu'zhi'ren	0
地狱之心	di'yu'zhi'xin	0
地狱咒术	di'yu'zhou'shu	0
电音猫女柯思卡	dian'yin'mao'nv'ke'si'ka	0
动能之盾	dong'neng'zhi'dun	0
毒蛇守卫面具	du'she'shou'wei'mian'ju	0
赌徒林戈	du'tu'lin'ge	0
毒液刀	du'ye'dao	0
段位	duan'wei	0
对线	dui'xian	0
遁形	dun'xing	0
夺命三刺	duo'ming'san'ci	0
夺命十字杀	duo'ming'shi'zi'sha	0
恶棍天使格温	e'gun'tian'shi'ge'wen	0
饿极成怒	e'ji'cheng'nu	0
恶意裁决	e'yi'cai'jue	0
恩赐祝福	en'ci'zhu'fu	0
二段逐步成长	er'duan'zhu'bu'cheng'zhang	0
二号野	er'hao'ye	0
二技能	er'ji'neng	0
二皮	er'pi	0
发号施令	fa'hao'shi'ling	0
法力值	fa'li'zhi	0
法师	fa'shi	0
法术强度	fa'shu'qiang'du	0
法术装备	fa'shu'zhuang'bei	0
发条装置	fa'tiao'zhuang'zhi	0
发育	fa'yu	0
反野	fan'ye	0
防御装备	fang'yu'zhuang'bei	0
飞驰跳跃	fei'chi'tiao'yue	0
飞轮连击	fei'lun'lian'ji	0
飞轮刃	fei'lun'ren	0
飞云奇袭者舞司	fei'yun'qi'xi'zhe'wu'si	0
粉叉	fen'cha	0
分解	fen'jie	0
风暴护盾	feng'bao'hu'dun	0
风暴魔王亚丹	feng'bao'mo'wang'ya'dan	0
风暴守卫长	feng'bao'shou'wei'chang	0
风暴守卫战旗	feng'bao'shou'wei'zhan'qi	0
风暴王冠	feng'bao'wang'guan	0
疯狂炮轰	feng'kuang'pao'hong	0
疯狂重击	feng'kuang'zhong'ji	0
锋利爪钩	feng'li'zhao'gou	0
蜂鸟之心	feng'niao'zhi'xin	0
复仇怒焰	fu'chou'nu'yan	0
复刻版	fu'ke'ban	0
斧头	fu'tou	0
辅助	fu'zhu	0
高跟鞋	gao'gen'xie	0
高空死亡	gao'kong'si'wang	0
高能炮击	gao'neng'pao'ji	0
格挡护腕	ge'dang'hu'wan	0
格斗犬格兰卓	ge'dou'quan'ge'lan'zhuo	0
共振音波	gong'zhen'yin'bo	0
骨锯	gu'ju	0
古骑士兰斯	gu'qi'shi'lan'si	0
光盾	guang'dun	0
光之壁垒	guang'zhi'bi'lei	0
鬼剑单挑王	gui'jian'dan'tiao'wang	0
鬼剑骷髅	gui'jian'ku'lou	0
鬼影大军	gui'ying'da'jun	0
贵族黑羽	gui'zu'hei'yu	0
海盗鬼剑骷髅	hai'dao'gui'jian'ku'lou	0
海希安	hai'xi'an	0
海希安充能靴	hai'xi'an'chong'neng'xue	0
海希安峡谷	hai'xi'an'xia'gu	0
海希安药水	hai'xi'an'yao'shui	0
海妖克拉肯	hai'yao'ke'la'ken	0
撼地神铠	han'di'shen'kai	0
寒冬烈战凯瑟琳	han'dong'lie'zhan'kai'se'lin	0
寒冬烈战凯思卓	han'dong'lie'zhan'kai'si'zhuo	0
悍然一击	han'ran'yi'ji	0
核心超频	he'xin'chao'pin	0
核心充能	he'xin'chong'neng	0
核心过载	he'xin'guo'zai	0
核心坍塌	he'xin'tan'ta	0
黑暗法师萨缪尔	hei'an'fa'shi'sa'miu'er	0
黑暗附身	hei'an'fu'shen	0
横冲暴走	heng'chong'bao'zou	0
恒星风暴	heng'xing'feng'bao	0
红灯笼弗利克	hong'deng'long'fu'li'ke	0
红龙箱	hong'long'xiang	0
红色迷雾	hong'se'mi'wu	0
红水晶箱	hong'shui'jing'xiang	0
红心诡计	hong'xin'gui'ji	0
猴年大吉	hou'nian'da'ji	0
猴王驾到	hou'wang'jia'dao	0
护甲	hu'jia	0
呼龙唤火	hu'long'huan'huo	0
护卫亚丹	hu'wei'ya'dan	0
护卫者契约	hu'wei'zhe'qi'yue	0
华舞追击	hua'wu'zhui'ji	0
花妖佩兔	hua'yao'pei'tu	0
黄金时间	huang'jin'shi'jian	0
荒野牛仔格温	huang'ye'niu'zai'ge'wen	0
恢复喷泉	hui'fu'pen'quan	0
回蓝刀	hui'lan'dao	0
回声	hui'sheng	0
回旋续命	hui'xuan'xu'ming	0
回血	hui'xue	0
回转刺杀	hui'zhuan'ci'sha	0
混沌穿梭	hun'dun'chuan'suo	0
混沌坦克	hun'dun'tan'ke	0
混沌乌云	hun'dun'wu'yun	0
混沌行者沃克尔	hun'dun'xing'zhe'wo'ke'er	0
火海天降	huo'hai'tian'jiang	0
火箭飞跃	huo'jian'fei'yue	0
火箭筒	huo'jian'tong	0
火力压制	huo'li'ya'zhi	0
火龙史卡夫	huo'long'shi'ka'fu	0
火球攻势	huo'qiu'gong'shi	0
活体护甲	huo'ti'hu'jia	0
火焰法师雷萨	huo'yan'fa'shi'lei'sa	0
积极伪装	ji'ji'wei'zhuang	0
机甲朱尔	ji'jia'zhu'er	0
机枪	ji'qiang	0
机枪索尔	ji'qiang'suo'er	0
汲取原力	ji'qu'yuan'li	0
计时器	ji'shi'qi	0
急速攻击	ji'su'gong'ji	0
急速射击	ji'su'she'ji	0
吉提亚之墙	ji'ti'ya'zhi'qiang	0
机械人索尔	ji'xie'ren'suo'er	0
机械战姬阿尔法	ji'xie'zhan'ji'a'er'fa	0
加倍下注	jia'bei'xia'zhu	0
加速	jia'su	0
尖长獠牙	jian'chang'liao'ya	0
箭齿迫击炮	jian'chi'pai'ji'pao	0
尖刺	jian'ci	0
尖刀	jian'dao	0
减攻速	jian'gong'su	0
剑客黑羽	jian'ke'hei'yu	0
尖利碎片	jian'li'sui'pian	0
箭矢穿透	jian'shi'chuan'tou	0
剑术格挡	jian'shu'ge'dang	0
减速	jian'su	0
剑无虚发	jian'wu'xu'fa	0
角斗士凯瑟琳	jiao'dou'shi'kai'se'lin	0
角斗士兰斯	jiao'dou'shi'lan'si	0
角斗士亚丹	jiao'dou'shi'ya'dan	0
交流电	jiao'liu'dian	0
紧绷之弩	jin'beng'zhi'nu	0
金币	jin'bi	0
金灯莱拉	jin'deng'lai'la	0
禁锢	jin'gu	0
禁锢之光	jin'gu'zhi'guang	0
进化者塞缪尔	jin'hua'zhe'sai'miu'er	0
紧急按钮	jin'ji'an'niu	0
进击守卫	jin'ji'shou'wei	0
金卡	jin'ka	0
金矿	jin'kuang	0
金牌模范战警凯瑟琳	jin'pai'mo'fan'zhan'jing'kai'se'lin	0
金属护甲	jin'shu'hu'jia	0
金属装甲	jin'shu'zhuang'jia	0
金焰史卡夫	jin'yan'shi'ka'fu	0
近战兵	jin'zhan'bing	0
精华	jing'hua	0
惊魂突击	jing'hun'tu'ji	0
荆棘小鬼	jing'ji'xiao'gui	0
荆棘种子	jing'ji'zhong'zi	0
精力值	jing'li'zhi	0
精灵光尘	jing'ling'guang'chen	0
精灵闪光弗利克	jing'ling'shan'guang'fu'li'ke	0
九段登峰造极	jiu'duan'deng'feng'zao'ji	0
飓风触发器	ju'feng'chu'fa'qi	0
巨龙之心	ju'long'zhi'xin	0
卷土重来	juan'tu'chong'lai	0
氪金	ke'jin	0
恐怖阴影	kong'bu'yin'ying	0
恐惧	kong'ju	0
控制	kong'zhi	0
骷髅头	ku'lou'tou	0
苦痛阴霾	ku'tong'yin'mai	0
酷刑折磨	ku'xing'zhe'mo	0
狂化追击	kuang'hua'zhui'ji	0
狂挥乱舞	kuang'hui'luan'wu	0
狂怒爆发	kuang'nu'bao'fa	0
狂怒使者	kuang'nu'shi'zhe	0
狂怒之刃罗娜	kuang'nu'zhi'ren'luo'na	0
狂士血怒	kuang'shi'xue'nu	0
狂战士罗娜	kuang'zhan'shi'luo'na	0
蓝卡	lan'ka	0
狼吞虎咽	lang'tun'hu'yan	0
狼王暴击	lang'wang'bao'ji	0
狼牙真相	lang'ya'zhen'xiang	0
累积攻击	lei'ji'gong'ji	0
雷霆之击	lei'ting'zhi'ji	0
雷霆追击	lei'ting'zhui'ji	0
利爪大法	li'zhua'da'fa	0
离子炮	li'zi'pao	0
连环攻势	lian'huan'gong'shi	0
裂敌者	lie'di'zhe	0
猎杀盛宴	lie'sha'sheng'yan	0
烈焰护盾	lie'yan'hu'dun	0
烈焰之怒	lie'yan'zhi'nu	0
凛冬尖塔	lin'dong'jian'ta	0
凛冬潜行	lin'dong'qian'xing	0
灵猴奥佐	ling'hou'ao'zuo	0
灵魂收割者	ling'hun'shou'ge'zhe	0
灵魂碎片	ling'hun'sui'pian	0
六段名不虚传	liu'duan'ming'bu'xu'chuan	0
六角罪镖	liu'jiao'zui'biao	0
流血	liu'xue	0
龙血契约	long'xue'qi'yue	0
炉火纯青	lu'huo'chun'qing	0
绿林凯思卓	lu'lin'kai'si'zhuo	0
旅行靴	lv'xing'xue	0
脉冲声波	mai'chong'sheng'bo	0
满腹牢骚	man'fu'lao'sao	0
盲豹格雷	mang'bao'ge'lei	0
猫女柯思卡	mao'nv'ke'si'ka	0
玫瑰追击	mei'gui'zhui'ji	0
密音回响	mi'yin'hui'xiang	0
迷踪步	mi'zong'bu	0
迷醉追击	mi'zui'zhui'ji	0
名不虚传	ming'bu'xu'chuan	0
命运桎梏	ming'yun'zhi'gu	0
魔法伤害	mo'fa'shang'hai	0
魔法学徒口口尔	mo'fa'xue'tu'kou'kou'er	0
魔法学徒塞缪尔	mo'fa'xue'tu'sai'miu'er	0
魔法装备	mo'fa'zhuang'bei	0
魔抗	mo'kang	0
魔狼福彻斯	mo'lang'fu'che'si	0
魔龙之心	mo'long'zhi'xin	0
魔龙之眼	mo'long'zhi'yan	0
魔女星乐斯	mo'nv'xing'le'si	0
木宝箱	mu'bao'xiang	0
目标锁定	mu'biao'suo'ding	0
耐力值	nai'li'zhi	0
能力值	neng'li'zhi	0
能量电池	neng'liang'dian'chi	0
黏浆	nian'jiang	0
怒火叠加	nu'huo'die'jia	0
欧泊石	ou'bo'shi	0
排位	pai'wei	0
炮兵	pao'bing	0
炮塔	pao'ta	0
喷气弹跳	pen'qi'tan'tiao	0
喷射火球	pen'she'huo'qiu	0
皮肤合成	pi'fu'he'cheng	0
皮肤盒子	pi'fu'he'zi	0
匹配	pi'pei	0
破胆突击	po'dan'tu'ji	0
破刀	po'dao	0
破防机枪	po'fang'ji'qiang	0
破碎神话	po'sui'shen'hua	0
破碎玩偶阿尔法	po'sui'wan'ou'a'er'fa	0
扑杀玩乐	pu'sha'wan'le	0
七段炉火纯青	qi'duan'lu'huo'chun'qing	0
骑士冲锋	qi'shi'chong'feng	0
奇异装置	qi'yi'zhuang'zhi	0
旗子	qi'zi	0
前蹦后跳	qian'beng'hou'tiao	0
钱怪	qian'guai	0
前射弹幕	qian'she'dan'mu	0
强力推进	qiang'li'tui'jin	0
强杀	qiang'sha	0
清兵	qing'bing	0
轻甲	qing'jia	0
青焰史卡夫	qing'yan'shi'ka'fu	0
清野	qing'ye	0
泉水	quan'shui	0
群狼出击	qun'lang'chu'ji	0
日蚀棱镜	ri'shi'leng'jing	0
熔炉	rong'lu	0
荣耀	rong'yao	0
如有神助	ru'you'shen'zhu	0
弱肉强食	ruo'rou'qiang'shi	0
三段铜头铁臂	san'duan'tong'tou'tie'bi	0
三号野	san'hao'ye	0
三技能	san'ji'neng	0
三皮	san'pi	0
三杀	san'sha	0
骚扰	sao'rao	0
沙漏	sha'lou	0
杀戮狂欢	sha'lu'kuang'huan	0
沙漠之鹰伊德瑞	sha'mo'zhi'ying'yi'de'rui	0
闪电战	shan'dian'zhan	0
闪电追击	shan'dian'zhui'ji	0
煽风点火	shan'feng'dian'huo	0
商城	shang'cheng	0
射手	she'shou	0
深藏不露	shen'cang'bu'lu	0
神弓盖世	shen'gong'gai'shi	0
神乎其技	shen'hu'qi'ji	0
神迹相随	shen'ji'xiang'sui	0
审判之诗	shen'pan'zhi'shi	0
肾上腺素	shen'shang'xian'su	0
神圣恩赐	shen'sheng'en'ci	0
声波共鸣	sheng'bo'gong'ming	0
声波屏障	sheng'bo'ping'zhang	0
圣诞礼物福彻斯	sheng'dan'li'wu'fu'che'si	0
圣光新星	sheng'guang'xin'xing	0
圣火洗礼	sheng'huo'xi'li	0
生命恩赐	sheng'ming'en'ci	0
生命值	sheng'ming'zhi	0
生命之心	sheng'ming'zhi'xin	0
圣骑士格瑞斯	sheng'qi'shi'ge'rui'si	0
生死极速丝凯伊	sheng'si'ji'su'si'kai'yi	0
圣星降世	sheng'xing'jiang'shi	0
势不可挡	shi'bu'ke'dang	0
十段王者荣耀	shi'duan'wang'zhe'rong'yao	0
十段至尊荣耀	shi'duan'zhi'zun'rong'yao	0
噬骨者鱼人费恩	shi'gu'zhe'yu'ren'fei'en	0
时光追忆莱拉	shi'guang'zhui'yi'lai'la	0
噬魂之剑	shi'hun'zhi'jian	0
史前格雷	shi'qian'ge'lei	0
史诗宝箱	shi'shi'bao'xiang	0
史诗皮肤	shi'shi'pi'fu	0
嗜血冲刺	shi'xue'chong'ci	0
视野	shi'ye	0
收获前夕	shou'huo'qian'xi	0
首要指令	shou'yao'zhi'ling	0
输出	shu'chu	0
树精	shu'jing	0
殊途同归	shu'tu'tong'gui	0
数罪并罚	shu'zui'bing'fa	0
双胞胎怪	shuang'bao'tai'guai	0
双重飞弹	shuang'chong'fei'dan	0
霜燃	shuang'ran	0
双杀	shuang'sha	0
睡甲	shui'jia	0
水晶溶剂	shui'jing'rong'ji	0
水晶哨兵	shui'jing'shao'bing	0
水晶石	shui'jing'shi	0
水晶碎片	shui'jing'sui'pian	0
四段值得一战	si'duan'zhi'de'yi'zhan	0
四方塌陷	si'fang'ta'xian	0
四号野	si'hao'ye	0
死灵大师	si'ling'da'shi	0
四杀	si'sha	0
死亡金属乐骷髅	si'wang'jin'shu'yue'ku'lou	0
速力重击	su'li'zhong'ji	0
逃出生天	tao'chu'sheng'tian	0
逃之夭夭	tao'zhi'yao'yao	0
特殊皮肤	te'shu'pi'fu	0
特种部队巴隆	te'zhong'bu'dui'ba'long	0
特种部队索尔	te'zhong'bu'dui'suo'er	0
特种部队伊德瑞	te'zhong'bu'dui'yi'de'rui	0
天使奥达基	tian'shi'ao'da'ji	0
铁卫契约	tie'wei'qi'yue	0
铜墙铁壁	tong'qiang'tie'bi	0
铜头铁臂	tong'tou'tie'bi	0
通用类	tong'yong'lei	0
屠龙天使奥达基	tu'long'tian'shi'ao'da'ji	0
突破点	tu'po'dian	0
兔兔蹦床	tu'tu'beng'chuang	0
突袭之王	tu'xi'zhi'wang	0
弯钩锁链	wan'gou'suo'lian	0
亡灵冲击	wang'ling'chong'ji	0
亡灵护盾	wang'ling'hu'dun	0
亡命回旋	wang'ming'hui'xuan	0
王牌攻势	wang'pai'gong'shi	0
微光浮尘	wei'guang'fu'chen	0
微光流矢	wei'guang'liu'shi	0
微光齐射	wei'guang'qi'she	0
微光治愈	wei'guang'zhi'yu	0
胃口大开	wei'kou'da'kai	0
涡轮喷气	wo'lun'pen'qi	0
巫毒师巴蒂斯特	wu'du'shi'ba'di'si'te	0
五段深藏不露	wu'duan'shen'cang'bu'lu	0
无尽长梦	wu'jin'chang'meng	0
无尽寒冬	wu'jin'han'dong	0
无尽炮击	wu'jin'pao'ji	0
无尽之箭	wu'jin'zhi'jian	0
物理强度	wu'li'qiang'du	0
物理伤害	wu'li'shang'hai	0
物理装备	wu'li'zhuang'bei	0
巫女星乐斯	wu'nv'xing'le'si	0
武器增强溶剂	wu'qi'zeng'qiang'rong'ji	0
无情追击	wu'qing'zhui'ji	0
五杀	wu'sha	0
武士醉枪手林戈	wu'shi'zui'qiang'shou'lin'ge	0
巫术诅咒	wu'shu'zu'zhou	0
武侠奥佐	wu'xia'ao'zuo	0
无限重启	wu'xian'chong'qi	0
无意冒犯	wu'yi'mao'fan	0
稀有宝箱	xi'you'bao'xiang	0
稀有皮肤	xi'you'pi'fu	0
夏日派对费恩	xia'ri'pai'dui'fei'en	0
夏日派对凯思卓	xia'ri'pai'dui'kai'si'zhuo	0
夏日派对骷髅	xia'ri'pai'dui'ku'lou	0
夏日派对索尔	xia'ri'pai'dui'suo'er	0
限定皮肤	xian'ding'pi'fu	0
先锋守护	xian'feng'shou'hu	0
橡树之心	xiang'shu'zhi'xin	0
小兵	xiao'bing	0
小兵之足	xiao'bing'zhi'zu	0
消耗	xiao'hao	0
消耗品	xiao'hao'pin	0
邪恶天才	xie'e'tian'cai	0
胁迫一击	xie'po'yi'ji	0
新春红妆柯思卡	xin'chun'hong'zhuang'ke'si'ka	0
信号枪	xin'hao'qiang	0
心礼相伴	xin'li'xiang'ban	0
新星之力	xin'xing'zhi'li	0
猩红之刃黑羽	xing'hong'zhi'ren'hei'yu	0
星际女王星乐斯	xing'ji'nv'wang'xing'le'si	0
星际战士巴隆	xing'ji'zhan'shi'ba'long	0
幸运散弹	xing'yun'san'dan	0
幸运之击	xing'yun'zhi'ji	0
休憩盔甲	xiu'qi'kui'jia	0
虚空电池	xu'kong'dian'chi	0
虚荣水晶	xu'rong'shui'jing	0
眩晕	xuan'yun	0
眩晕猎杀	xuan'yun'lie'sha	0
学院柯思卡	xue'yuan'ke'si'ka	0
学院莱拉	xue'yuan'lai'la	0
学院塔卡	xue'yuan'ta'ka	0
学院舞司	xue'yuan'wu'si	0
血债血偿	xue'zhai'xue'chang	0
迅捷火枪	xun'jie'huo'qiang	0
岩浆火焰	yan'jiang'huo'yan	0
野区	ye'qu	0
野区商店	ye'qu'shang'dian	0
移动壁垒	yi'dong'bi'lei	0
一段初出茅庐	yi'duan'chu'chu'mao'lu	0
以寡敌众	yi'gua'di'zhong	0
一号野	yi'hao'ye	0
一技能	yi'ji'neng	0
一皮	yi'pi	0
一忘皆空	yi'wang'jie'kong	0
隐藏分	yin'cang'fen	0
银河崩坏	yin'he'beng'huai	0
隐狐塔卡	yin'hu'ta'ka	0
银色旋风	yin'se'xuan'feng	0
隐身	yin'shen	0
音速舞司	yin'su'wu'si	0
英灵归来	ying'ling'gui'lai	0
鹰眼凯思卓	ying'yan'kai'si'zhuo	0
英勇好战	ying'yong'hao'zhan	0
勇者坦途	yong'zhe'tan'tu	0
诱敌免疫	you'di'mian'yi	0
游击战术	you'ji'zhan'shu	0
幽灵鬼步	you'ling'gui'bu	0
幽冥猛击	you'ming'meng'ji	0
幽冥骑士兰斯	you'ming'qi'shi'lan'si	0
愈合重击	yu'he'zhong'ji	0
与狼共舞	yu'lang'gong'wu	0
鱼人费恩	yu'ren'fei'en	0
狱炎烈酒	yu'yan'lie'jiu	0
余震	yu'zhen	0
远程兵	yuan'cheng'bing	0
远古女武神	yuan'gu'nv'wu'shen	0
圆环大师	yuan'huan'da'shi	0
月光斗篷	yue'guang'dou'peng	0
越空突刺	yue'kong'tu'ci	0
月亮公主星乐斯	yue'liang'gong'zhu'xing'le'si	0
越塔杀人	yue'ta'sha'ren	0
战斗翻滚	zhan'dou'fan'gun	0
战吼	zhan'hou	0
战吼震天	zhan'hou'zhen'tian	0
战警凯瑟琳	zhan'jing'kai'se'lin	0
战栗钢索	zhan'li'gang'suo	0
战擎丝凯伊	zhan'qing'si'kai'yi	0
战神之踵	zhan'shen'zhi'zhong	0
战士	zhan'shi	0
战靴	zhan'xue	0
照明弹	zhao'ming'dan	0
爪牙糖果	zhao'ya'tang'guo	0
侦查陷阱	zhen'cha'xian'jing	0
震颤红心	zhen'chan'hong'xin	0
真实伤害	zhen'shi'shang'hai	0
拯救之诗	zheng'jiu'zhi'shi	0
征途之靴	zheng'tu'zhi'xue	0
值得一战	zhi'de'yi'zhan	0
指挥	zhi'hui	0
致命一击	zhi'ming'yi'ji	0
蜘蛛女王凯思卓	zhi'zhu'nv'wang'kai'si'zhuo	0
至尊荣耀	zhi'zun'rong'yao	0
中部哨兵	zhong'bu'shao'bing	0
终结协议	zhong'jie'xie'yi	0
重拳出击	zhong'quan'chu'ji	0
重伤	zhong'shang	0
重跳加速	zhong'tiao'jia'su	0
重型钢剑	zhong'xing'gang'jian	0
重型棱镜	zhong'xing'leng'jing	0
重型装甲	zhong'xing'zhuang'jia	0
终章加速	zhong'zhang'jia'su	0
种子潜能	zhong'zi'qian'neng	0
逐步成长	zhu'bu'cheng'zhang	0
主二辅一	zhu'er'fu'yi	0
茱莉亚的恩赐	zhu'li'ya'de'en'ci	0
茱莉亚之歌	zhu'li'ya'zhi'ge	0
茱莉亚之光	zhu'li'ya'zhi'guang	0
主一辅二	zhu'yi'fu'er	0
装备	zhuang'bei	0
装备沉默	zhuang'bei'chen'mo	0
准备接驾	zhun'bei'jie'jia	0
子弹齐射	zi'dan'qi'she	0
紫卡	zi'ka	0
紫龙箱	zi'long'xiang	0
紫水晶箱	zi'shui'jing'xiang	0
紫焰史卡夫	zi'yan'shi'ka'fu	0
走位	zou'wei	0
诅咒之剑	zu'zhou'zhi'jian	0
醉枪手林戈	zui'qiang'shou'lin'ge	0
罪有应得	zui'you'ying'de	0
