暗脉菜粉蝶	an'mai'cai'fen'die	0
巴黎翠凤蝶	ba'li'cui'feng'die	0
白带凤蝶	bai'dai'feng'die	0
白点褐蚬蝶	bai'dian'he'xian'die	0
白角星弄蝶	bai'jiao'xing'nong'die	0
白弄蝶	bai'nong'die	0
白室蚬蝶	bai'shi'xian'die	0
白蚬蝶	bai'xian'die	0
斑凤蝶	ban'feng'die	0
宝镜凤蝶	bao'jing'feng'die	0
报喜斑粉蝶	bao'xi'ban'fen'die	0
碧凤蝶	bi'feng'die	0
檗黄粉蝶	bo'huang'fen'die	0
布莱荫眼蝶	bu'lai'yin'yan'die	0
长尾青凤蝶	chang'wei'qing'feng'die	0
长须蝶	chang'xu'die	0
橙翅方粉蝶	cheng'chi'fang'fen'die	0
橙粉蝶	cheng'fen'die	0
橙黄豆粉蝶	cheng'huang'dou'fen'die	0
赤顶粉蝶	chi'ding'fen'die	0
齿缘红蛱蝶	chi'yuan'hong'jia'die	0
串珠环蝶	chuan'zhu'huan'die	0
槌果藤粉蝶	chui'guo'teng'fen'die	0
粗纹青斑蝶	cu'wen'qing'ban'die	0
翠袖锯眼蝶	cui'xiu'ju'yan'die	0
大翅绢粉蝶	da'chi'juan'fen'die	0
大绢斑蝶	da'juan'ban'die	0
大伞弄蝶	da'san'nong'die	0
大透翅斑蝶	da'tou'chi'ban'die	0
大纹白粉蝶	da'wen'bai'fen'die	0
大紫蛱蝶	da'zi'jia'die	0
淡纹青斑蝶	dan'wen'qing'ban'die	0
地珠环蝶	di'zhu'huan'die	0
电蛱蝶	dian'jia'die	0
颠眼蝶	dian'yan'die	0
东方菜粉蝶	dong'fang'cai'fen'die	0
东亚矍眼蝶	dong'ya'jue'yan'die	0
多型凤蝶	duo'xing'feng'die	0
峨眉大弄蝶	e'mei'da'nong'die	0
二尾蛱蝶	er'wei'jia'die	0
飞龙粉蝶	fei'long'fen'die	0
凤蝶	feng'die	0
凤尾青凤蝶	feng'wei'qing'feng'die	0
凤眼方环蝶	feng'yan'fang'huan'die	0
柑橘凤蝶	gan'ju'feng'die	0
果神粉蝶	guo'shen'fen'die	0
鹤顶粉蝶	he'ding'fen'die	0
合欢黄粉蝶	he'huan'huang'fen'die	0
黑斑伞弄蝶	hei'ban'san'nong'die	0
黑豹弄蝶	hei'bao'nong'die	0
黑点菜粉蝶	hei'dian'cai'fen'die	0
黑点小粉蝶	hei'dian'xiao'fen'die	0
黑凤蝶	hei'feng'die	0
黑绢斑蝶	hei'juan'ban'die	0
黑流蛱蝶	hei'liu'jia'die	0
黑脉桦斑蝶	hei'mai'hua'ban'die	0
黑脉园粉蝶	hei'mai'yuan'fen'die	0
黑燕尾蚬蝶	hei'yan'wei'xian'die	0
横纹环蝶	heng'wen'huan'die	0
红灰蝶	hong'hui'die	0
红襟粉蝶	hong'jin'fen'die	0
红锯蛱蝶	hong'ju'jia'die	0
红裙凤蝶	hong'qun'feng'die	0
红纹凤蝶	hong'wen'feng'die	0
红缘凤蝶	hong'yuan'feng'die	0
红缘灰蝶	hong'yuan'hui'die	0
红珠凤蝶	hong'zhu'feng'die	0
虎斑蝶	hu'ban'die	0
虎纹斑蝶	hu'wen'ban'die	0
虎纹剑尾凤蝶	hu'wen'jian'wei'feng'die	0
虎纹针凤蝶	hu'wen'zhen'feng'die	0
桦斑蝶	hua'ban'die	0
花椒凤蝶	hua'jiao'feng'die	0
幻紫斑蝶	huan'zi'ban'die	0
黄带褐蚬蝶	huang'dai'he'xian'die	0
黄凤蝶	huang'feng'die	0
黄扇蝶	huang'shan'die	0
黄裳凤蝶	huang'shang'feng'die	0
黄帅蛱蝶	huang'shuai'jia'die	0
灰翅串珠环蝶	hui'chi'chuan'zhu'huan'die	0
尖翅弄蝶	jian'chi'nong'die	0
尖翅银灰蝶	jian'chi'yin'hui'die	0
箭环蝶	jian'huan'die	0
姜黄弄蝶	jiang'huang'nong'die	0
金斑蝶	jin'ban'die	0
金凤蝶	jin'feng'die	0
金扇凤蝶	jin'shan'feng'die	0
金裳凤蝶	jin'shang'feng'die	0
锯粉蝶	ju'fen'die	0
绢斑蝶	juan'ban'die	0
枯叶蝶	ku'ye'die	0
枯叶蛱蝶	ku'ye'jia'die	0
宽边黄粉蝶	kuan'bian'huang'fen'die	0
宽带黛眼蝶	kuan'dai'dai'yan'die	0
宽带凤蝶	kuan'dai'feng'die	0
宽带青凤蝶	kuan'dai'qing'feng'die	0
宽尾凤蝶	kuan'wei'feng'die	0
莱灰蝶	lai'hui'die	0
蓝点紫斑蝶	lan'dian'zi'ban'die	0
蓝凤蝶	lan'feng'die	0
楞凤蝶	leng'feng'die	0
梨花粉蝶	li'hua'fen'die	0
梨花迁粉蝶	li'hua'qian'fen'die	0
连纹黛眼蝶	lian'wen'dai'yan'die	0
裂斑金灰蝶	lie'ban'jin'hui'die	0
琉璃波纹小灰蝶	liu'li'bo'wen'xiao'hui'die	0
琉璃纹凤蝶	liu'li'wen'feng'die	0
绿斑凤蝶	lv'ban'feng'die	0
绿凤蝶	lv'feng'die	0
绿灰蝶	lv'hui'die	0
美凤蝶	mei'feng'die	0
迷蛱蝶	mi'jia'die	0
密纱眉眼蝶	mi'sha'mei'yan'die	0
密纹飒弄蝶	mi'wen'sa'nong'die	0
木兰青凤蝶	mu'lan'qing'feng'die	0
拟斑凤蝶	ni'ban'feng'die	0
拟幻紫斑蝶	ni'huan'zi'ban'die	0
拟旖斑蝶	ni'yi'ban'die	0
浓紫彩灰蝶	nong'zi'cai'hui'die	0
朴喙蝶	pu'hui'die	0
迁粉蝶	qian'fen'die	0
牵牛灰蝶	qian'niu'hui'die	0
青斑蝶	qing'ban'die	0
青城箭环蝶	qing'cheng'jian'huan'die	0
青凤蝶	qing'feng'die	0
蜻蜓蝶	qing'ting'die	0
曲纹袖弄蝶	qu'wen'xiu'nong'die	0
啬青斑蝶	se'qing'ban'die	0
僧袈眉眼蝶	seng'jia'mei'yan'die	0
裳凤蝶	shang'feng'die	0
蛇目褐蚬蝶	she'mu'he'xian'die	0
榺凤蝶	sheng'feng'die	0
鼠李粉蝶	shu'li'fen'die	0
双色带蛱蝶	shuang'se'dai'jia'die	0
双尾蛱蝶	shuang'wei'jia'die	0
双星箭环蝶	shuang'xing'jian'huan'die	0
双眼蚬蝶	shuang'yan'xian'die	0
丝链荫眼蝶	si'lian'yin'yan'die	0
碎斑凤蝶	sui'ban'feng'die	0
碎斑青凤蝶	sui'ban'qing'feng'die	0
藤粉蝶	teng'fen'die	0
藤果蚬蝶	teng'guo'xian'die	0
天狗蝶	tian'gou'die	0
铁刀木粉蝶	tie'dao'mu'fen'die	0
铁木莱异灰蝶	tie'mu'lai'yi'hui'die	0
铁锈灰蝶	tie'xiu'hui'die	0
统帅青凤蝶	tong'shuai'qing'feng'die	0
透翅斑蝶	tou'chi'ban'die	0
桅子灰蝶	wei'zi'hui'die	0
纹环蝶	wen'huan'die	0
无尾灰蝶	wu'wei'hui'die	0
乌鸦凤蝶	wu'ya'feng'die	0
无趾弄蝶	wu'zhi'nong'die	0
细纹青斑蝶	xi'wen'qing'ban'die	0
西藏翠蛱蝶	xi'zang'cui'jia'die	0
纤粉蝶	xian'fen'die	0
小青凤蝶	xiao'qing'feng'die	0
小透翅斑蝶	xiao'tou'chi'ban'die	0
斜带缺尾蚬蝶	xie'dai'que'wei'xian'die	0
猩灰蝶	xing'hui'die	0
蚜灰蝶	ya'hui'die	0
雅灰蝶	ya'hui'die	0
燕凤蝶	yan'feng'die	0
烟环蝶	yan'huan'die	0
瑶凤蝶	yao'feng'die	0
椰眼蝶	ye'yan'die	0
异型紫斑蝶	yi'xing'zi'ban'die	0
银白蛱蝶	yin'bai'jia'die	0
银线灰蝶	yin'xian'hui'die	0
玉斑凤蝶	yu'ban'feng'die	0
玉带蝶	yu'dai'die	0
玉带凤蝶	yu'dai'feng'die	0
鱼纹环蝶	yu'wen'huan'die	0
圆翅钩粉蝶	yuan'chi'gou'fen'die	0
圆弧蛱蝶	yuan'hu'jia'die	0
月纹矩环蝶	yue'wen'ju'huan'die	0
窄斑翠凤蝶	zhai'ban'cui'feng'die	0
樟青凤蝶	zhang'qing'feng'die	0
赭灰蝶	zhe'hui'die	0
甄蝶	zhen'die	0
苎麻斑蛱蝶	zhu'ma'ban'jia'die	0
苎麻珍蝶	zhu'ma'zhen'die	0
竹蚜小灰蝶	zhu'ya'xiao'hui'die	0
紫端斑蝶	zi'duan'ban'die	0
紫线黛眼蝶	zi'xian'dai'yan'die	0
棕脉粉蝶	zong'mai'fen'die	0
