啊啊啊我忘记了	a'a'a'wo'wang'ji'le	0
阿吽	a'hong	0
阿卡麟	a'ka'lin	0
阿空	a'kong	0
阿燐	a'lin	0
阿求	a'qiu	0
艾丽	ai'li	0
爱丽丝	ai'li'si	0
爱丽丝的魔法书	ai'li'si'de'mo'fa'shu	0
爱丽丝玛格特洛依德	ai'li'si'ma'ge'te'luo'yi'de	0
爱丽丝梦游仙境	ai'li'si'meng'you'xian'jing	0
爱丽丝威震天	ai'li'si'wei'zhen'tian	0
爱莲	ai'lian	0
爱塔妮缇拉尔瓦	ai'ta'ni'ti'la'er'wa	0
庵我烧了	an'wo'shao'le	0
奥莲姬	ao'lian'ji	0
八百万之神	ba'bai'wan'zhi'shen	0
八坂神奈子	ba'ban'shen'nai'zi	0
八分咲	ba'fen'xiao	0
八卦炉	ba'gua'lu	0
八桥	ba'qiao	0
八意永琳	ba'yi'yong'lin	0
八云蓝	ba'yun'lan	0
八云紫	ba'yun'zi	0
百鬼夜行	bai'gui'ye'xing	0
白鹭风茗	bai'lu'feng'ming	0
稗田阿求	bai'tian'a'qiu	0
百万鬼夜行	bai'wan'gui'ye'xing	0
百药枡	bai'yao'sheng	0
白玉楼	bai'yu'lou	0
半白泽	ban'bai'ze	0
坂田合欢乃	ban'tian'he'huan'nai	0
宝宝巴士	bao'bao'ba'shi	0
抱头蹲防	bao'tou'dun'fang	0
包子仙	bao'zi'xian	0
本居小铃	ben'ju'xiao'ling	0
本子仙	ben'zi'xian	0
彼岸	bi'an	0
彼岸归航	bi'an'gui'hang	0
比那名居天子	bi'na'ming'ju'tian'zi	0
弁弁	bian'bian	0
博丽	bo'li	0
博丽大结界	bo'li'da'jie'jie	0
博丽结界	bo'li'jie'jie	0
博丽灵梦	bo'li'ling'meng	0
博丽神社	bo'li'shen'she	0
博丽神社例大祭	bo'li'shen'she'li'da'ji	0
布都	bu'dou	0
布嘟嘟	bu'du'du	0
布加勒斯特的人偶师	bu'jia'le'si'te'de'ren'ou'shi	0
不可思议之国的爱丽丝	bu'ke'si'yi'zhi'guo'de'ai'li'si	0
不认识的孩子	bu'ren'shi'de'hai'zi	0
不死之烟飘上月球	bu'si'zhi'yan'piao'shang'yue'qiu	0
不朽的曼珠沙华	bu'xiu'de'man'zhu'sha'hua	0
擦弹	ca'dan	0
蔡徐坤	cai'xu'kun	0
残机	can'ji	0
缠流子	chan'liu'zi	0
车车人	che'che'ren	0
车万	che'wan	0
沉默的兽灵	chen'mo'de'shou'ling	0
成美	cheng'mei	0
赤蛮奇	chi'man'qi	0
重生	chong'sheng	0
畜生界	chu'sheng'jie	0
畜生们的休息	chu'sheng'men'de'xiu'xi	0
船幽灵	chuan'you'ling	0
船长	chuan'zhang	0
纯狐	chun'hu	0
纯妈	chun'ma	0
纯情活泼的小姑娘	chun'qing'huo'po'de'xiao'gu'niang	0
茨歌仙	ci'ge'xian	0
茨木华扇	ci'mu'hua'shan	0
从地下的归还	cong'di'xia'de'gui'huan	0
萃梦想	cui'meng'xiang	0
萃香	cui'xiang	0
村纱水蜜	cun'sha'shui'mi	0
大蛾子	da'e'zi	0
大根	da'gen	0
大蛤蟆之池	da'ha'ma'zhi'chi	0
大酱	da'jiang	0
大结界	da'jie'jie	0
大鹫灵	da'jiu'ling	0
大狸子	da'li'zi	0
大妖精	da'yao'jing	0
大玉	da'yu	0
弹幕	dan'mu	0
弹幕射击	dan'mu'she'ji	0
弹幕邪天鬼	dan'mu'xie'tian'gui	0
弹幕战	dan'mu'zhan	0
道中	dao'zhong	0
得点	de'dian	0
地底通路	di'di'tong'lu	0
敌机	di'ji	0
地灵殿	di'ling'dian	0
地狱鸦	di'yu'ya	0
掉残	diao'can	0
弔姐	diao'jie	0
吊瓶妖	diao'ping'yao	0
凋叶棕	diao'ye'zong	0
丁礼田	ding'li'tian	0
丁礼田舞	ding'li'tian'wu	0
东方	dong'fang	0
东方蝉时歌	dong'fang'chan'shi'ge	0
东方茨歌仙	dong'fang'ci'ge'xian	0
东方萃梦想	dong'fang'cui'meng'xiang	0
东方大炮弹	dong'fang'da'pao'dan	0
东方大往生	dong'fang'da'wang'sheng	0
东方大战争	dong'fang'da'zhan'zheng	0
东方地灵殿	dong'fang'di'ling'dian	0
东方绯想天	dong'fang'fei'xiang'tian	0
东方非想天则	dong'fang'fei'xiang'tian'ze	0
东方封魔录	dong'fang'feng'mo'lu	0
东方风神录	dong'fang'feng'shen'lu	0
东方绀珠传	dong'fang'gan'zhu'chuan	0
东方刚欲异闻	dong'fang'gang'yu'yi'wen	0
东方怪绮谈	dong'fang'guai'qi'tan	0
东方鬼形兽	dong'fang'gui'xing'shou	0
东方红楼梦	dong'fang'hong'lou'meng	0
东方红魔乡	dong'fang'hong'mo'xiang	0
东方华烂漫	dong'fang'hua'lan'man	0
东方花映冢	dong'fang'hua'ying'zhong	0
东方幻想乡	dong'fang'huan'xiang'xiang	0
东方辉针城	dong'fang'hui'zhen'cheng	0
东方铃奈庵	dong'fang'ling'nai'an	0
东方灵异传	dong'fang'ling'yi'chuan	0
东方梦灵梦	dong'fang'meng'ling'meng	0
东方梦时空	dong'fang'meng'shi'kong	0
东方儚月抄	dong'fang'meng'yue'chao	0
东方凭依华	dong'fang'ping'yi'hua	0
东方清泉飨	dong'fang'qing'quan'xiang	0
东方求闻口授	dong'fang'qiu'wen'kou'shou	0
东方求闻史纪	dong'fang'qiu'wen'shi'ji	0
东方三月精	dong'fang'san'yue'jing	0
东方神灵庙	dong'fang'shen'ling'miao	0
东方深秘录	dong'fang'shen'mi'lu	0
东方失去之言	dong'fang'shi'qu'zhi'yan	0
东方四季呗	dong'fang'si'ji'bei	0
东方天空璋	dong'fang'tian'kong'zhang	0
东方天上花	dong'fang'tian'shang'hua	0
东方童楼遥	dong'fang'tong'lou'yao	0
东方外来韦编	dong'fang'wai'lai'wei'bian	0
东方文花帖	dong'fang'wen'hua'tie	0
东方香霖堂	dong'fang'xiang'lin'tang	0
东方心绮楼	dong'fang'xin'qi'lou	0
东方星莲船	dong'fang'xing'lian'chuan	0
东方妖妖梦	dong'fang'yao'yao'meng	0
东方萤灯筏	dong'fang'ying'deng'fa	0
东方樱蝶梦	dong'fang'ying'die'meng	0
东方樱神月	dong'fang'ying'shen'yue	0
东方永夜抄	dong'fang'yong'ye'chao	0
东方游剧天	dong'fang'you'ju'tian	0
东方智灵奇传	dong'fang'zhi'ling'qi'chuan	0
东方紫香花	dong'fang'zi'xiang'hua	0
东方醉蝶华	dong'fang'zui'die'hua	0
东风谷早苗	dong'feng'gu'zao'miao	0
动物灵	dong'wu'ling	0
毒奶	du'nai	0
多多良小伞	duo'duo'liang'xiao'san	0
哆来咪	duo'lai'mi	0
哆来咪苏伊特	duo'lai'mi'su'yi'te	0
谔谔	e'e	0
噩梦日记	e'meng'ri'ji	0
二次创作	er'ci'chuang'zuo	0
二设	er'she	0
二婶子	er'shen'zi	0
二岩猯藏	er'yan'tuan'cang	0
尔子田	er'zi'tian	0
尔子田里乃	er'zi'tian'li'nai	0
法界	fa'jie	0
反魂蝶	fan'hun'die	0
芳香	fang'xiang	0
防撞桶	fang'zhuang'tong	0
非符	fei'fu	0
非想天	fei'xiang'tian	0
丰聪耳神子	feng'cong'er'shen'zi	0
风见幽香	feng'jian'you'xiang	0
疯帽子茶会	feng'mao'zi'cha'hui	0
封魔录	feng'mo'lu	0
风神录	feng'shen'lu	0
封兽鵺	feng'shou'ye	0
风之暗穴	feng'zhi'an'xue	0
疯中二婶子	feng'zhong'er'shen'zi	0
符卡	fu'ka	0
符卡规则	fu'ka'gui'ze	0
芙兰	fu'lan	0
芙兰朵露	fu'lan'duo'lu	0
芙兰朵露斯卡雷特	fu'lan'duo'lu'si'ka'lei'te	0
付丧神	fu'sang'shen	0
尬舞姐妹	ga'wu'jie'mei	0
感情的摩天楼	gan'qing'de'mo'tian'lou	0
绀珠传	gan'zhu'chuan	0
刚欲同盟	gang'yu'tong'meng	0
刚欲异闻	gang'yu'yi'wen	0
高丽野阿吽	gao'li'ye'a'hong	0
格斗	ge'dou	0
宫古芳香	gong'gu'fang'xiang	0
狗椛	gou'hua	0
固定弹	gu'ding'dan	0
鼓哥	gu'ge	0
鼓姐	gu'jie	0
古明地觉	gu'ming'di'jue	0
古明地恋	gu'ming'di'lian	0
怪力乱神	guai'li'luan'shen	0
怪绮谈	guai'qi'tan	0
广西烧烤摊老板	guang'xi'shao'kao'tan'lao'ban	0
广有射怪鸟事	guang'you'she'guai'niao'shi	0
鬼畜妹	gui'chu'mei	0
袿姬	gui'ji	0
鬼杰组	gui'jie'zu	0
鬼杰组组长	gui'jie'zu'zu'zhang	0
鬼人正邪	gui'ren'zheng'xie	0
鬼形兽	gui'xing'shou	0
果果	guo'guo	0
过膝袜	guo'xi'wa	0
哈德曼的妖怪少女	ha'de'man'de'yao'guai'shao'nv	0
航哥	hang'ge	0
好吗	hao'ma	0
河城荷取	he'cheng'he'qu	0
赫卡	he'ka	0
赫卡姐	he'ka'jie	0
赫卡提亚	he'ka'ti'ya	0
赫卡提亚拉碧斯拉祖利	he'ka'ti'ya'la'bi'si'la'zu'li	0
荷取	he'qu	0
核融炉	he'rong'lu	0
河童	he'tong	0
黑谷山女	hei'gu'shan'nv	0
黑历史	hei'li'shi	0
红楼	hong'lou	0
红美铃	hong'mei'ling	0
红萌馆	hong'meng'guan	0
红魔馆	hong'mo'guan	0
红魔乡	hong'mo'xiang	0
红银	hong'yin	0
红字本	hong'zi'ben	0
虎哥	hu'ge	0
胡桃	hu'tao	0
冴月麟	hu'yue'lin	0
椛椛	hua'hua	0
花开夜	hua'kai'ye	0
华扇	hua'shan	0
华扇邸	hua'shan'di	0
花映冢	hua'ying'zhong	0
坏苹果	huai'ping'guo	0
欢姐	huan'jie	0
幻梦缘起	huan'meng'yuan'qi	0
幻视之夜	huan'shi'zhi'ye	0
幻想万华镜	huan'xiang'wan'hua'jing	0
幻想夏乡	huan'xiang'xia'xiang	0
幻想乡	huan'xiang'xiang	0
幻想乡空闪姬	huan'xiang'xiang'kong'shan'ji	0
幻想乡空战姬	huan'xiang'xiang'kong'zhan'ji	0
幻想乡少女大战	huan'xiang'xiang'shao'nv'da'zhan	0
幻想乡玩家	huan'xiang'xiang'wan'jia	0
幻想跃迁实验室	huan'xiang'yue'qian'shi'yan'shi	0
幻缘团	huan'yuan'tuan	0
幻月	huan'yue	0
幻跃团	huan'yue'tuan	0
黄昏立绘	huang'hun'li'hui	0
黄旭东	huang'xu'dong	0
辉夜	hui'ye	0
慧音	hui'yin	0
辉针城	hui'zhen'cheng	0
辉针城的小人族	hui'zhen'cheng'de'xiao'ren'zu	0
魂魄妖忌	hun'po'yao'ji	0
魂魄妖梦	hun'po'yao'meng	0
火车	huo'che	0
霍青娥	huo'qing'e	0
火焰猫燐	huo'yan'mao'lin	0
吉弔	ji'diao	0
吉弔八千慧	ji'diao'ba'qian'hui	0
姬海棠果	ji'hai'tang'guo	0
姬海棠极	ji'hai'tang'ji	0
姬海棠羽立	ji'hai'tang'yu'li	0
鸡妹	ji'mei	0
寄世界于偶像	ji'shi'jie'yu'ou'xiang	0
键山雏	jian'shan'chu	0
间歇泉	jian'xie'quan	0
奖残	jiang'can	0
奖分	jiang'fen	0
姐贵	jie'gui	0
结界	jie'jie	0
禁忌的魔法	jin'ji'de'mo'fa	0
矜羯罗	jin'jie'luo	0
今泉影狼	jin'quan'ying'lang	0
今天也是好天气	jin'tian'ye'shi'hao'tian'qi	0
今昔幻想乡	jin'xi'huan'xiang'xiang	0
今宵是飘逸的利己主义者	jin'xiao'shi'piao'yi'de'li'ji'zhu'yi'zhe	0
劲牙组	jin'ya'zu	0
劲牙组组长	jin'ya'zu'zu'zhang	0
堇子	jin'zi	0
京都幻想剧团	jing'du'huan'xiang'ju'tuan	0
静叶	jing'ye	0
囧仙	jiong'xian	0
囧仙子	jiong'xian'zi	0
旧地狱遗址	jiu'di'yu'yi'zhi	0
旧都	jiu'du	0
九十九八桥	jiu'shi'jiu'ba'qiao	0
九十九弁弁	jiu'shi'jiu'bian'bian	0
九天瀑布	jiu'tian'pu'bu	0
菊理	ju'li	0
决死符	jue'si'fu	0
卡娜安娜贝拉尔	ka'na'an'na'bei'la'er	0
考据党	kao'ju'dang	0
可悲的人偶	ke'bei'de'ren'ou	0
克劳恩	ke'lao'en	0
克劳恩皮丝	ke'lao'en'pi'si	0
堀川雷鼓	ku'chuan'lei'gu	0
狂气之瞳	kuang'qi'zhi'tong	0
蓝妈	lan'ma	0
狼女	lang'nv	0
老娘是最强	lao'niang'shi'zui'qiang	0
乐航	le'hang	0
乐囧	le'jiong	0
蕾蒂	lei'di	0
蕾蒂霍瓦特洛克	lei'di'huo'wa'te'luo'ke	0
蕾拉	lei'la	0
蕾拉普莉兹姆利巴	lei'la'pu'li'zi'mu'li'ba	0
蕾米	lei'mi	0
雷咪	lei'mi	0
蕾米莉亚	lei'mi'li'ya	0
蕾米莉亚斯卡雷特	lei'mi'li'ya'si'ka'lei'te	0
例大祭	li'da'ji	0
莉格露	li'ge'lu	0
莉格露奈特巴格	li'ge'lu'nai'te'ba'ge	0
骊驹早鬼	li'ju'zao'gui	0
莉莉	li'li	0
莉莉白	li'li'bai	0
莉莉黑	li'li'hei	0
莉莉霍瓦特	li'li'huo'wa'te	0
莉莉卡	li'li'ka	0
莉莉卡普莉兹姆利巴	li'li'ka'pu'li'zi'mu'li'ba	0
里乃	li'nai	0
里香	li'xiang	0
恋恋	lian'lian	0
莲妈	lian'ma	0
莲子	lian'zi	0
铃二	ling'er	0
铃瑚	ling'hu	0
灵力	ling'li	0
灵梦	ling'meng	0
铃奈庵	ling'nai'an	0
令人怀念的东方之血	ling'ren'huai'nian'de'dong'fang'zhi'xue	0
灵乌路空	ling'wu'lu'kong	0
铃仙	ling'xian	0
铃仙二号	ling'xian'er'hao	0
铃仙优昙华院因幡	ling'xian'you'tan'hua'yuan'yin'fan	0
灵异传	ling'yi'chuan	0
灵知的太阳信仰	ling'zhi'de'tai'yang'xin'yang	0
留琴	liu'qin	0
六十年目的东方裁判	liu'shi'nian'mu'di'dong'fang'cai'pan	0
辘轳首	lu'lu'shou	0
露米娅	lu'mi'ya	0
露娜	lu'na	0
露娜切露德	lu'na'qie'lu'de	0
露娜萨	lu'na'sa	0
露娜萨普莉兹姆利巴	lu'na'sa'pu'li'zi'mu'li'ba	0
露易兹	lu'yi'zi	0
轮椅战神	lun'yi'zhan'shen	0
萝卜	luo'bo	0
洛天依	luo'tian'yi	0
绿头发的爸爸	lv'tou'fa'de'ba'ba	0
绿眼的嫉妒	lv'yan'de'ji'du	0
玛艾露贝莉赫恩	ma'ai'lu'bei'li'he'en	0
玛格特罗依德邸	ma'ge'te'luo'yi'de'di	0
麻将山	ma'jiang'shan	0
玛露奇	ma'lu'qi	0
满福神社	man'fu'shen'she	0
馒馒来	man'man'lai	0
毛玉	mao'yu	0
梅蒂欣梅兰可莉	mei'di'xin'mei'lan'ke'li	0
美国酱	mei'guo'jiang	0
妹红	mei'hong	0
梅丽	mei'li	0
梅莉	mei'li	0
美铃	mei'ling	0
梅露兰	mei'lu'lan	0
梅露兰普莉兹姆利巴	mei'lu'lan'pu'li'zi'mu'li'ba	0
魅魔	mei'mo	0
梦殿大祀庙	meng'dian'da'si'miao	0
梦时空	meng'shi'kong	0
梦想天生	meng'xiang'tian'sheng	0
梦消失	meng'xiao'shi	0
梦月	meng'yue	0
儚月抄	meng'yue'chao	0
梦子	meng'zi	0
秘封	mi'feng	0
蜜蜂	mi'feng	0
秘封厨	mi'feng'chu	0
秘封噩梦日记	mi'feng'e'meng'ri'ji	0
秘封活动记录	mi'feng'huo'dong'ji'lu	0
秘封俱乐部异界摄影记录	mi'feng'ju'le'bu'yi'jie'she'ying'ji'lu	0
秘封组	mi'feng'zu	0
米国酱	mi'guo'jiang	0
米国小妖精	mi'guo'xiao'yao'jing	0
咪咪号	mi'mi'hao	0
秘神摩多罗	mi'shen'mo'duo'luo	0
米斯蒂娅	mi'si'di'ya	0
米斯蒂娅萝蕾拉	mi'si'di'ya'luo'lei'la	0
迷途之家	mi'tu'zhi'jia	0
迷途竹林	mi'tu'zhu'lin	0
面灵气	mian'ling'qi	0
绵月丰姬	mian'yue'feng'ji	0
绵月依姬	mian'yue'yi'ji	0
苗苗	miao'miao	0
苗爷	miao'ye	0
冥界	ming'jie	0
命莲	ming'lian	0
命莲寺	ming'lian'si	0
明罗	ming'luo	0
明治十七年的上海爱丽丝	ming'zhi'shi'qi'nian'de'shang'hai'ai'li'si	0
摸多了硬起来	mo'duo'le'ying'qi'lai	0
摩多罗	mo'duo'luo	0
摩多罗隐岐奈	mo'duo'luo'yin'qi'nai	0
魔法森林	mo'fa'sen'lin	0
魔法使	mo'fa'shi	0
魔理沙	mo'li'sha	0
魔理沙的弹幕回忆	mo'li'sha'de'dan'mu'hui'yi	0
摩妈	mo'ma	0
磨米机	mo'mi'ji	0
摩托罗拉	mo'tuo'luo'la	0
摩西的奇迹	mo'xi'de'qi'ji	0
娜兹玲	na'zi'ling	0
牛妈	niu'ma	0
牛崎润美	niu'qi'run'mei	0
女苑	nv'yuan	0
帕露西	pa'lu'xi	0
帕琪	pa'qi	0
帕秋莉	pa'qiu'li	0
帕秋莉诺蕾姬	pa'qiu'li'nuo'lei'ji	0
判定点	pan'ding'dian	0
蓬莱人	peng'lai'ren	0
蓬莱山辉夜	peng'lai'shan'hui'ye	0
凭依华	ping'yi'hua	0
凭坐在梦与现实之间	ping'zuo'zai'meng'yu'xian'shi'zhi'jian	0
琪露诺	qi'lu'nuo	0
骑士之夜	qi'shi'zhi'ye	0
琪斯美	qi'si'mei	0
千年幻想乡	qian'nian'huan'xiang'xiang	0
桥姬	qiao'ji	0
秦河胜	qin'he'sheng	0
秦心	qin'xin	0
青娥	qing'e	0
清兰	qing'lan	0
青蛙子	qing'wa'zi	0
秋静叶	qiu'jing'ye	0
秋穰子	qiu'rang'zi	0
求闻口授	qiu'wen'kou'shou	0
求闻史纪	qiu'wen'shi'ji	0
犬走椛	quan'zou'hua	0
穰子	rang'zi	0
人间之里	ren'jian'zhi'li	0
人形裁判	ren'xing'cai'pan	0
人形使	ren'xing'shi	0
人鱼	ren'yu	0
戎璎花	rong'ying'hua	0
入道	ru'dao	0
乳町	ru'ding	0
若鹭姬	ruo'lu'ji	0
萨拉	sa'la	0
萨丽艾尔	sa'li'ai'er	0
三分咲	san'fen'xiao	0
三途川	san'tu'chuan	0
伞妖	san'yao	0
三月精	san'yue'jing	0
桑尼	sang'ni	0
桑尼米尔克	sang'ni'mi'er'ke	0
骚灵	sao'ling	0
森近霖之助	sen'jin'lin'zhi'zhu	0
山姥	shan'lao	0
山女	shan'nv	0
山彦	shan'yan	0
闪耀的弱肉强食法则	shan'yao'de'ruo'rou'qiang'shi'fa'ze	0
上白泽慧音	shang'bai'ze'hui'yin	0
上海爱丽丝幻乐团	shang'hai'ai'li'si'huan'yue'tuan	0
烧烤摊老板	shao'kao'tan'lao'ban	0
少名针妙丸	shao'ming'zhen'miao'wan	0
少女幻葬	shao'nv'huan'zang	0
少女觉的第三只眼	shao'nv'jue'de'di'san'zhi'yan	0
少女绮想曲	shao'nv'qi'xiang'qu	0
射命丸文	she'ming'wan'wen	0
社团	she'tuan	0
神话幻想	shen'hua'huan'xiang	0
神灵	shen'ling	0
神灵庙	shen'ling'miao	0
神妈	shen'ma	0
深秘录	shen'mi'lu	0
神奈子	shen'nai'zi	0
神绮	shen'qi	0
神社闭店之日	shen'she'bi'dian'zhi'ri	0
神玉	shen'yu	0
神子	shen'zi	0
圣白莲	sheng'bai'lian	0
圣德传说	sheng'de'chuan'shuo	0
圣德太子	sheng'de'tai'zi	0
圣德太子的马	sheng'de'tai'zi'de'ma	0
圣德太子的天马	sheng'de'tai'zi'de'tian'ma	0
圣莲船	sheng'lian'chuan	0
生死之境	sheng'si'zhi'jing	0
世界美咲剧场	shi'jie'mei'xiao'ju'chang	0
十六夜	shi'liu'ye	0
十六夜咲夜	shi'liu'ye'xiao'ye	0
矢田寺成美	shi'tian'si'cheng'mei	0
矢田寺成美永远不喜欢你	shi'tian'si'cheng'mei'yong'yuan'bu'xi'huan'ni	0
石之婴儿与水中牛	shi'zhi'ying'er'yu'shui'zhong'niu	0
兽道	shou'dao	0
寿命论	shou'ming'lun	0
兽娘幻想入	shou'niang'huan'xiang'ru	0
兽人	shou'ren	0
守矢神社	shou'shi'shen'she	0
双七	shuang'qi	0
水桥帕露西	shui'qiao'pa'lu'xi	0
水獭灵	shui'ta'ling	0
四重存在	si'chong'cun'zai	0
四季	si'ji	0
四季大人	si'ji'da'ren	0
四季撒吗	si'ji'sa'ma	0
四季撒吗我有罪	si'ji'sa'ma'wo'you'zui	0
四季映姬	si'ji'ying'ji	0
四季映姬亚玛萨那度	si'ji'ying'ji'ya'ma'sa'na'du	0
斯卡雷特	si'ka'lei'te	0
死灵	si'ling	0
死神	si'shen	0
四十米大刀	si'shi'mi'da'dao	0
斯塔	si'ta	0
斯塔萨菲娅	si'ta'sa'fei'ya	0
死亡幻想曲	si'wang'huan'xiang'qu	0
寺子屋	si'zi'wu	0
搜到有	sou'dao'you	0
苏格拉底	su'ge'la'di	0
苏我屠自古	su'wo'tu'zi'gu	0
随机弹	sui'ji'dan	0
砕月	sui'yue	0
碎月	sui'yue	0
太田顺也	tai'tian'shun'ye	0
太阳花田	tai'yang'hua'tian	0
太子的马	tai'zi'de'ma	0
探女	tan'nv	0
探女老仙	tan'nv'lao'xian	0
陶瓷的杖刀人	tao'ci'de'zhang'dao'ren	0
藤原妹红	teng'yuan'mei'hong	0
天狗	tian'gou	0
天空璋	tian'kong'zhang	0
天人	tian'ren	0
天探女	tian'tan'nv	0
天邪鬼	tian'xie'gui	0
天子	tian'zi	0
条纹过膝袜	tiao'wen'guo'xi'wa	0
庭渡久侘歌	ting'du'jiu'cha'ge	0
同人	tong'ren	0
土蜘蛛	tu'zhi'zhu	0
土著信仰	tu'zhu'xin'yang	0
屠自古	tu'zi'gu	0
豚乙女	tun'yi'nv	0
外界	wai'jie	0
外来人	wai'lai'ren	0
外来韦编	wai'lai'wei'bian	0
亡灵	wang'ling	0
为逝去公主所奏的七重奏	wei'shi'qu'gong'zhu'suo'zou'de'qi'chong'zou	0
威严满满	wei'yan'man'man	0
胃炎满满	wei'yan'man'man	0
文花帖	wen'hua'tie	0
文文	wen'wen	0
我会自己上厕所	wo'hui'zi'ji'shang'ce'suo	0
我喜欢矢田寺成美	wo'xi'huan'shi'tian'si'cheng'mei	0
我做东方鬼畜音	wo'zuo'dong'fang'gui'chu'yin	0
物部布都	wu'bu'bu'dou	0
五分咲	wu'fen'xiao	0
无何有之乡	wu'he'you'zhi'xiang	0
无名之丘	wu'ming'zhi'qiu	0
雾雨	wu'yu	0
雾雨魔理沙	wu'yu'mo'li'sha	0
无缘冢	wu'yuan'zhong	0
雾之湖	wu'zhi'hu	0
稀神探女	xi'shen'tan'nv	0
西行寺幽幽子	xi'xing'si'you'you'zi	0
吸血鬼	xi'xue'gui	0
下压	xia'ya	0
献给逝去公主的七重奏	xian'gei'shi'qu'gong'zhu'de'qi'chong'zou	0
仙界	xian'jie	0
现界	xian'jie	0
仙人	xian'ren	0
现世的秘术师	xian'shi'de'mi'shu'shi	0
香霖堂	xiang'lin'tang	0
乡长	xiang'zhang	0
响子	xiang'zi	0
消弹	xiao'dan	0
小町	xiao'ding	0
小恶魔	xiao'e'mo	0
小老帝	xiao'lao'di	0
小铃	xiao'ling	0
小米弹	xiao'mi'dan	0
小人族	xiao'ren'zu	0
小伞	xiao'san	0
小桶	xiao'tong	0
小兔姬	xiao'tu'ji	0
小碗	xiao'wan	0
小五	xiao'wu	0
小小青蛙不输风雨	xiao'xiao'qing'wa'bu'shu'feng'yu	0
咲夜	xiao'ye	0
小野冢小町	xiao'ye'zhong'xiao'ding	0
泄矢诹访子	xie'shi'zou'fang'zi	0
心酱	xin'jiang	0
心绮楼	xin'qi'lou	0
信仰是为了虚幻之人	xin'yang'shi'wei'le'xu'huan'zhi'ren	0
心之所在	xin'zhi'suo'zai	0
星莲船	xing'lian'chuan	0
星条旗的小丑	xing'tiao'qi'de'xiao'chou	0
星熊杯	xing'xiong'bei	0
星熊勇仪	xing'xiong'yong'yi	0
幸运与不幸	xing'yun'yu'bu'xing	0
星之器	xing'zhi'qi	0
续关	xu'guan	0
玄武之泽	xuan'wu'zhi'ze	0
玄爷	xuan'ye	0
玄云海	xuan'yun'hai	0
阎魔	yan'mo	0
妖虫	yao'chong	0
妖怪狸	yao'guai'li	0
妖怪鼠	yao'guai'shu	0
妖怪之山	yao'guai'zhi'shan	0
妖精	yao'jing	0
妖精大战争	yao'jing'da'zhan'zheng	0
妖梦	yao'meng	0
妖兽	yao'shou	0
妖兔	yao'tu	0
妖妖跋扈	yao'yao'ba'hu	0
妖妖梦	yao'yao'meng	0
鵺酱	ye'jiang	0
野狼灵	ye'lang'ling	0
野蛮至极	ye'man'zhi'ji	0
爷们红	ye'men'hong	0
夜雀	ye'que	0
爷是恋恋	ye'shi'lian'lian	0
一般通过	yi'ban'tong'guo	0
一般通过山女	yi'ban'tong'guo'shan'nv	0
异变	yi'bian	0
伊吹萃香	yi'chui'cui'xiang	0
伊吹瓢	yi'chui'piao	0
伊吹西瓜	yi'chui'xi'gua	0
一分咲	yi'fen'xiao	0
衣玖	yi'jiu	0
依莉斯	yi'li'si	0
一轮	yi'lun	0
一设	yi'she	0
依神女苑	yi'shen'nv'yuan	0
依神紫苑	yi'shen'zi'yuan	0
易者	yi'zhe	0
引弹	yin'dan	0
因幡帝	yin'fan'di	0
因幡天为	yin'fan'tian'wei	0
隐匿的四季	yin'ni'de'si'ji	0
隐岐奈	yin'qi'nai	0
寅丸星	yin'wan'xing	0
阴阳玉	yin'yang'yu	0
樱花樱花	ying'hua'ying'hua	0
影狼	ying'lang	0
永动之龛	yong'dong'zhi'kan	0
永江衣玖	yong'jiang'yi'jiu	0
永琳	yong'lin	0
永夜抄	yong'ye'chao	0
勇仪	yong'yi	0
永远的春梦	yong'yuan'de'chun'meng	0
永远的满月	yong'yuan'de'man'yue	0
永远亭	yong'yuan'ting	0
幽闭星光	you'bi'xing'guang	0
有顶天	you'ding'tian	0
幽谷响子	you'gu'xiang'zi	0
幽幻魔眼	you'huan'mo'yan	0
油库里	you'ku'li	0
幽灵	you'ling	0
幽冥结界	you'ming'jie'jie	0
幽香	you'xiang	0
幽雅的绽放墨染之樱	you'ya'de'zhan'fang'mo'ran'zhi'ying	0
幽幽子	you'you'zi	0
御伽之国的鬼岛	yu'jia'zhi'guo'de'gui'dao	0
玉米棒子	yu'mi'bang'zi	0
欲望加速	yu'wang'jia'su	0
宇佐见堇子	yu'zuo'jian'jin'zi	0
宇佐见堇子的魔法书	yu'zuo'jian'jin'zi'de'mo'fa'shu	0
宇佐见莲子	yu'zuo'jian'lian'zi	0
原点组	yuan'dian'zu	0
原始的节拍	yuan'shi'de'jie'pai	0
远野幻想物语	yuan'ye'huan'xiang'wu'yu	0
越共	yue'gong	0
乐器妖怪	yue'qi'yao'guai	0
月人	yue'ren	0
月时计	yue'shi'ji	0
月兔	yue'tu	0
月之都	yue'zhi'dou	0
云居一轮	yun'ju'yi'lun	0
云山	yun'shan	0
再思之道	zai'si'zhi'dao	0
早鬼	zao'gui	0
早苗	zao'miao	0
杖刀偶磨弓	zhang'dao'ou'mo'gong	0
长相酷似周杰伦的村民	zhang'xiang'ku'si'zhou'jie'lun'de'cun'min	0
长者	zhang'zhe	0
折返	zhe'fan	0
这是好的	zhe'shi'hao'de	0
这是好的并且没有任何坏处	zhe'shi'hao'de'bing'qie'mei'you'ren'he'huai'chu	0
真吉八弔	zhen'ji'ba'diao	0
针妙丸	zhen'miao'wan	0
正邪	zheng'xie	0
埴安神袿姬	zhi'an'shen'gui'ji	0
智灵奇传	zhi'ling'qi'chuan	0
埴轮兵长	zhi'lun'bing'zhang	0
只有地藏知晓的哀叹	zhi'you'di'zang'zhi'xiao'de'ai'tan	0
中弹	zhong'dan	0
终符	zhong'fu	0
众神眷恋的幻想乡	zhong'shen'juan'lian'de'huan'xiang'xiang	0
仲夏夜的妖精之梦	zhong'xia'ye'de'yao'jing'zhi'meng	0
朱鹭子	zhu'lu'zi	0
竹取飞翔	zhu'qu'fei'xiang	0
转转	zhuan'zhuan	0
壮族大妈	zhuang'zu'da'ma	0
自机	zi'ji	0
自机狙	zi'ji'ju	0
紫老太	zi'lao'tai	0
紫妈	zi'ma	0
紫妹	zi'mei	0
紫奶奶	zi'nai'nai	0
紫婆婆	zi'po'po	0
紫香花	zi'xiang'hua	0
紫苑	zi'yuan	0
诹访湖	zou'fang'hu	0
诹访子	zou'fang'zi	0
醉蝶华	zui'die'hua	0
佐渡的二岩	zuo'du'de'er'yan	0
