安全线	an'quan'xian	0
安全用户	an'quan'yong'hu	0
暴风雨雪	bao'feng'yu'xue	0
爆炸品	bao'zha'pin	0
避难线	bi'nan'xian	0
编组站	bian'zu'zhan	0
标准用语	biao'zhun'yong'yu	0
车机联控标准	che'ji'lian'kong'biao'zhun	0
车站值班员	che'zhan'zhi'ban'yuan	0
乘务员	cheng'wu'yuan	0
穿越或占用正线调车	chuan'yue'huo'zhan'yong'zheng'xian'diao'che	0
电力机车	dian'li'ji'che	0
调车领导人	diao'che'ling'dao'ren	0
调度命令	diao'du'ming'ling	0
调度所	diao'du'suo	0
动车组	dong'che'zu	0
防溜措施	fang'liu'cuo'shi	0
供电	gong'dian	0
机车固定走行线	ji'che'gu'ding'zou'xing'xian	0
集团公司	ji'tuan'gong'si	0
列车编组	lie'che'bian'zu	0
林学新	lin'xue'xin	0
刘燕芬	liu'yan'fen	0
人力制动机	ren'li'zhi'dong'ji	0
棠溪站	tang'xi'zhan	0
铁路技术管理规程	tie'lu'ji'shu'guan'li'gui'cheng	0
铁路运输调度规则	tie'lu'yun'shu'diao'du'gui'ze	0
微机联锁	wei'ji'lian'suo	0
行车凭证	xing'che'ping'zheng	0
行车设备检查登记簿	xing'che'she'bei'jian'cha'deng'ji'bu	0
压缩气体	ya'suo'qi'ti	0
运输组织	yun'shu'zu'zhi	0
运转室	yun'zhuan'shi	0
闸瓦	zha'wa	0
重大事故	zhong'da'shi'gu	0
专用线	zhuan'yong'xian	0
追踪列车	zhui'zong'lie'che	0
自动闭塞	zi'dong'bi'se	0
