哀其不幸怒其不争	ai'qi'bu'xing'nu'qi'bu'zheng	0
爱情不能不包括帮助	ai'qing'bu'neng'bu'bao'kuo'bang'zhu	0
帮助不等于爱情	bang'zhu'bu'deng'yu'ai'qing	0
必须敢于正视	bi'xu'gan'yu'zheng'shi	0
并不是十足的轻蔑	bing'bu'shi'shi'zu'de'qing'mie	0
不必听自暴自弃者的话	bu'bi'ting'zi'bao'zi'qi'zhe'de'hua	0
不可救药的民族中	bu'ke'jiu'yao'de'min'zu'zhong	0
不是一颗心对另一颗心敲打	bu'shi'yi'ke'xin'dui'ling'yi'ke'xin'qiao'da	0
不在沉默中爆发	bu'zai'chen'mo'zhong'bao'fa	0
曾经阔气的要复古	ceng'jing'kuo'qi'de'yao'fu'gu	0
诚信为人之本	cheng'xin'wei'ren'zhi'ben	0
吃的是草挤出的是牛奶	chi'de'shi'cao'ji'chu'de'shi'niu'nai	0
抽刃向更强者	chou'ren'xiang'geng'qiang'zhe	0
创作总根于爱	chuang'zuo'zong'gen'yu'ai	0
从来如此便对吗	cong'lai'ru'ci'bian'dui'ma	0
待我成尘时	dai'wo'cheng'chen'shi	0
但能够为钱而卖掉	dan'neng'gou'wei'qian'er'mai'diao	0
但一定可以达到他所向往的目标	dan'yi'ding'ke'yi'da'dao'ta'suo'xiang'wang'de'mu'biao	0
敌人是不足惧的	di'ren'shi'bu'zu'ju'de	0
度尽劫波兄弟在	du'jin'jie'bo'xiong'di'zai	0
而不走路呢	er'bu'zou'lu'ne	0
发思古之幽情	fa'si'gu'zhi'you'qing	0
凡事以理想为因	fan'shi'yi'li'xiang'wei'yin	0
凡事总需研究才会明白	fan'shi'zong'xu'yan'jiu'cai'hui'ming'bai	0
凡为当局所诛者皆有罪	fan'wei'dang'ju'suo'zhu'zhe'jie'you'zui	0
俯首甘为孺子牛	fu'shou'gan'wei'ru'zi'niu	0
改造自己总比禁止别人来的难	gai'zao'zi'ji'zong'bi'jin'zhi'bie'ren'lai'de'nan	0
共和使人们变成沉默	gong'he'shi'ren'men'bian'cheng'chen'mo	0
寒凝大地发春华	han'ning'da'di'fa'chun'hua	0
横眉冷对千夫指	heng'mei'leng'dui'qian'fu'zhi	0
花开花落两由之	hua'kai'hua'luo'liang'you'zhi	0
即使慢驰而不息	ji'shi'man'chi'er'bu'xi	0
寄意寒星荃不察	ji'yi'han'xing'quan'bu'cha	0
假使做事要面面顾到	jia'shi'zuo'shi'yao'mian'mian'gu'dao	0
纠缠如毒蛇	jiu'chan'ru'du'she	0
就在沉默中灭亡	jiu'zai'chen'mo'zhong'mie'wang	0
决掩不住血写的事实	jue'yan'bu'zhu'xue'xie'de'shi'shi	0
连眼珠也不转过去	lian'yan'zhu'ye'bu'zhuan'guo'qu	0
怜子如何不丈夫	lian'zi'ru'he'bu'zhang'fu	0
明言着轻蔑什么人	ming'yan'zhe'qing'mie'shen'me'ren	0
墨写的谎说	mo'xie'de'huang'shuo	0
那就什么事都不能做了	na'jiu'shen'me'shi'dou'bu'neng'zuo'le	0
你将见我的微笑	ni'jiang'jian'wo'de'wei'xiao	0
怒向刀丛觅小诗	nu'xiang'dao'cong'mi'xiao'shi	0
怕夏天死尸的易烂	pa'xia'tian'si'shi'de'yi'lan	0
其实地上本没有路	qi'shi'di'shang'ben'mei'you'lu	0
其实是无异于谋财害命	qi'shi'shi'wu'yi'yu'mou'cai'hai'ming	0
妻性是逼成的	qi'xing'shi'bi'cheng'de	0
岂有豪情似旧时	qi'you'hao'qing'si'jiu'shi	0
怯者愤怒	qie'zhe'fen'nu	0
犬儒的刺一用	quan'ru'de'ci'yi'yong	0
却不该是命令者	que'bu'gai'shi'ming'ling'zhe	0
却抽刃向更弱者	que'chou'ren'xiang'geng'ruo'zhe	0
忍看朋辈成新鬼	ren'kan'peng'bei'cheng'xin'gui	0
人类的悲欢并不相通	ren'lei'de'bei'huan'bing'bu'xiang'tong	0
人生得一知己足矣	ren'sheng'de'yi'zhi'ji'zu'yi	0
人又何必因为一点小障碍	ren'you'he'bi'yin'wei'yi'dian'xiao'zhang'ai	0
史家之绝唱	shi'jia'zhi'jue'chang	0
时间就是性命	shi'jian'jiu'shi'xing'ming	0
时间就像海绵里的水	shi'jian'jiu'xiang'hai'mian'li'de'shui	0
事实是毫无情面的东西	shi'shi'shi'hao'wu'qing'mian'de'dong'xi	0
使所读的书活起来	shi'suo'du'de'shu'huo'qi'lai	0
实行为果	shi'xing'wei'guo	0
斯世当以同怀视之	si'shi'dang'yi'tong'huai'shi'zhi	0
死者倘不埋在活人心中	si'zhe'tang'bu'mai'zai'huo'ren'xin'zhong	0
所以必须和现实社会接触	suo'yi'bi'xu'he'xian'shi'she'hui'jie'chu	0
它能将空言打得粉碎	ta'neng'jiang'kong'yan'da'de'fen'sui	0
贪安稳就没有自由	tan'an'wen'jiu'mei'you'zi'you	0
倘能生存	tang'neng'sheng'cun	0
倘无恒心是很不好的	tang'wu'heng'xin'shi'hen'bu'hao'de	0
倘只看书便变成书橱	tang'zhi'kan'shu'bian'bian'cheng'shu'chu	0
玩具是儿童的天使	wan'ju'shi'er'tong'de'tian'shi	0
往往为了现在	wang'wang'wei'le'xian'zai	0
未曾阔气的要革新	wei'ceng'kuo'qi'de'yao'ge'xin	0
惟沉默是最高的轻蔑	wei'chen'mo'shi'zui'gao'de'qing'mie	0
唯有民族魂是值得宝贵的	wei'you'min'zu'hun'shi'zhi'de'bao'gui'de	0
唯有它发扬起来	wei'you'ta'fa'yang'qi'lai	0
我当然仍要学习	wo'dang'ran'reng'yao'xue'xi	0
我觉得坦途在前	wo'jue'de'tan'tu'zai'qian	0
我以我血荐轩辕	wo'yi'wo'xue'jian'xuan'yuan	0
我憎恶这以野草作装饰的地面	wo'zeng'wu'zhe'yi'ye'cao'zuo'zhuang'shi'de'di'mian	0
我自爱我的野草	wo'zi'ai'wo'de'ye'cao	0
无端的空耗别人的时间	wu'duan'de'kong'hao'bie'ren'de'shi'jian	0
无情未必真豪杰	wu'qing'wei'bi'zhen'hao'jie	0
无韵之离骚	wu'yun'zhi'li'sao	0
先驱者本是容易变成绊脚石的	xian'qu'zhe'ben'shi'rong'yi'bian'cheng'ban'jiao'shi'de	0
想不到也可以指挥文人	xiang'bu'dao'ye'ke'yi'zhi'hui'wen'ren	0
相逢一笑泯恩仇	xiang'feng'yi'xiao'min'en'chou	0
心事浩茫连广宇	xin'shi'hao'mang'lian'guang'yu	0
许多事情都败在他们手里	xu'duo'shi'qing'dou'bai'zai'ta'men'shou'li	0
血沃中原肥劲草	xue'wo'zhong'yuan'fei'jing'cao	0
要在文化上有成绩	yao'zai'wen'hua'shang'you'cheng'ji	0
要自杀的人	yao'zi'sha'de'ren	0
要自由就要历些危险	yao'zi'you'jiu'yao'li'xie'wei'xian	0
也会怕大海的汪洋	ye'hui'pa'da'hai'de'wang'yang	0
一定有许多英雄	yi'ding'you'xu'duo'ying'xiong	0
勇者愤怒	yong'zhe'fen'nu	0
有一分热发一分光	you'yi'fen're'fa'yi'fen'guang	0
友谊是两颗心真诚相待	you'yi'shi'liang'ke'xin'zhen'cheng'xiang'dai	0
幼稚是会成长会成熟的	you'zhi'shi'hui'cheng'zhang'hui'cheng'shu'de	0
愈艰难就愈要做	yu'jian'nan'jiu'yu'yao'zuo	0
于无声处听惊雷	yu'wu'sheng'chu'ting'jing'lei	0
愿中国青年都摆脱冷气	yuan'zhong'guo'qing'nian'dou'bai'tuo'leng'qi	0
则非韧不可	ze'fei'ren'bu'ke	0
则苟延了他自己的生命	ze'gou'yan'le'ta'zi'ji'de'sheng'ming	0
长者须是指导者协商者	zhang'zhe'xu'shi'zhi'dao'zhe'xie'shang'zhe	0
正在阔气的要保持现状	zheng'zai'kuo'qi'de'yao'bao'chi'xian'zhuang	0
指挥刀可以指挥武士	zhi'hui'dao'ke'yi'zhi'hui'wu'shi	0
只是向上走	zhi'shi'xiang'shang'zou	0
只要不衰老腐败就好	zhi'yao'bu'shuai'lao'fu'bai'jiu'hao	0
执著如冤鬼	zhi'zhuo'ru'yuan'gui	0
中国才有真进步	zhong'guo'cai'you'zhen'jin'bu	0
专读书也有弊病	zhuan'du'shu'ye'you'bi'bing	0
专向孩子们瞪眼	zhuan'xiang'hai'zi'men'deng'yan	0
自由固不是钱所买到的	zi'you'gu'bu'shi'qian'suo'mai'dao'de	0
纵令落后纵令失败	zong'ling'luo'hou'zong'ling'shi'bai	0
走的人多了也便成了路	zou'de'ren'duo'le'ye'bian'cheng'le'lu	0
最高的轻蔑是无言	zui'gao'de'qing'mie'shi'wu'yan	0
做一件事无论大小	zuo'yi'jian'shi'wu'lun'da'xiao	0
